index,actual,predicted,probability,cumul_pos,cost,revenue,profit
2,1.0,1.0,1.0,1,4,15,11
10,1.0,1.0,1.0,2,8,30,22
29,1.0,1.0,1.0,3,12,45,33
47,1.0,1.0,1.0,4,16,60,44
63,1.0,1.0,1.0,5,20,75,55
71,1.0,1.0,1.0,6,24,90,66
75,1.0,1.0,1.0,7,28,105,77
81,1.0,1.0,1.0,8,32,120,88
85,1.0,1.0,1.0,9,36,135,99
89,1.0,1.0,1.0,10,40,150,110
96,1.0,1.0,1.0,11,44,165,121
103,1.0,1.0,1.0,12,48,180,132
125,1.0,1.0,1.0,13,52,195,143
131,1.0,1.0,1.0,14,56,210,154
140,1.0,1.0,1.0,15,60,225,165
146,1.0,1.0,1.0,16,64,240,176
165,1.0,1.0,1.0,17,68,255,187
168,1.0,1.0,1.0,18,72,270,198
170,1.0,1.0,1.0,19,76,285,209
175,1.0,1.0,1.0,20,80,300,220
181,1.0,1.0,1.0,21,84,315,231
193,1.0,1.0,1.0,22,88,330,242
195,1.0,1.0,1.0,23,92,345,253
201,1.0,1.0,1.0,24,96,360,264
202,1.0,1.0,1.0,25,100,375,275
203,1.0,1.0,1.0,26,104,390,286
229,1.0,1.0,1.0,27,108,405,297
235,1.0,1.0,1.0,28,112,420,308
239,1.0,1.0,1.0,29,116,435,319
260,1.0,1.0,1.0,30,120,450,330
262,1.0,1.0,1.0,31,124,465,341
275,1.0,1.0,1.0,32,128,480,352
276,1.0,1.0,1.0,33,132,495,363
287,1.0,1.0,1.0,34,136,510,374
293,1.0,1.0,1.0,35,140,525,385
307,1.0,1.0,1.0,36,144,540,396
309,1.0,1.0,1.0,37,148,555,407
311,1.0,1.0,1.0,38,152,570,418
317,1.0,1.0,1.0,39,156,585,429
323,1.0,1.0,1.0,40,160,600,440
332,1.0,1.0,1.0,41,164,615,451
335,1.0,1.0,1.0,42,168,630,462
338,1.0,1.0,1.0,43,172,645,473
340,1.0,1.0,1.0,44,176,660,484
361,1.0,1.0,1.0,45,180,675,495
390,1.0,1.0,1.0,46,184,690,506
395,1.0,1.0,1.0,47,188,705,517
406,1.0,1.0,1.0,48,192,720,528
426,1.0,1.0,1.0,49,196,735,539
427,1.0,1.0,1.0,50,200,750,550
430,1.0,1.0,1.0,51,204,765,561
435,1.0,1.0,1.0,52,208,780,572
438,1.0,1.0,1.0,53,212,795,583
443,1.0,1.0,1.0,54,216,810,594
446,1.0,1.0,1.0,55,220,825,605
449,1.0,1.0,1.0,56,224,840,616
454,1.0,1.0,1.0,57,228,855,627
458,1.0,1.0,1.0,58,232,870,638
465,1.0,1.0,1.0,59,236,885,649
486,1.0,1.0,1.0,60,240,900,660
500,1.0,1.0,1.0,61,244,915,671
503,1.0,1.0,1.0,62,248,930,682
543,1.0,1.0,1.0,63,252,945,693
550,1.0,1.0,1.0,64,256,960,704
553,1.0,1.0,1.0,65,260,975,715
578,1.0,1.0,1.0,66,264,990,726
580,1.0,1.0,1.0,67,268,1005,737
601,1.0,1.0,1.0,68,272,1020,748
607,1.0,1.0,1.0,69,276,1035,759
610,1.0,1.0,1.0,70,280,1050,770
617,1.0,1.0,1.0,71,284,1065,781
656,1.0,1.0,1.0,72,288,1080,792
662,1.0,1.0,1.0,73,292,1095,803
668,1.0,1.0,1.0,74,296,1110,814
669,1.0,1.0,1.0,75,300,1125,825
677,1.0,1.0,1.0,76,304,1140,836
679,1.0,1.0,1.0,77,308,1155,847
699,1.0,1.0,1.0,78,312,1170,858
719,1.0,1.0,1.0,79,316,1185,869
726,1.0,1.0,1.0,80,320,1200,880
731,1.0,1.0,1.0,81,324,1215,891
735,1.0,1.0,1.0,82,328,1230,902
744,1.0,1.0,1.0,83,332,1245,913
748,1.0,1.0,1.0,84,336,1260,924
759,1.0,1.0,1.0,85,340,1275,935
775,1.0,1.0,1.0,86,344,1290,946
817,1.0,1.0,1.0,87,348,1305,957
818,1.0,1.0,1.0,88,352,1320,968
820,1.0,1.0,1.0,89,356,1335,979
826,1.0,1.0,1.0,90,360,1350,990
844,1.0,1.0,1.0,91,364,1365,1001
851,1.0,1.0,1.0,92,368,1380,1012
853,1.0,1.0,1.0,93,372,1395,1023
857,1.0,1.0,1.0,94,376,1410,1034
863,1.0,1.0,1.0,95,380,1425,1045
875,1.0,1.0,1.0,96,384,1440,1056
876,1.0,1.0,1.0,97,388,1455,1067
881,1.0,1.0,1.0,98,392,1470,1078
909,1.0,1.0,1.0,99,396,1485,1089
915,1.0,1.0,1.0,100,400,1500,1100
924,1.0,1.0,1.0,101,404,1515,1111
930,1.0,1.0,1.0,102,408,1530,1122
941,1.0,1.0,1.0,103,412,1545,1133
951,1.0,1.0,1.0,104,416,1560,1144
975,1.0,1.0,1.0,105,420,1575,1155
977,1.0,1.0,1.0,106,424,1590,1166
978,1.0,1.0,1.0,107,428,1605,1177
980,1.0,1.0,1.0,108,432,1620,1188
993,1.0,1.0,1.0,109,436,1635,1199
999,1.0,1.0,1.0,110,440,1650,1210
1005,1.0,1.0,1.0,111,444,1665,1221
1006,1.0,1.0,1.0,112,448,1680,1232
1010,1.0,1.0,1.0,113,452,1695,1243
1020,1.0,1.0,1.0,114,456,1710,1254
1021,1.0,1.0,1.0,115,460,1725,1265
1029,1.0,1.0,1.0,116,464,1740,1276
1034,1.0,1.0,1.0,117,468,1755,1287
1046,1.0,1.0,1.0,118,472,1770,1298
1048,1.0,1.0,1.0,119,476,1785,1309
1059,1.0,1.0,1.0,120,480,1800,1320
1064,1.0,1.0,1.0,121,484,1815,1331
1071,1.0,1.0,1.0,122,488,1830,1342
1073,1.0,1.0,1.0,123,492,1845,1353
1074,1.0,1.0,1.0,124,496,1860,1364
1076,1.0,1.0,1.0,125,500,1875,1375
1080,1.0,1.0,1.0,126,504,1890,1386
1082,1.0,1.0,1.0,127,508,1905,1397
1090,1.0,1.0,1.0,128,512,1920,1408
1092,1.0,1.0,1.0,129,516,1935,1419
1093,1.0,1.0,1.0,130,520,1950,1430
1098,1.0,1.0,1.0,131,524,1965,1441
1100,1.0,1.0,1.0,132,528,1980,1452
1114,1.0,1.0,1.0,133,532,1995,1463
1124,1.0,1.0,1.0,134,536,2010,1474
1142,1.0,1.0,1.0,135,540,2025,1485
1151,1.0,1.0,1.0,136,544,2040,1496
1170,1.0,1.0,1.0,137,548,2055,1507
1193,1.0,1.0,1.0,138,552,2070,1518
1194,1.0,1.0,1.0,139,556,2085,1529
1195,1.0,1.0,1.0,140,560,2100,1540
1201,1.0,1.0,1.0,141,564,2115,1551
1206,1.0,1.0,1.0,142,568,2130,1562
1231,1.0,1.0,1.0,143,572,2145,1573
1236,1.0,1.0,1.0,144,576,2160,1584
1266,1.0,1.0,1.0,145,580,2175,1595
1280,1.0,1.0,1.0,146,584,2190,1606
1283,1.0,1.0,1.0,147,588,2205,1617
1287,1.0,1.0,1.0,148,592,2220,1628
1302,1.0,1.0,1.0,149,596,2235,1639
1308,1.0,1.0,1.0,150,600,2250,1650
1309,1.0,1.0,1.0,151,604,2265,1661
1321,1.0,1.0,1.0,152,608,2280,1672
1328,1.0,1.0,1.0,153,612,2295,1683
1348,1.0,1.0,1.0,154,616,2310,1694
1350,1.0,1.0,1.0,155,620,2325,1705
1394,1.0,1.0,1.0,156,624,2340,1716
1399,1.0,1.0,1.0,157,628,2355,1727
1400,1.0,1.0,1.0,158,632,2370,1738
1401,1.0,1.0,1.0,159,636,2385,1749
1417,1.0,1.0,1.0,160,640,2400,1760
1427,1.0,1.0,1.0,161,644,2415,1771
1430,1.0,1.0,1.0,162,648,2430,1782
1439,1.0,1.0,1.0,163,652,2445,1793
1440,1.0,1.0,1.0,164,656,2460,1804
1458,1.0,1.0,1.0,165,660,2475,1815
1484,1.0,1.0,1.0,166,664,2490,1826
1499,1.0,1.0,1.0,167,668,2505,1837
1503,1.0,1.0,1.0,168,672,2520,1848
1504,1.0,1.0,1.0,169,676,2535,1859
1508,1.0,1.0,1.0,170,680,2550,1870
1510,1.0,1.0,1.0,171,684,2565,1881
1515,1.0,1.0,1.0,172,688,2580,1892
1520,1.0,1.0,1.0,173,692,2595,1903
1521,1.0,1.0,1.0,174,696,2610,1914
1523,1.0,1.0,1.0,175,700,2625,1925
1524,1.0,1.0,1.0,176,704,2640,1936
1536,1.0,1.0,1.0,177,708,2655,1947
1538,1.0,1.0,1.0,178,712,2670,1958
1541,1.0,1.0,1.0,179,716,2685,1969
1555,1.0,1.0,1.0,180,720,2700,1980
1574,1.0,1.0,1.0,181,724,2715,1991
1578,1.0,1.0,1.0,182,728,2730,2002
1584,1.0,1.0,1.0,183,732,2745,2013
1588,1.0,1.0,1.0,184,736,2760,2024
1589,1.0,1.0,1.0,185,740,2775,2035
1590,1.0,1.0,1.0,186,744,2790,2046
1598,1.0,1.0,1.0,187,748,2805,2057
1606,1.0,1.0,1.0,188,752,2820,2068
1608,1.0,1.0,1.0,189,756,2835,2079
1635,1.0,1.0,1.0,190,760,2850,2090
1636,1.0,1.0,1.0,191,764,2865,2101
1641,1.0,1.0,1.0,192,768,2880,2112
1653,1.0,1.0,1.0,193,772,2895,2123
1660,1.0,1.0,1.0,194,776,2910,2134
1667,1.0,1.0,1.0,195,780,2925,2145
1682,1.0,1.0,1.0,196,784,2940,2156
1684,1.0,1.0,1.0,197,788,2955,2167
1691,1.0,1.0,1.0,198,792,2970,2178
1698,1.0,1.0,1.0,199,796,2985,2189
1701,1.0,1.0,1.0,200,800,3000,2200
1729,1.0,1.0,1.0,201,804,3015,2211
1734,1.0,1.0,1.0,202,808,3030,2222
1736,1.0,1.0,1.0,203,812,3045,2233
1757,1.0,1.0,1.0,204,816,3060,2244
1765,1.0,1.0,1.0,205,820,3075,2255
1767,1.0,1.0,1.0,206,824,3090,2266
1774,1.0,1.0,1.0,207,828,3105,2277
1782,1.0,1.0,1.0,208,832,3120,2288
1787,1.0,1.0,1.0,209,836,3135,2299
1790,1.0,1.0,1.0,210,840,3150,2310
1798,1.0,1.0,1.0,211,844,3165,2321
1800,1.0,1.0,1.0,212,848,3180,2332
1813,1.0,1.0,1.0,213,852,3195,2343
1822,1.0,1.0,1.0,214,856,3210,2354
1825,1.0,1.0,1.0,215,860,3225,2365
1831,1.0,1.0,1.0,216,864,3240,2376
1870,1.0,1.0,1.0,217,868,3255,2387
1872,1.0,1.0,1.0,218,872,3270,2398
1882,1.0,1.0,1.0,219,876,3285,2409
1884,1.0,1.0,1.0,220,880,3300,2420
1900,1.0,1.0,1.0,221,884,3315,2431
1902,1.0,1.0,1.0,222,888,3330,2442
1906,1.0,1.0,1.0,223,892,3345,2453
1907,1.0,1.0,1.0,224,896,3360,2464
1909,1.0,1.0,1.0,225,900,3375,2475
1918,1.0,1.0,1.0,226,904,3390,2486
1924,1.0,1.0,1.0,227,908,3405,2497
1928,1.0,1.0,1.0,228,912,3420,2508
1930,1.0,1.0,1.0,229,916,3435,2519
1942,1.0,1.0,1.0,230,920,3450,2530
1952,1.0,1.0,1.0,231,924,3465,2541
1955,1.0,1.0,1.0,232,928,3480,2552
1962,1.0,1.0,1.0,233,932,3495,2563
1964,1.0,1.0,1.0,234,936,3510,2574
1975,1.0,1.0,1.0,235,940,3525,2585
1978,1.0,1.0,1.0,236,944,3540,2596
1985,1.0,1.0,1.0,237,948,3555,2607
1988,1.0,1.0,1.0,238,952,3570,2618
1997,1.0,1.0,1.0,239,956,3585,2629
2007,1.0,1.0,1.0,240,960,3600,2640
2008,1.0,1.0,1.0,241,964,3615,2651
2012,1.0,1.0,1.0,242,968,3630,2662
2026,1.0,1.0,1.0,243,972,3645,2673
2033,1.0,1.0,1.0,244,976,3660,2684
2035,1.0,1.0,1.0,245,980,3675,2695
2052,1.0,1.0,1.0,246,984,3690,2706
2058,1.0,1.0,1.0,247,988,3705,2717
2083,1.0,1.0,1.0,248,992,3720,2728
2091,1.0,1.0,1.0,249,996,3735,2739
2108,1.0,1.0,1.0,250,1000,3750,2750
2130,1.0,1.0,1.0,251,1004,3765,2761
2138,1.0,1.0,1.0,252,1008,3780,2772
2147,1.0,1.0,1.0,253,1012,3795,2783
2153,1.0,1.0,1.0,254,1016,3810,2794
2158,1.0,1.0,1.0,255,1020,3825,2805
2160,1.0,1.0,1.0,256,1024,3840,2816
2166,1.0,1.0,1.0,257,1028,3855,2827
2171,1.0,1.0,1.0,258,1032,3870,2838
2175,1.0,1.0,1.0,259,1036,3885,2849
2182,1.0,1.0,1.0,260,1040,3900,2860
2185,1.0,1.0,1.0,261,1044,3915,2871
2200,1.0,1.0,1.0,262,1048,3930,2882
2204,1.0,1.0,1.0,263,1052,3945,2893
2209,1.0,1.0,1.0,264,1056,3960,2904
2210,1.0,1.0,1.0,265,1060,3975,2915
2215,1.0,1.0,1.0,266,1064,3990,2926
2218,1.0,1.0,1.0,267,1068,4005,2937
2226,1.0,1.0,1.0,268,1072,4020,2948
2229,1.0,1.0,1.0,269,1076,4035,2959
2231,1.0,1.0,1.0,270,1080,4050,2970
2233,1.0,1.0,1.0,271,1084,4065,2981
2237,1.0,1.0,1.0,272,1088,4080,2992
2240,1.0,1.0,1.0,273,1092,4095,3003
2245,1.0,1.0,1.0,274,1096,4110,3014
2247,1.0,1.0,1.0,275,1100,4125,3025
2249,1.0,1.0,1.0,276,1104,4140,3036
2250,1.0,1.0,1.0,277,1108,4155,3047
2255,1.0,1.0,1.0,278,1112,4170,3058
2258,1.0,1.0,1.0,279,1116,4185,3069
2261,1.0,1.0,1.0,280,1120,4200,3080
2269,1.0,1.0,1.0,281,1124,4215,3091
2277,1.0,1.0,1.0,282,1128,4230,3102
2292,1.0,1.0,1.0,283,1132,4245,3113
2327,1.0,1.0,1.0,284,1136,4260,3124
2332,1.0,1.0,1.0,285,1140,4275,3135
2333,1.0,1.0,1.0,286,1144,4290,3146
2334,1.0,1.0,1.0,287,1148,4305,3157
2338,1.0,1.0,1.0,288,1152,4320,3168
2355,1.0,1.0,1.0,289,1156,4335,3179
2359,1.0,1.0,1.0,290,1160,4350,3190
2376,1.0,1.0,1.0,291,1164,4365,3201
2392,1.0,1.0,1.0,292,1168,4380,3212
2393,1.0,1.0,1.0,293,1172,4395,3223
2406,1.0,1.0,1.0,294,1176,4410,3234
2421,1.0,1.0,1.0,295,1180,4425,3245
2427,1.0,1.0,1.0,296,1184,4440,3256
2433,1.0,1.0,1.0,297,1188,4455,3267
2444,1.0,1.0,1.0,298,1192,4470,3278
2461,1.0,1.0,1.0,299,1196,4485,3289
2478,1.0,1.0,1.0,300,1200,4500,3300
2487,1.0,1.0,1.0,301,1204,4515,3311
2494,1.0,1.0,1.0,302,1208,4530,3322
2497,1.0,1.0,1.0,303,1212,4545,3333
2511,1.0,1.0,1.0,304,1216,4560,3344
2513,1.0,1.0,1.0,305,1220,4575,3355
2516,1.0,1.0,1.0,306,1224,4590,3366
2520,1.0,1.0,1.0,307,1228,4605,3377
2523,1.0,1.0,1.0,308,1232,4620,3388
2529,1.0,1.0,1.0,309,1236,4635,3399
2530,1.0,1.0,1.0,310,1240,4650,3410
2531,1.0,1.0,1.0,311,1244,4665,3421
2543,1.0,1.0,1.0,312,1248,4680,3432
2544,1.0,1.0,1.0,313,1252,4695,3443
2546,1.0,1.0,1.0,314,1256,4710,3454
2552,1.0,1.0,1.0,315,1260,4725,3465
2565,1.0,1.0,1.0,316,1264,4740,3476
2575,1.0,1.0,1.0,317,1268,4755,3487
2577,1.0,1.0,1.0,318,1272,4770,3498
2585,1.0,1.0,1.0,319,1276,4785,3509
2587,1.0,1.0,1.0,320,1280,4800,3520
2592,1.0,1.0,1.0,321,1284,4815,3531
2622,1.0,1.0,1.0,322,1288,4830,3542
2640,1.0,1.0,1.0,323,1292,4845,3553
2644,1.0,1.0,1.0,324,1296,4860,3564
2648,1.0,1.0,1.0,325,1300,4875,3575
2656,1.0,1.0,1.0,326,1304,4890,3586
2657,1.0,1.0,1.0,327,1308,4905,3597
2658,1.0,1.0,1.0,328,1312,4920,3608
2667,1.0,1.0,1.0,329,1316,4935,3619
2668,1.0,1.0,1.0,330,1320,4950,3630
2678,1.0,1.0,1.0,331,1324,4965,3641
2679,1.0,1.0,1.0,332,1328,4980,3652
2684,1.0,1.0,1.0,333,1332,4995,3663
2686,1.0,1.0,1.0,334,1336,5010,3674
2751,1.0,1.0,1.0,335,1340,5025,3685
2752,1.0,1.0,1.0,336,1344,5040,3696
2760,1.0,1.0,1.0,337,1348,5055,3707
2770,1.0,1.0,1.0,338,1352,5070,3718
2789,1.0,1.0,1.0,339,1356,5085,3729
2795,1.0,1.0,1.0,340,1360,5100,3740
2803,1.0,1.0,1.0,341,1364,5115,3751
2813,1.0,1.0,1.0,342,1368,5130,3762
2818,1.0,1.0,1.0,343,1372,5145,3773
2823,1.0,1.0,1.0,344,1376,5160,3784
2824,1.0,1.0,1.0,345,1380,5175,3795
2825,1.0,1.0,1.0,346,1384,5190,3806
2837,1.0,1.0,1.0,347,1388,5205,3817
2852,1.0,1.0,1.0,348,1392,5220,3828
2854,1.0,1.0,1.0,349,1396,5235,3839
2859,1.0,1.0,1.0,350,1400,5250,3850
2862,1.0,1.0,1.0,351,1404,5265,3861
2872,1.0,1.0,1.0,352,1408,5280,3872
2878,1.0,1.0,1.0,353,1412,5295,3883
2881,1.0,1.0,1.0,354,1416,5310,3894
2900,1.0,1.0,1.0,355,1420,5325,3905
2925,1.0,1.0,1.0,356,1424,5340,3916
2930,1.0,1.0,1.0,357,1428,5355,3927
2934,1.0,1.0,1.0,358,1432,5370,3938
2941,1.0,1.0,1.0,359,1436,5385,3949
2953,1.0,1.0,1.0,360,1440,5400,3960
2966,1.0,1.0,1.0,361,1444,5415,3971
2970,1.0,1.0,1.0,362,1448,5430,3982
2978,1.0,1.0,1.0,363,1452,5445,3993
2988,1.0,1.0,1.0,364,1456,5460,4004
3004,1.0,1.0,1.0,365,1460,5475,4015
3013,1.0,1.0,1.0,366,1464,5490,4026
3017,1.0,1.0,1.0,367,1468,5505,4037
3024,1.0,1.0,1.0,368,1472,5520,4048
3026,1.0,1.0,1.0,369,1476,5535,4059
3029,1.0,1.0,1.0,370,1480,5550,4070
3043,1.0,1.0,1.0,371,1484,5565,4081
3054,1.0,1.0,1.0,372,1488,5580,4092
3055,1.0,1.0,1.0,373,1492,5595,4103
3063,1.0,1.0,1.0,374,1496,5610,4114
3065,1.0,1.0,1.0,375,1500,5625,4125
3125,1.0,1.0,1.0,376,1504,5640,4136
3157,1.0,1.0,1.0,377,1508,5655,4147
3159,1.0,1.0,1.0,378,1512,5670,4158
3163,1.0,1.0,1.0,379,1516,5685,4169
3165,1.0,1.0,1.0,380,1520,5700,4180
3186,1.0,1.0,1.0,381,1524,5715,4191
3189,1.0,1.0,1.0,382,1528,5730,4202
3208,1.0,1.0,1.0,383,1532,5745,4213
3227,1.0,1.0,1.0,384,1536,5760,4224
3243,1.0,1.0,1.0,385,1540,5775,4235
3246,1.0,1.0,1.0,386,1544,5790,4246
3272,1.0,1.0,1.0,387,1548,5805,4257
3284,1.0,1.0,1.0,388,1552,5820,4268
3293,1.0,1.0,1.0,389,1556,5835,4279
3296,1.0,1.0,1.0,390,1560,5850,4290
3297,1.0,1.0,1.0,391,1564,5865,4301
3303,1.0,1.0,1.0,392,1568,5880,4312
3304,1.0,1.0,1.0,393,1572,5895,4323
3310,1.0,1.0,1.0,394,1576,5910,4334
3313,1.0,1.0,1.0,395,1580,5925,4345
3319,1.0,1.0,1.0,396,1584,5940,4356
3320,1.0,1.0,1.0,397,1588,5955,4367
3323,1.0,1.0,1.0,398,1592,5970,4378
3334,1.0,1.0,1.0,399,1596,5985,4389
3343,1.0,1.0,1.0,400,1600,6000,4400
3346,1.0,1.0,1.0,401,1604,6015,4411
3350,1.0,1.0,1.0,402,1608,6030,4422
3351,1.0,1.0,1.0,403,1612,6045,4433
3362,1.0,1.0,1.0,404,1616,6060,4444
3363,1.0,1.0,1.0,405,1620,6075,4455
3367,1.0,1.0,1.0,406,1624,6090,4466
3379,1.0,1.0,1.0,407,1628,6105,4477
3415,1.0,1.0,1.0,408,1632,6120,4488
3418,1.0,1.0,1.0,409,1636,6135,4499
3453,1.0,1.0,1.0,410,1640,6150,4510
3461,1.0,1.0,1.0,411,1644,6165,4521
3474,1.0,1.0,1.0,412,1648,6180,4532
3475,1.0,1.0,1.0,413,1652,6195,4543
3478,1.0,1.0,1.0,414,1656,6210,4554
3479,1.0,1.0,1.0,415,1660,6225,4565
3485,1.0,1.0,1.0,416,1664,6240,4576
3486,1.0,1.0,1.0,417,1668,6255,4587
3512,1.0,1.0,1.0,418,1672,6270,4598
3514,1.0,1.0,1.0,419,1676,6285,4609
3527,1.0,1.0,1.0,420,1680,6300,4620
3541,1.0,1.0,1.0,421,1684,6315,4631
3552,1.0,1.0,1.0,422,1688,6330,4642
3556,1.0,1.0,1.0,423,1692,6345,4653
3586,1.0,1.0,1.0,424,1696,6360,4664
3587,1.0,1.0,1.0,425,1700,6375,4675
3588,1.0,1.0,1.0,426,1704,6390,4686
3593,1.0,1.0,1.0,427,1708,6405,4697
3600,1.0,1.0,1.0,428,1712,6420,4708
3606,1.0,1.0,1.0,429,1716,6435,4719
3616,1.0,1.0,1.0,430,1720,6450,4730
3624,1.0,1.0,1.0,431,1724,6465,4741
3628,1.0,1.0,1.0,432,1728,6480,4752
3630,1.0,1.0,1.0,433,1732,6495,4763
3644,1.0,1.0,1.0,434,1736,6510,4774
3645,1.0,1.0,1.0,435,1740,6525,4785
3650,1.0,1.0,1.0,436,1744,6540,4796
3665,1.0,1.0,1.0,437,1748,6555,4807
3672,1.0,1.0,1.0,438,1752,6570,4818
3673,1.0,1.0,1.0,439,1756,6585,4829
3685,1.0,1.0,1.0,440,1760,6600,4840
3700,1.0,1.0,1.0,441,1764,6615,4851
3706,1.0,1.0,1.0,442,1768,6630,4862
3713,1.0,1.0,1.0,443,1772,6645,4873
3716,1.0,1.0,1.0,444,1776,6660,4884
3718,1.0,1.0,1.0,445,1780,6675,4895
3720,1.0,1.0,1.0,446,1784,6690,4906
3733,1.0,1.0,1.0,447,1788,6705,4917
3734,1.0,1.0,1.0,448,1792,6720,4928
3737,1.0,1.0,1.0,449,1796,6735,4939
3739,1.0,1.0,1.0,450,1800,6750,4950
3745,1.0,1.0,1.0,451,1804,6765,4961
3787,1.0,1.0,1.0,452,1808,6780,4972
3798,1.0,1.0,1.0,453,1812,6795,4983
3799,1.0,1.0,1.0,454,1816,6810,4994
3804,1.0,1.0,1.0,455,1820,6825,5005
3808,1.0,1.0,1.0,456,1824,6840,5016
3824,1.0,1.0,1.0,457,1828,6855,5027
3825,1.0,1.0,1.0,458,1832,6870,5038
3833,1.0,1.0,1.0,459,1836,6885,5049
3835,1.0,1.0,1.0,460,1840,6900,5060
3836,1.0,1.0,1.0,461,1844,6915,5071
3837,1.0,1.0,1.0,462,1848,6930,5082
3843,1.0,1.0,1.0,463,1852,6945,5093
3846,1.0,1.0,1.0,464,1856,6960,5104
3850,1.0,1.0,1.0,465,1860,6975,5115
3856,1.0,1.0,1.0,466,1864,6990,5126
3866,1.0,1.0,1.0,467,1868,7005,5137
3869,1.0,1.0,1.0,468,1872,7020,5148
3888,1.0,1.0,1.0,469,1876,7035,5159
3898,1.0,1.0,1.0,470,1880,7050,5170
3918,1.0,1.0,1.0,471,1884,7065,5181
3925,1.0,1.0,1.0,472,1888,7080,5192
3927,1.0,1.0,1.0,473,1892,7095,5203
3928,1.0,1.0,1.0,474,1896,7110,5214
3931,1.0,1.0,1.0,475,1900,7125,5225
3934,1.0,1.0,1.0,476,1904,7140,5236
3941,1.0,1.0,1.0,477,1908,7155,5247
3949,1.0,1.0,1.0,478,1912,7170,5258
3969,1.0,1.0,1.0,479,1916,7185,5269
3973,1.0,1.0,1.0,480,1920,7200,5280
3977,1.0,1.0,1.0,481,1924,7215,5291
3994,1.0,1.0,1.0,482,1928,7230,5302
3999,1.0,1.0,1.0,483,1932,7245,5313
4007,1.0,1.0,1.0,484,1936,7260,5324
4016,1.0,1.0,1.0,485,1940,7275,5335
4021,1.0,1.0,1.0,486,1944,7290,5346
4027,1.0,1.0,1.0,487,1948,7305,5357
4041,1.0,1.0,1.0,488,1952,7320,5368
4046,1.0,1.0,1.0,489,1956,7335,5379
4055,1.0,1.0,1.0,490,1960,7350,5390
4056,1.0,1.0,1.0,491,1964,7365,5401
4059,1.0,1.0,1.0,492,1968,7380,5412
4064,1.0,1.0,1.0,493,1972,7395,5423
4067,1.0,1.0,1.0,494,1976,7410,5434
4079,1.0,1.0,1.0,495,1980,7425,5445
4092,1.0,1.0,1.0,496,1984,7440,5456
4099,1.0,1.0,1.0,497,1988,7455,5467
4100,1.0,1.0,1.0,498,1992,7470,5478
4121,1.0,1.0,1.0,499,1996,7485,5489
4138,1.0,1.0,1.0,500,2000,7500,5500
4141,1.0,1.0,1.0,501,2004,7515,5511
4143,1.0,1.0,1.0,502,2008,7530,5522
4147,1.0,1.0,1.0,503,2012,7545,5533
4152,1.0,1.0,1.0,504,2016,7560,5544
4158,1.0,1.0,1.0,505,2020,7575,5555
4161,1.0,1.0,1.0,506,2024,7590,5566
4171,1.0,1.0,1.0,507,2028,7605,5577
4197,1.0,1.0,1.0,508,2032,7620,5588
4200,1.0,1.0,1.0,509,2036,7635,5599
4212,1.0,1.0,1.0,510,2040,7650,5610
4216,1.0,1.0,1.0,511,2044,7665,5621
4218,1.0,1.0,1.0,512,2048,7680,5632
4244,1.0,1.0,1.0,513,2052,7695,5643
4245,1.0,1.0,1.0,514,2056,7710,5654
4259,1.0,1.0,1.0,515,2060,7725,5665
4267,1.0,1.0,1.0,516,2064,7740,5676
4279,1.0,1.0,1.0,517,2068,7755,5687
4280,1.0,1.0,1.0,518,2072,7770,5698
4281,1.0,1.0,1.0,519,2076,7785,5709
4285,1.0,1.0,1.0,520,2080,7800,5720
4291,1.0,1.0,1.0,521,2084,7815,5731
4292,1.0,1.0,1.0,522,2088,7830,5742
4294,1.0,1.0,1.0,523,2092,7845,5753
4305,1.0,1.0,1.0,524,2096,7860,5764
4314,1.0,1.0,1.0,525,2100,7875,5775
4343,1.0,1.0,1.0,526,2104,7890,5786
4351,1.0,1.0,1.0,527,2108,7905,5797
4352,1.0,1.0,1.0,528,2112,7920,5808
4359,1.0,1.0,1.0,529,2116,7935,5819
4371,1.0,1.0,1.0,530,2120,7950,5830
4375,1.0,1.0,1.0,531,2124,7965,5841
4389,1.0,1.0,1.0,532,2128,7980,5852
4393,1.0,1.0,1.0,533,2132,7995,5863
4395,1.0,1.0,1.0,534,2136,8010,5874
4409,1.0,1.0,1.0,535,2140,8025,5885
4413,1.0,1.0,1.0,536,2144,8040,5896
4417,1.0,1.0,1.0,537,2148,8055,5907
4418,1.0,1.0,1.0,538,2152,8070,5918
4428,1.0,1.0,1.0,539,2156,8085,5929
4429,1.0,1.0,1.0,540,2160,8100,5940
4434,1.0,1.0,1.0,541,2164,8115,5951
4447,1.0,1.0,1.0,542,2168,8130,5962
4452,1.0,1.0,1.0,543,2172,8145,5973
4457,1.0,1.0,1.0,544,2176,8160,5984
4459,1.0,1.0,1.0,545,2180,8175,5995
4463,1.0,1.0,1.0,546,2184,8190,6006
4490,1.0,1.0,1.0,547,2188,8205,6017
4495,1.0,1.0,1.0,548,2192,8220,6028
4500,1.0,1.0,1.0,549,2196,8235,6039
4510,1.0,1.0,1.0,550,2200,8250,6050
4520,1.0,1.0,1.0,551,2204,8265,6061
4535,1.0,1.0,1.0,552,2208,8280,6072
4576,1.0,1.0,1.0,553,2212,8295,6083
4585,1.0,1.0,1.0,554,2216,8310,6094
4591,1.0,1.0,1.0,555,2220,8325,6105
4594,1.0,1.0,1.0,556,2224,8340,6116
4596,1.0,1.0,1.0,557,2228,8355,6127
4599,1.0,1.0,1.0,558,2232,8370,6138
4607,1.0,1.0,1.0,559,2236,8385,6149
4612,1.0,1.0,1.0,560,2240,8400,6160
4613,1.0,1.0,1.0,561,2244,8415,6171
4623,1.0,1.0,1.0,562,2248,8430,6182
4632,1.0,1.0,1.0,563,2252,8445,6193
4639,1.0,1.0,1.0,564,2256,8460,6204
4653,1.0,1.0,1.0,565,2260,8475,6215
4657,1.0,1.0,1.0,566,2264,8490,6226
4663,1.0,1.0,1.0,567,2268,8505,6237
4674,1.0,1.0,1.0,568,2272,8520,6248
4680,1.0,1.0,1.0,569,2276,8535,6259
4683,1.0,1.0,1.0,570,2280,8550,6270
4685,1.0,1.0,1.0,571,2284,8565,6281
4701,1.0,1.0,1.0,572,2288,8580,6292
4705,1.0,1.0,1.0,573,2292,8595,6303
4707,1.0,1.0,1.0,574,2296,8610,6314
4722,1.0,1.0,1.0,575,2300,8625,6325
4724,1.0,1.0,1.0,576,2304,8640,6336
4730,1.0,1.0,1.0,577,2308,8655,6347
4742,1.0,1.0,1.0,578,2312,8670,6358
4749,1.0,1.0,1.0,579,2316,8685,6369
4771,1.0,1.0,1.0,580,2320,8700,6380
4777,1.0,1.0,1.0,581,2324,8715,6391
4782,1.0,1.0,1.0,582,2328,8730,6402
4792,1.0,1.0,1.0,583,2332,8745,6413
4796,1.0,1.0,1.0,584,2336,8760,6424
4806,1.0,1.0,1.0,585,2340,8775,6435
4807,1.0,1.0,1.0,586,2344,8790,6446
4814,1.0,1.0,1.0,587,2348,8805,6457
4859,1.0,1.0,1.0,588,2352,8820,6468
4870,1.0,1.0,1.0,589,2356,8835,6479
4873,1.0,1.0,1.0,590,2360,8850,6490
4885,1.0,1.0,1.0,591,2364,8865,6501
4887,1.0,1.0,1.0,592,2368,8880,6512
4892,1.0,1.0,1.0,593,2372,8895,6523
4897,1.0,1.0,1.0,594,2376,8910,6534
4899,1.0,1.0,1.0,595,2380,8925,6545
4901,1.0,1.0,1.0,596,2384,8940,6556
4945,1.0,1.0,1.0,597,2388,8955,6567
4946,1.0,1.0,1.0,598,2392,8970,6578
4974,1.0,1.0,1.0,599,2396,8985,6589
4979,1.0,1.0,1.0,600,2400,9000,6600
4983,1.0,1.0,1.0,601,2404,9015,6611
4990,1.0,1.0,1.0,602,2408,9030,6622
5000,1.0,1.0,1.0,603,2412,9045,6633
5002,1.0,1.0,1.0,604,2416,9060,6644
5015,1.0,1.0,1.0,605,2420,9075,6655
5019,1.0,1.0,1.0,606,2424,9090,6666
5025,1.0,1.0,1.0,607,2428,9105,6677
5049,1.0,1.0,1.0,608,2432,9120,6688
5060,1.0,1.0,1.0,609,2436,9135,6699
5063,1.0,1.0,1.0,610,2440,9150,6710
5078,1.0,1.0,1.0,611,2444,9165,6721
5081,1.0,1.0,1.0,612,2448,9180,6732
5086,1.0,1.0,1.0,613,2452,9195,6743
5093,1.0,1.0,1.0,614,2456,9210,6754
5106,1.0,1.0,1.0,615,2460,9225,6765
5122,1.0,1.0,1.0,616,2464,9240,6776
5124,1.0,1.0,1.0,617,2468,9255,6787
5139,1.0,1.0,1.0,618,2472,9270,6798
5172,1.0,1.0,1.0,619,2476,9285,6809
5176,1.0,1.0,1.0,620,2480,9300,6820
5180,1.0,1.0,1.0,621,2484,9315,6831
5185,1.0,1.0,1.0,622,2488,9330,6842
5189,1.0,1.0,1.0,623,2492,9345,6853
5213,1.0,1.0,1.0,624,2496,9360,6864
5218,1.0,1.0,1.0,625,2500,9375,6875
5220,1.0,1.0,1.0,626,2504,9390,6886
5226,1.0,1.0,1.0,627,2508,9405,6897
5250,1.0,1.0,1.0,628,2512,9420,6908
5257,1.0,1.0,1.0,629,2516,9435,6919
5261,1.0,1.0,1.0,630,2520,9450,6930
5264,1.0,1.0,1.0,631,2524,9465,6941
5273,1.0,1.0,1.0,632,2528,9480,6952
5282,1.0,1.0,1.0,633,2532,9495,6963
5287,1.0,1.0,1.0,634,2536,9510,6974
5289,1.0,1.0,1.0,635,2540,9525,6985
5301,1.0,1.0,1.0,636,2544,9540,6996
5302,1.0,1.0,1.0,637,2548,9555,7007
5304,1.0,1.0,1.0,638,2552,9570,7018
5316,1.0,1.0,1.0,639,2556,9585,7029
5325,1.0,1.0,1.0,640,2560,9600,7040
5339,1.0,1.0,1.0,641,2564,9615,7051
5347,1.0,1.0,1.0,642,2568,9630,7062
5361,1.0,1.0,1.0,643,2572,9645,7073
5383,1.0,1.0,1.0,644,2576,9660,7084
5403,1.0,1.0,1.0,645,2580,9675,7095
5404,1.0,1.0,1.0,646,2584,9690,7106
5410,1.0,1.0,1.0,647,2588,9705,7117
5415,1.0,1.0,1.0,648,2592,9720,7128
5438,1.0,1.0,1.0,649,2596,9735,7139
5456,1.0,1.0,1.0,650,2600,9750,7150
5468,1.0,1.0,1.0,651,2604,9765,7161
5470,1.0,1.0,1.0,652,2608,9780,7172
5475,1.0,1.0,1.0,653,2612,9795,7183
5478,1.0,1.0,1.0,654,2616,9810,7194
5479,1.0,1.0,1.0,655,2620,9825,7205
5484,1.0,1.0,1.0,656,2624,9840,7216
5490,1.0,1.0,1.0,657,2628,9855,7227
5500,1.0,1.0,1.0,658,2632,9870,7238
5525,1.0,1.0,1.0,659,2636,9885,7249
5526,1.0,1.0,1.0,660,2640,9900,7260
5542,1.0,1.0,1.0,661,2644,9915,7271
5547,1.0,1.0,1.0,662,2648,9930,7282
5570,1.0,1.0,1.0,663,2652,9945,7293
5573,1.0,1.0,1.0,664,2656,9960,7304
5585,1.0,1.0,1.0,665,2660,9975,7315
5594,1.0,1.0,1.0,666,2664,9990,7326
5601,1.0,1.0,1.0,667,2668,10005,7337
5605,1.0,1.0,1.0,668,2672,10020,7348
5616,1.0,1.0,1.0,669,2676,10035,7359
5622,1.0,1.0,1.0,670,2680,10050,7370
5642,1.0,1.0,1.0,671,2684,10065,7381
5643,1.0,1.0,1.0,672,2688,10080,7392
5649,1.0,1.0,1.0,673,2692,10095,7403
5664,1.0,1.0,1.0,674,2696,10110,7414
5683,1.0,1.0,1.0,675,2700,10125,7425
5692,1.0,1.0,1.0,676,2704,10140,7436
5693,1.0,1.0,1.0,677,2708,10155,7447
5702,1.0,1.0,1.0,678,2712,10170,7458
5713,1.0,1.0,1.0,679,2716,10185,7469
5715,1.0,1.0,1.0,680,2720,10200,7480
5716,1.0,1.0,1.0,681,2724,10215,7491
5725,1.0,1.0,1.0,682,2728,10230,7502
5726,1.0,1.0,1.0,683,2732,10245,7513
5727,1.0,1.0,1.0,684,2736,10260,7524
5735,1.0,1.0,1.0,685,2740,10275,7535
5744,1.0,1.0,1.0,686,2744,10290,7546
5752,1.0,1.0,1.0,687,2748,10305,7557
5758,1.0,1.0,1.0,688,2752,10320,7568
5759,1.0,1.0,1.0,689,2756,10335,7579
5765,1.0,1.0,1.0,690,2760,10350,7590
5766,1.0,1.0,1.0,691,2764,10365,7601
5768,1.0,1.0,1.0,692,2768,10380,7612
5771,1.0,1.0,1.0,693,2772,10395,7623
5780,1.0,1.0,1.0,694,2776,10410,7634
5799,1.0,1.0,1.0,695,2780,10425,7645
5802,1.0,1.0,1.0,696,2784,10440,7656
5816,1.0,1.0,1.0,697,2788,10455,7667
5830,1.0,1.0,1.0,698,2792,10470,7678
5837,1.0,1.0,1.0,699,2796,10485,7689
5840,1.0,1.0,1.0,700,2800,10500,7700
5848,1.0,1.0,1.0,701,2804,10515,7711
5852,1.0,1.0,1.0,702,2808,10530,7722
5854,1.0,1.0,1.0,703,2812,10545,7733
5857,1.0,1.0,1.0,704,2816,10560,7744
5865,1.0,1.0,1.0,705,2820,10575,7755
5871,1.0,1.0,1.0,706,2824,10590,7766
5874,1.0,1.0,1.0,707,2828,10605,7777
5877,1.0,1.0,1.0,708,2832,10620,7788
5883,1.0,1.0,1.0,709,2836,10635,7799
5884,1.0,1.0,1.0,710,2840,10650,7810
5885,1.0,1.0,1.0,711,2844,10665,7821
5889,1.0,1.0,1.0,712,2848,10680,7832
5905,1.0,1.0,1.0,713,2852,10695,7843
5908,1.0,1.0,1.0,714,2856,10710,7854
5913,1.0,1.0,1.0,715,2860,10725,7865
5923,1.0,1.0,1.0,716,2864,10740,7876
5927,1.0,1.0,1.0,717,2868,10755,7887
5928,1.0,1.0,1.0,718,2872,10770,7898
5931,1.0,1.0,1.0,719,2876,10785,7909
5943,1.0,1.0,1.0,720,2880,10800,7920
5945,1.0,1.0,1.0,721,2884,10815,7931
5951,1.0,1.0,1.0,722,2888,10830,7942
5953,1.0,1.0,1.0,723,2892,10845,7953
5967,1.0,1.0,1.0,724,2896,10860,7964
5969,1.0,1.0,1.0,725,2900,10875,7975
5981,1.0,1.0,1.0,726,2904,10890,7986
5984,1.0,1.0,1.0,727,2908,10905,7997
6005,1.0,1.0,1.0,728,2912,10920,8008
6008,1.0,1.0,1.0,729,2916,10935,8019
6012,1.0,1.0,1.0,730,2920,10950,8030
6036,1.0,1.0,1.0,731,2924,10965,8041
6038,1.0,1.0,1.0,732,2928,10980,8052
6040,1.0,1.0,1.0,733,2932,10995,8063
6047,1.0,1.0,1.0,734,2936,11010,8074
6060,1.0,1.0,1.0,735,2940,11025,8085
6074,1.0,1.0,1.0,736,2944,11040,8096
6076,1.0,1.0,1.0,737,2948,11055,8107
6079,1.0,1.0,1.0,738,2952,11070,8118
6082,1.0,1.0,1.0,739,2956,11085,8129
6084,1.0,1.0,1.0,740,2960,11100,8140
6089,1.0,1.0,1.0,741,2964,11115,8151
6094,1.0,1.0,1.0,742,2968,11130,8162
6103,1.0,1.0,1.0,743,2972,11145,8173
6104,1.0,1.0,1.0,744,2976,11160,8184
6105,1.0,1.0,1.0,745,2980,11175,8195
6106,1.0,1.0,1.0,746,2984,11190,8206
6111,1.0,1.0,1.0,747,2988,11205,8217
6112,1.0,1.0,1.0,748,2992,11220,8228
6117,1.0,1.0,1.0,749,2996,11235,8239
6125,1.0,1.0,1.0,750,3000,11250,8250
6128,1.0,1.0,1.0,751,3004,11265,8261
6135,1.0,1.0,1.0,752,3008,11280,8272
6152,1.0,1.0,1.0,753,3012,11295,8283
6154,1.0,1.0,1.0,754,3016,11310,8294
6159,1.0,1.0,1.0,755,3020,11325,8305
6170,1.0,1.0,1.0,756,3024,11340,8316
6179,1.0,1.0,1.0,757,3028,11355,8327
6189,1.0,1.0,1.0,758,3032,11370,8338
6194,1.0,1.0,1.0,759,3036,11385,8349
6196,1.0,1.0,1.0,760,3040,11400,8360
6197,1.0,1.0,1.0,761,3044,11415,8371
6203,1.0,1.0,1.0,762,3048,11430,8382
6205,1.0,1.0,1.0,763,3052,11445,8393
6219,1.0,1.0,1.0,764,3056,11460,8404
6226,1.0,1.0,1.0,765,3060,11475,8415
6245,1.0,1.0,1.0,766,3064,11490,8426
6269,1.0,1.0,1.0,767,3068,11505,8437
6290,1.0,1.0,1.0,768,3072,11520,8448
6305,1.0,1.0,1.0,769,3076,11535,8459
6329,1.0,1.0,1.0,770,3080,11550,8470
6330,1.0,1.0,1.0,771,3084,11565,8481
6334,1.0,1.0,1.0,772,3088,11580,8492
6343,1.0,1.0,1.0,773,3092,11595,8503
6349,1.0,1.0,1.0,774,3096,11610,8514
6354,1.0,1.0,1.0,775,3100,11625,8525
6391,1.0,1.0,1.0,776,3104,11640,8536
6406,1.0,1.0,1.0,777,3108,11655,8547
6409,1.0,1.0,1.0,778,3112,11670,8558
6422,1.0,1.0,1.0,779,3116,11685,8569
6434,1.0,1.0,1.0,780,3120,11700,8580
6454,1.0,1.0,1.0,781,3124,11715,8591
6462,1.0,1.0,1.0,782,3128,11730,8602
6466,1.0,1.0,1.0,783,3132,11745,8613
6487,1.0,1.0,1.0,784,3136,11760,8624
6519,1.0,1.0,1.0,785,3140,11775,8635
6528,1.0,1.0,1.0,786,3144,11790,8646
6539,1.0,1.0,1.0,787,3148,11805,8657
6548,1.0,1.0,1.0,788,3152,11820,8668
6563,1.0,1.0,1.0,789,3156,11835,8679
6566,1.0,1.0,1.0,790,3160,11850,8690
6577,1.0,1.0,1.0,791,3164,11865,8701
6581,1.0,1.0,1.0,792,3168,11880,8712
6590,1.0,1.0,1.0,793,3172,11895,8723
6591,1.0,1.0,1.0,794,3176,11910,8734
6611,1.0,1.0,1.0,795,3180,11925,8745
6619,1.0,1.0,1.0,796,3184,11940,8756
6620,1.0,1.0,1.0,797,3188,11955,8767
6626,1.0,1.0,1.0,798,3192,11970,8778
6628,1.0,1.0,1.0,799,3196,11985,8789
6629,1.0,1.0,1.0,800,3200,12000,8800
6634,1.0,1.0,1.0,801,3204,12015,8811
6649,1.0,1.0,1.0,802,3208,12030,8822
6654,1.0,1.0,1.0,803,3212,12045,8833
6695,1.0,1.0,1.0,804,3216,12060,8844
6701,1.0,1.0,1.0,805,3220,12075,8855
6705,1.0,1.0,1.0,806,3224,12090,8866
6711,1.0,1.0,1.0,807,3228,12105,8877
6716,1.0,1.0,1.0,808,3232,12120,8888
6720,1.0,1.0,1.0,809,3236,12135,8899
6722,1.0,1.0,1.0,810,3240,12150,8910
6724,1.0,1.0,1.0,811,3244,12165,8921
6727,1.0,1.0,1.0,812,3248,12180,8932
6742,1.0,1.0,1.0,813,3252,12195,8943
6748,1.0,1.0,1.0,814,3256,12210,8954
6756,1.0,1.0,1.0,815,3260,12225,8965
6757,1.0,1.0,1.0,816,3264,12240,8976
6759,1.0,1.0,1.0,817,3268,12255,8987
6773,1.0,1.0,1.0,818,3272,12270,8998
6781,1.0,1.0,1.0,819,3276,12285,9009
6786,1.0,1.0,1.0,820,3280,12300,9020
6790,1.0,1.0,1.0,821,3284,12315,9031
6794,1.0,1.0,1.0,822,3288,12330,9042
6805,1.0,1.0,1.0,823,3292,12345,9053
6810,1.0,1.0,1.0,824,3296,12360,9064
6813,1.0,1.0,1.0,825,3300,12375,9075
6832,1.0,1.0,1.0,826,3304,12390,9086
6840,1.0,1.0,1.0,827,3308,12405,9097
6844,1.0,1.0,1.0,828,3312,12420,9108
6853,1.0,1.0,1.0,829,3316,12435,9119
6856,1.0,1.0,1.0,830,3320,12450,9130
6860,1.0,1.0,1.0,831,3324,12465,9141
6869,1.0,1.0,1.0,832,3328,12480,9152
6871,1.0,1.0,1.0,833,3332,12495,9163
6885,1.0,1.0,1.0,834,3336,12510,9174
6887,1.0,1.0,1.0,835,3340,12525,9185
6903,1.0,1.0,1.0,836,3344,12540,9196
6908,1.0,1.0,1.0,837,3348,12555,9207
6945,1.0,1.0,1.0,838,3352,12570,9218
6957,1.0,1.0,1.0,839,3356,12585,9229
6968,1.0,1.0,1.0,840,3360,12600,9240
6976,1.0,1.0,1.0,841,3364,12615,9251
6979,1.0,1.0,1.0,842,3368,12630,9262
6985,1.0,1.0,1.0,843,3372,12645,9273
6986,1.0,1.0,1.0,844,3376,12660,9284
7000,1.0,1.0,1.0,845,3380,12675,9295
7001,1.0,1.0,1.0,846,3384,12690,9306
7019,1.0,1.0,1.0,847,3388,12705,9317
7020,1.0,1.0,1.0,848,3392,12720,9328
7022,1.0,1.0,1.0,849,3396,12735,9339
7041,1.0,1.0,1.0,850,3400,12750,9350
7047,1.0,1.0,1.0,851,3404,12765,9361
7081,1.0,1.0,1.0,852,3408,12780,9372
7087,1.0,1.0,1.0,853,3412,12795,9383
7099,1.0,1.0,1.0,854,3416,12810,9394
7102,1.0,1.0,1.0,855,3420,12825,9405
7103,1.0,1.0,1.0,856,3424,12840,9416
7105,1.0,1.0,1.0,857,3428,12855,9427
7110,1.0,1.0,1.0,858,3432,12870,9438
7115,1.0,1.0,1.0,859,3436,12885,9449
7122,1.0,1.0,1.0,860,3440,12900,9460
7124,1.0,1.0,1.0,861,3444,12915,9471
7127,1.0,1.0,1.0,862,3448,12930,9482
7136,1.0,1.0,1.0,863,3452,12945,9493
7142,1.0,1.0,1.0,864,3456,12960,9504
7143,1.0,1.0,1.0,865,3460,12975,9515
7144,1.0,1.0,1.0,866,3464,12990,9526
7149,1.0,1.0,1.0,867,3468,13005,9537
7153,1.0,1.0,1.0,868,3472,13020,9548
7163,1.0,1.0,1.0,869,3476,13035,9559
7172,1.0,1.0,1.0,870,3480,13050,9570
7188,1.0,1.0,1.0,871,3484,13065,9581
7189,1.0,1.0,1.0,872,3488,13080,9592
7194,1.0,1.0,1.0,873,3492,13095,9603
7197,1.0,1.0,1.0,874,3496,13110,9614
7203,1.0,1.0,1.0,875,3500,13125,9625
7212,1.0,1.0,1.0,876,3504,13140,9636
7231,1.0,1.0,1.0,877,3508,13155,9647
7233,1.0,1.0,1.0,878,3512,13170,9658
7245,1.0,1.0,1.0,879,3516,13185,9669
7258,1.0,1.0,1.0,880,3520,13200,9680
7270,1.0,1.0,1.0,881,3524,13215,9691
7275,1.0,1.0,1.0,882,3528,13230,9702
7283,1.0,1.0,1.0,883,3532,13245,9713
7290,1.0,1.0,1.0,884,3536,13260,9724
7299,1.0,1.0,1.0,885,3540,13275,9735
7304,1.0,1.0,1.0,886,3544,13290,9746
7306,1.0,1.0,1.0,887,3548,13305,9757
7310,1.0,1.0,1.0,888,3552,13320,9768
7313,1.0,1.0,1.0,889,3556,13335,9779
7317,1.0,1.0,1.0,890,3560,13350,9790
7319,1.0,1.0,1.0,891,3564,13365,9801
7321,1.0,1.0,1.0,892,3568,13380,9812
7347,1.0,1.0,1.0,893,3572,13395,9823
7354,1.0,1.0,1.0,894,3576,13410,9834
7356,1.0,1.0,1.0,895,3580,13425,9845
7366,1.0,1.0,1.0,896,3584,13440,9856
7384,1.0,1.0,1.0,897,3588,13455,9867
7385,1.0,1.0,1.0,898,3592,13470,9878
7386,1.0,1.0,1.0,899,3596,13485,9889
7398,1.0,1.0,1.0,900,3600,13500,9900
7406,1.0,1.0,1.0,901,3604,13515,9911
7416,1.0,1.0,1.0,902,3608,13530,9922
7425,1.0,1.0,1.0,903,3612,13545,9933
7431,1.0,1.0,1.0,904,3616,13560,9944
7432,1.0,1.0,1.0,905,3620,13575,9955
7435,1.0,1.0,1.0,906,3624,13590,9966
7440,1.0,1.0,1.0,907,3628,13605,9977
7446,1.0,1.0,1.0,908,3632,13620,9988
7451,1.0,1.0,1.0,909,3636,13635,9999
7458,1.0,1.0,1.0,910,3640,13650,10010
7460,1.0,1.0,1.0,911,3644,13665,10021
7472,1.0,1.0,1.0,912,3648,13680,10032
7484,1.0,1.0,1.0,913,3652,13695,10043
7485,1.0,1.0,1.0,914,3656,13710,10054
7487,1.0,1.0,1.0,915,3660,13725,10065
7490,1.0,1.0,1.0,916,3664,13740,10076
7493,1.0,1.0,1.0,917,3668,13755,10087
7502,1.0,1.0,1.0,918,3672,13770,10098
7514,1.0,1.0,1.0,919,3676,13785,10109
7523,1.0,1.0,1.0,920,3680,13800,10120
7524,1.0,1.0,1.0,921,3684,13815,10131
7531,1.0,1.0,1.0,922,3688,13830,10142
7539,1.0,1.0,1.0,923,3692,13845,10153
7544,1.0,1.0,1.0,924,3696,13860,10164
7550,1.0,1.0,1.0,925,3700,13875,10175
7551,1.0,1.0,1.0,926,3704,13890,10186
7573,1.0,1.0,1.0,927,3708,13905,10197
7581,1.0,1.0,1.0,928,3712,13920,10208
7583,1.0,1.0,1.0,929,3716,13935,10219
7595,1.0,1.0,1.0,930,3720,13950,10230
7596,1.0,1.0,1.0,931,3724,13965,10241
7598,1.0,1.0,1.0,932,3728,13980,10252
7602,1.0,1.0,1.0,933,3732,13995,10263
7623,1.0,1.0,1.0,934,3736,14010,10274
7629,1.0,1.0,1.0,935,3740,14025,10285
7638,1.0,1.0,1.0,936,3744,14040,10296
7641,1.0,1.0,1.0,937,3748,14055,10307
7642,1.0,1.0,1.0,938,3752,14070,10318
7649,1.0,1.0,1.0,939,3756,14085,10329
7652,1.0,1.0,1.0,940,3760,14100,10340
7681,1.0,1.0,1.0,941,3764,14115,10351
7686,1.0,1.0,1.0,942,3768,14130,10362
7687,1.0,1.0,1.0,943,3772,14145,10373
7692,1.0,1.0,1.0,944,3776,14160,10384
7698,1.0,1.0,1.0,945,3780,14175,10395
7709,1.0,1.0,1.0,946,3784,14190,10406
7717,1.0,1.0,1.0,947,3788,14205,10417
7726,1.0,1.0,1.0,948,3792,14220,10428
7732,1.0,1.0,1.0,949,3796,14235,10439
7733,1.0,1.0,1.0,950,3800,14250,10450
7740,1.0,1.0,1.0,951,3804,14265,10461
7742,1.0,1.0,1.0,952,3808,14280,10472
7750,1.0,1.0,1.0,953,3812,14295,10483
7757,1.0,1.0,1.0,954,3816,14310,10494
7780,1.0,1.0,1.0,955,3820,14325,10505
7803,1.0,1.0,1.0,956,3824,14340,10516
7805,1.0,1.0,1.0,957,3828,14355,10527
7809,1.0,1.0,1.0,958,3832,14370,10538
7811,1.0,1.0,1.0,959,3836,14385,10549
7816,1.0,1.0,1.0,960,3840,14400,10560
7821,1.0,1.0,1.0,961,3844,14415,10571
7828,1.0,1.0,1.0,962,3848,14430,10582
7829,1.0,1.0,1.0,963,3852,14445,10593
7831,1.0,1.0,1.0,964,3856,14460,10604
7838,1.0,1.0,1.0,965,3860,14475,10615
7839,1.0,1.0,1.0,966,3864,14490,10626
7844,1.0,1.0,1.0,967,3868,14505,10637
7846,1.0,1.0,1.0,968,3872,14520,10648
7853,1.0,1.0,1.0,969,3876,14535,10659
7859,1.0,1.0,1.0,970,3880,14550,10670
7865,1.0,1.0,1.0,971,3884,14565,10681
7870,1.0,1.0,1.0,972,3888,14580,10692
7885,1.0,1.0,1.0,973,3892,14595,10703
7896,1.0,1.0,1.0,974,3896,14610,10714
7899,1.0,1.0,1.0,975,3900,14625,10725
7900,1.0,1.0,1.0,976,3904,14640,10736
7915,1.0,1.0,1.0,977,3908,14655,10747
7927,1.0,1.0,1.0,978,3912,14670,10758
7929,1.0,1.0,1.0,979,3916,14685,10769
7932,1.0,1.0,1.0,980,3920,14700,10780
7937,1.0,1.0,1.0,981,3924,14715,10791
7946,1.0,1.0,1.0,982,3928,14730,10802
7952,1.0,1.0,1.0,983,3932,14745,10813
7975,1.0,1.0,1.0,984,3936,14760,10824
7989,1.0,1.0,1.0,985,3940,14775,10835
8002,1.0,1.0,1.0,986,3944,14790,10846
8010,1.0,1.0,1.0,987,3948,14805,10857
8014,1.0,1.0,1.0,988,3952,14820,10868
8019,1.0,1.0,1.0,989,3956,14835,10879
8045,1.0,1.0,1.0,990,3960,14850,10890
8049,1.0,1.0,1.0,991,3964,14865,10901
8054,1.0,1.0,1.0,992,3968,14880,10912
8055,1.0,1.0,1.0,993,3972,14895,10923
8063,1.0,1.0,1.0,994,3976,14910,10934
8068,1.0,1.0,1.0,995,3980,14925,10945
8073,1.0,1.0,1.0,996,3984,14940,10956
8083,1.0,1.0,1.0,997,3988,14955,10967
8089,1.0,1.0,1.0,998,3992,14970,10978
8109,1.0,1.0,1.0,999,3996,14985,10989
8111,1.0,1.0,1.0,1000,4000,15000,11000
8118,1.0,1.0,1.0,1001,4004,15015,11011
8119,1.0,1.0,1.0,1002,4008,15030,11022
8129,1.0,1.0,1.0,1003,4012,15045,11033
8158,1.0,1.0,1.0,1004,4016,15060,11044
8160,1.0,1.0,1.0,1005,4020,15075,11055
8171,1.0,1.0,1.0,1006,4024,15090,11066
8187,1.0,1.0,1.0,1007,4028,15105,11077
8203,1.0,1.0,1.0,1008,4032,15120,11088
8208,1.0,1.0,1.0,1009,4036,15135,11099
8216,1.0,1.0,1.0,1010,4040,15150,11110
8243,1.0,1.0,1.0,1011,4044,15165,11121
8245,1.0,1.0,1.0,1012,4048,15180,11132
8261,1.0,1.0,1.0,1013,4052,15195,11143
8265,1.0,1.0,1.0,1014,4056,15210,11154
8276,1.0,1.0,1.0,1015,4060,15225,11165
8277,1.0,1.0,1.0,1016,4064,15240,11176
8289,1.0,1.0,1.0,1017,4068,15255,11187
8305,1.0,1.0,1.0,1018,4072,15270,11198
8312,1.0,1.0,1.0,1019,4076,15285,11209
8321,1.0,1.0,1.0,1020,4080,15300,11220
8322,1.0,1.0,1.0,1021,4084,15315,11231
8356,1.0,1.0,1.0,1022,4088,15330,11242
8362,1.0,1.0,1.0,1023,4092,15345,11253
8406,1.0,1.0,1.0,1024,4096,15360,11264
8408,1.0,1.0,1.0,1025,4100,15375,11275
8419,1.0,1.0,1.0,1026,4104,15390,11286
8436,1.0,1.0,1.0,1027,4108,15405,11297
8442,1.0,1.0,1.0,1028,4112,15420,11308
8446,1.0,1.0,1.0,1029,4116,15435,11319
8457,1.0,1.0,1.0,1030,4120,15450,11330
8459,1.0,1.0,1.0,1031,4124,15465,11341
8461,1.0,1.0,1.0,1032,4128,15480,11352
8462,1.0,1.0,1.0,1033,4132,15495,11363
8489,1.0,1.0,1.0,1034,4136,15510,11374
8491,1.0,1.0,1.0,1035,4140,15525,11385
8499,1.0,1.0,1.0,1036,4144,15540,11396
8501,1.0,1.0,1.0,1037,4148,15555,11407
8515,1.0,1.0,1.0,1038,4152,15570,11418
8521,1.0,1.0,1.0,1039,4156,15585,11429
8525,1.0,1.0,1.0,1040,4160,15600,11440
8544,1.0,1.0,1.0,1041,4164,15615,11451
8546,1.0,1.0,1.0,1042,4168,15630,11462
8549,1.0,1.0,1.0,1043,4172,15645,11473
8553,1.0,1.0,1.0,1044,4176,15660,11484
8567,1.0,1.0,1.0,1045,4180,15675,11495
8569,1.0,1.0,1.0,1046,4184,15690,11506
8577,1.0,1.0,1.0,1047,4188,15705,11517
8584,1.0,1.0,1.0,1048,4192,15720,11528
8587,1.0,1.0,1.0,1049,4196,15735,11539
8615,1.0,1.0,1.0,1050,4200,15750,11550
8619,1.0,1.0,1.0,1051,4204,15765,11561
8620,1.0,1.0,1.0,1052,4208,15780,11572
8623,1.0,1.0,1.0,1053,4212,15795,11583
8627,1.0,1.0,1.0,1054,4216,15810,11594
8636,1.0,1.0,1.0,1055,4220,15825,11605
8638,1.0,1.0,1.0,1056,4224,15840,11616
8640,1.0,1.0,1.0,1057,4228,15855,11627
8657,1.0,1.0,1.0,1058,4232,15870,11638
8658,1.0,1.0,1.0,1059,4236,15885,11649
8661,1.0,1.0,1.0,1060,4240,15900,11660
8671,1.0,1.0,1.0,1061,4244,15915,11671
8673,1.0,1.0,1.0,1062,4248,15930,11682
8674,1.0,1.0,1.0,1063,4252,15945,11693
8675,1.0,1.0,1.0,1064,4256,15960,11704
8676,1.0,1.0,1.0,1065,4260,15975,11715
8679,1.0,1.0,1.0,1066,4264,15990,11726
8685,1.0,1.0,1.0,1067,4268,16005,11737
8692,1.0,1.0,1.0,1068,4272,16020,11748
8693,1.0,1.0,1.0,1069,4276,16035,11759
8697,1.0,1.0,1.0,1070,4280,16050,11770
8727,1.0,1.0,1.0,1071,4284,16065,11781
8748,1.0,1.0,1.0,1072,4288,16080,11792
8770,1.0,1.0,1.0,1073,4292,16095,11803
8774,1.0,1.0,1.0,1074,4296,16110,11814
8776,1.0,1.0,1.0,1075,4300,16125,11825
8778,1.0,1.0,1.0,1076,4304,16140,11836
8783,1.0,1.0,1.0,1077,4308,16155,11847
8793,1.0,1.0,1.0,1078,4312,16170,11858
8798,1.0,1.0,1.0,1079,4316,16185,11869
8811,1.0,1.0,1.0,1080,4320,16200,11880
8814,1.0,1.0,1.0,1081,4324,16215,11891
8818,1.0,1.0,1.0,1082,4328,16230,11902
8820,1.0,1.0,1.0,1083,4332,16245,11913
8824,1.0,1.0,1.0,1084,4336,16260,11924
8826,1.0,1.0,1.0,1085,4340,16275,11935
8833,1.0,1.0,1.0,1086,4344,16290,11946
8834,1.0,1.0,1.0,1087,4348,16305,11957
8845,1.0,1.0,1.0,1088,4352,16320,11968
8859,1.0,1.0,1.0,1089,4356,16335,11979
8861,1.0,1.0,1.0,1090,4360,16350,11990
8863,1.0,1.0,1.0,1091,4364,16365,12001
8875,1.0,1.0,1.0,1092,4368,16380,12012
8884,1.0,1.0,1.0,1093,4372,16395,12023
8886,1.0,1.0,1.0,1094,4376,16410,12034
8891,1.0,1.0,1.0,1095,4380,16425,12045
8908,1.0,1.0,1.0,1096,4384,16440,12056
8912,1.0,1.0,1.0,1097,4388,16455,12067
8914,1.0,1.0,1.0,1098,4392,16470,12078
8918,1.0,1.0,1.0,1099,4396,16485,12089
8919,1.0,1.0,1.0,1100,4400,16500,12100
8926,1.0,1.0,1.0,1101,4404,16515,12111
8930,1.0,1.0,1.0,1102,4408,16530,12122
8934,1.0,1.0,1.0,1103,4412,16545,12133
8945,1.0,1.0,1.0,1104,4416,16560,12144
8980,1.0,1.0,1.0,1105,4420,16575,12155
9003,1.0,1.0,1.0,1106,4424,16590,12166
9017,1.0,1.0,1.0,1107,4428,16605,12177
9020,1.0,1.0,1.0,1108,4432,16620,12188
9021,1.0,1.0,1.0,1109,4436,16635,12199
9022,1.0,1.0,1.0,1110,4440,16650,12210
9023,1.0,1.0,1.0,1111,4444,16665,12221
9028,1.0,1.0,1.0,1112,4448,16680,12232
9037,1.0,1.0,1.0,1113,4452,16695,12243
9043,1.0,1.0,1.0,1114,4456,16710,12254
9045,1.0,1.0,1.0,1115,4460,16725,12265
9046,1.0,1.0,1.0,1116,4464,16740,12276
9061,1.0,1.0,1.0,1117,4468,16755,12287
9062,1.0,1.0,1.0,1118,4472,16770,12298
9064,1.0,1.0,1.0,1119,4476,16785,12309
9065,1.0,1.0,1.0,1120,4480,16800,12320
9067,1.0,1.0,1.0,1121,4484,16815,12331
9080,1.0,1.0,1.0,1122,4488,16830,12342
9084,1.0,1.0,1.0,1123,4492,16845,12353
9090,1.0,1.0,1.0,1124,4496,16860,12364
9092,1.0,1.0,1.0,1125,4500,16875,12375
9093,1.0,1.0,1.0,1126,4504,16890,12386
9107,1.0,1.0,1.0,1127,4508,16905,12397
9111,1.0,1.0,1.0,1128,4512,16920,12408
9112,1.0,1.0,1.0,1129,4516,16935,12419
9116,1.0,1.0,1.0,1130,4520,16950,12430
9121,1.0,1.0,1.0,1131,4524,16965,12441
9130,1.0,1.0,1.0,1132,4528,16980,12452
9139,1.0,1.0,1.0,1133,4532,16995,12463
9153,1.0,1.0,1.0,1134,4536,17010,12474
9157,1.0,1.0,1.0,1135,4540,17025,12485
9159,1.0,1.0,1.0,1136,4544,17040,12496
9173,1.0,1.0,1.0,1137,4548,17055,12507
9180,1.0,1.0,1.0,1138,4552,17070,12518
9185,1.0,1.0,1.0,1139,4556,17085,12529
9187,1.0,1.0,1.0,1140,4560,17100,12540
9199,1.0,1.0,1.0,1141,4564,17115,12551
9200,1.0,1.0,1.0,1142,4568,17130,12562
9202,1.0,1.0,1.0,1143,4572,17145,12573
9212,1.0,1.0,1.0,1144,4576,17160,12584
9219,1.0,1.0,1.0,1145,4580,17175,12595
9232,1.0,1.0,1.0,1146,4584,17190,12606
9237,1.0,1.0,1.0,1147,4588,17205,12617
9240,1.0,1.0,1.0,1148,4592,17220,12628
9243,1.0,1.0,1.0,1149,4596,17235,12639
9249,1.0,1.0,1.0,1150,4600,17250,12650
9250,1.0,1.0,1.0,1151,4604,17265,12661
9257,1.0,1.0,1.0,1152,4608,17280,12672
9258,1.0,1.0,1.0,1153,4612,17295,12683
9260,1.0,1.0,1.0,1154,4616,17310,12694
9261,1.0,1.0,1.0,1155,4620,17325,12705
9278,1.0,1.0,1.0,1156,4624,17340,12716
9283,1.0,1.0,1.0,1157,4628,17355,12727
9287,1.0,1.0,1.0,1158,4632,17370,12738
9293,1.0,1.0,1.0,1159,4636,17385,12749
9295,1.0,1.0,1.0,1160,4640,17400,12760
9303,1.0,1.0,1.0,1161,4644,17415,12771
9306,1.0,1.0,1.0,1162,4648,17430,12782
9308,1.0,1.0,1.0,1163,4652,17445,12793
9310,1.0,1.0,1.0,1164,4656,17460,12804
9319,1.0,1.0,1.0,1165,4660,17475,12815
9326,1.0,1.0,1.0,1166,4664,17490,12826
9328,1.0,1.0,1.0,1167,4668,17505,12837
9329,1.0,1.0,1.0,1168,4672,17520,12848
9331,1.0,1.0,1.0,1169,4676,17535,12859
9333,1.0,1.0,1.0,1170,4680,17550,12870
9334,1.0,1.0,1.0,1171,4684,17565,12881
9340,1.0,1.0,1.0,1172,4688,17580,12892
9341,1.0,1.0,1.0,1173,4692,17595,12903
9344,1.0,1.0,1.0,1174,4696,17610,12914
9348,1.0,1.0,1.0,1175,4700,17625,12925
9372,1.0,1.0,1.0,1176,4704,17640,12936
9391,1.0,1.0,1.0,1177,4708,17655,12947
9399,1.0,1.0,1.0,1178,4712,17670,12958
9405,1.0,1.0,1.0,1179,4716,17685,12969
9406,1.0,1.0,1.0,1180,4720,17700,12980
9407,1.0,1.0,1.0,1181,4724,17715,12991
9411,1.0,1.0,1.0,1182,4728,17730,13002
9412,1.0,1.0,1.0,1183,4732,17745,13013
9414,1.0,1.0,1.0,1184,4736,17760,13024
9416,1.0,1.0,1.0,1185,4740,17775,13035
9417,1.0,1.0,1.0,1186,4744,17790,13046
9419,1.0,1.0,1.0,1187,4748,17805,13057
9427,1.0,1.0,1.0,1188,4752,17820,13068
9429,1.0,1.0,1.0,1189,4756,17835,13079
9438,1.0,1.0,1.0,1190,4760,17850,13090
9439,1.0,1.0,1.0,1191,4764,17865,13101
9447,1.0,1.0,1.0,1192,4768,17880,13112
9492,1.0,1.0,1.0,1193,4772,17895,13123
9495,1.0,1.0,1.0,1194,4776,17910,13134
9501,1.0,1.0,1.0,1195,4780,17925,13145
9509,1.0,1.0,1.0,1196,4784,17940,13156
9515,1.0,1.0,1.0,1197,4788,17955,13167
9518,1.0,1.0,1.0,1198,4792,17970,13178
9537,1.0,1.0,1.0,1199,4796,17985,13189
9542,1.0,1.0,1.0,1200,4800,18000,13200
9571,1.0,1.0,1.0,1201,4804,18015,13211
9579,1.0,1.0,1.0,1202,4808,18030,13222
9586,1.0,1.0,1.0,1203,4812,18045,13233
9607,1.0,1.0,1.0,1204,4816,18060,13244
9613,1.0,1.0,1.0,1205,4820,18075,13255
9617,1.0,1.0,1.0,1206,4824,18090,13266
9627,1.0,1.0,1.0,1207,4828,18105,13277
9636,1.0,1.0,1.0,1208,4832,18120,13288
9638,1.0,1.0,1.0,1209,4836,18135,13299
9654,1.0,1.0,1.0,1210,4840,18150,13310
9658,1.0,1.0,1.0,1211,4844,18165,13321
9668,1.0,1.0,1.0,1212,4848,18180,13332
9670,1.0,1.0,1.0,1213,4852,18195,13343
9672,1.0,1.0,1.0,1214,4856,18210,13354
9681,1.0,1.0,1.0,1215,4860,18225,13365
9687,1.0,1.0,1.0,1216,4864,18240,13376
9697,1.0,1.0,1.0,1217,4868,18255,13387
9703,1.0,1.0,1.0,1218,4872,18270,13398
9719,1.0,1.0,1.0,1219,4876,18285,13409
9741,1.0,1.0,1.0,1220,4880,18300,13420
9742,1.0,1.0,1.0,1221,4884,18315,13431
9743,1.0,1.0,1.0,1222,4888,18330,13442
9755,1.0,1.0,1.0,1223,4892,18345,13453
9778,1.0,1.0,1.0,1224,4896,18360,13464
9782,1.0,1.0,1.0,1225,4900,18375,13475
9783,1.0,1.0,1.0,1226,4904,18390,13486
9785,1.0,1.0,1.0,1227,4908,18405,13497
9798,1.0,1.0,1.0,1228,4912,18420,13508
9818,1.0,1.0,1.0,1229,4916,18435,13519
9822,1.0,1.0,1.0,1230,4920,18450,13530
9827,1.0,1.0,1.0,1231,4924,18465,13541
9836,1.0,1.0,1.0,1232,4928,18480,13552
9845,1.0,1.0,1.0,1233,4932,18495,13563
9853,1.0,1.0,1.0,1234,4936,18510,13574
9861,1.0,1.0,1.0,1235,4940,18525,13585
9867,1.0,1.0,1.0,1236,4944,18540,13596
9870,1.0,1.0,1.0,1237,4948,18555,13607
9872,1.0,1.0,1.0,1238,4952,18570,13618
9878,1.0,1.0,1.0,1239,4956,18585,13629
9879,1.0,1.0,1.0,1240,4960,18600,13640
9880,1.0,1.0,1.0,1241,4964,18615,13651
9881,1.0,1.0,1.0,1242,4968,18630,13662
9882,1.0,1.0,1.0,1243,4972,18645,13673
9892,1.0,1.0,1.0,1244,4976,18660,13684
9912,1.0,1.0,1.0,1245,4980,18675,13695
9918,1.0,1.0,1.0,1246,4984,18690,13706
9923,1.0,1.0,1.0,1247,4988,18705,13717
9940,1.0,1.0,1.0,1248,4992,18720,13728
9954,1.0,1.0,1.0,1249,4996,18735,13739
9980,1.0,1.0,1.0,1250,5000,18750,13750
9983,1.0,1.0,1.0,1251,5004,18765,13761
9990,1.0,1.0,1.0,1252,5008,18780,13772
10003,1.0,1.0,1.0,1253,5012,18795,13783
10004,1.0,1.0,1.0,1254,5016,18810,13794
10005,1.0,1.0,1.0,1255,5020,18825,13805
10012,1.0,1.0,1.0,1256,5024,18840,13816
10015,1.0,1.0,1.0,1257,5028,18855,13827
10016,1.0,1.0,1.0,1258,5032,18870,13838
10025,1.0,1.0,1.0,1259,5036,18885,13849
10030,1.0,1.0,1.0,1260,5040,18900,13860
10036,1.0,1.0,1.0,1261,5044,18915,13871
10041,1.0,1.0,1.0,1262,5048,18930,13882
10105,1.0,1.0,1.0,1263,5052,18945,13893
10110,1.0,1.0,1.0,1264,5056,18960,13904
10113,1.0,1.0,1.0,1265,5060,18975,13915
10123,1.0,1.0,1.0,1266,5064,18990,13926
10127,1.0,1.0,1.0,1267,5068,19005,13937
10129,1.0,1.0,1.0,1268,5072,19020,13948
10140,1.0,1.0,1.0,1269,5076,19035,13959
10143,1.0,1.0,1.0,1270,5080,19050,13970
10144,1.0,1.0,1.0,1271,5084,19065,13981
10152,1.0,1.0,1.0,1272,5088,19080,13992
10154,1.0,1.0,1.0,1273,5092,19095,14003
10163,1.0,1.0,1.0,1274,5096,19110,14014
10174,1.0,1.0,1.0,1275,5100,19125,14025
10182,1.0,1.0,1.0,1276,5104,19140,14036
10184,1.0,1.0,1.0,1277,5108,19155,14047
10191,1.0,1.0,1.0,1278,5112,19170,14058
10194,1.0,1.0,1.0,1279,5116,19185,14069
10199,1.0,1.0,1.0,1280,5120,19200,14080
10211,1.0,1.0,1.0,1281,5124,19215,14091
10213,1.0,1.0,1.0,1282,5128,19230,14102
10234,1.0,1.0,1.0,1283,5132,19245,14113
10240,1.0,1.0,1.0,1284,5136,19260,14124
10245,1.0,1.0,1.0,1285,5140,19275,14135
10251,1.0,1.0,1.0,1286,5144,19290,14146
10257,1.0,1.0,1.0,1287,5148,19305,14157
10260,1.0,1.0,1.0,1288,5152,19320,14168
10304,1.0,1.0,1.0,1289,5156,19335,14179
10312,1.0,1.0,1.0,1290,5160,19350,14190
10317,1.0,1.0,1.0,1291,5164,19365,14201
10319,1.0,1.0,1.0,1292,5168,19380,14212
10328,1.0,1.0,1.0,1293,5172,19395,14223
10349,1.0,1.0,1.0,1294,5176,19410,14234
10358,1.0,1.0,1.0,1295,5180,19425,14245
10371,1.0,1.0,1.0,1296,5184,19440,14256
10372,1.0,1.0,1.0,1297,5188,19455,14267
10375,1.0,1.0,1.0,1298,5192,19470,14278
10377,1.0,1.0,1.0,1299,5196,19485,14289
10378,1.0,1.0,1.0,1300,5200,19500,14300
10390,1.0,1.0,1.0,1301,5204,19515,14311
10394,1.0,1.0,1.0,1302,5208,19530,14322
10396,1.0,1.0,1.0,1303,5212,19545,14333
10398,1.0,1.0,1.0,1304,5216,19560,14344
10401,1.0,1.0,1.0,1305,5220,19575,14355
10418,1.0,1.0,1.0,1306,5224,19590,14366
10419,1.0,1.0,1.0,1307,5228,19605,14377
10425,1.0,1.0,1.0,1308,5232,19620,14388
10429,1.0,1.0,1.0,1309,5236,19635,14399
10430,1.0,1.0,1.0,1310,5240,19650,14410
10435,1.0,1.0,1.0,1311,5244,19665,14421
10438,1.0,1.0,1.0,1312,5248,19680,14432
10445,1.0,1.0,1.0,1313,5252,19695,14443
10452,1.0,1.0,1.0,1314,5256,19710,14454
10474,1.0,1.0,1.0,1315,5260,19725,14465
10477,1.0,1.0,1.0,1316,5264,19740,14476
10488,1.0,1.0,1.0,1317,5268,19755,14487
10502,1.0,1.0,1.0,1318,5272,19770,14498
10530,1.0,1.0,1.0,1319,5276,19785,14509
10538,1.0,1.0,1.0,1320,5280,19800,14520
10544,1.0,1.0,1.0,1321,5284,19815,14531
10575,1.0,1.0,1.0,1322,5288,19830,14542
10584,1.0,1.0,1.0,1323,5292,19845,14553
10591,1.0,1.0,1.0,1324,5296,19860,14564
10596,1.0,1.0,1.0,1325,5300,19875,14575
10608,1.0,1.0,1.0,1326,5304,19890,14586
10636,1.0,1.0,1.0,1327,5308,19905,14597
10637,1.0,1.0,1.0,1328,5312,19920,14608
10646,1.0,1.0,1.0,1329,5316,19935,14619
10666,1.0,1.0,1.0,1330,5320,19950,14630
10673,1.0,1.0,1.0,1331,5324,19965,14641
10680,1.0,1.0,1.0,1332,5328,19980,14652
10685,1.0,1.0,1.0,1333,5332,19995,14663
10699,1.0,1.0,1.0,1334,5336,20010,14674
10702,1.0,1.0,1.0,1335,5340,20025,14685
10704,1.0,1.0,1.0,1336,5344,20040,14696
10710,1.0,1.0,1.0,1337,5348,20055,14707
10714,1.0,1.0,1.0,1338,5352,20070,14718
10715,1.0,1.0,1.0,1339,5356,20085,14729
10724,1.0,1.0,1.0,1340,5360,20100,14740
10730,1.0,1.0,1.0,1341,5364,20115,14751
10750,1.0,1.0,1.0,1342,5368,20130,14762
10758,1.0,1.0,1.0,1343,5372,20145,14773
10761,1.0,1.0,1.0,1344,5376,20160,14784
10768,1.0,1.0,1.0,1345,5380,20175,14795
10771,1.0,1.0,1.0,1346,5384,20190,14806
10774,1.0,1.0,1.0,1347,5388,20205,14817
10782,1.0,1.0,1.0,1348,5392,20220,14828
10783,1.0,1.0,1.0,1349,5396,20235,14839
10787,1.0,1.0,1.0,1350,5400,20250,14850
10793,1.0,1.0,1.0,1351,5404,20265,14861
10806,1.0,1.0,1.0,1352,5408,20280,14872
10825,1.0,1.0,1.0,1353,5412,20295,14883
10840,1.0,1.0,1.0,1354,5416,20310,14894
10848,1.0,1.0,1.0,1355,5420,20325,14905
10856,1.0,1.0,1.0,1356,5424,20340,14916
10871,1.0,1.0,1.0,1357,5428,20355,14927
10877,1.0,1.0,1.0,1358,5432,20370,14938
10887,1.0,1.0,1.0,1359,5436,20385,14949
10889,1.0,1.0,1.0,1360,5440,20400,14960
10895,1.0,1.0,1.0,1361,5444,20415,14971
10903,1.0,1.0,1.0,1362,5448,20430,14982
10908,1.0,1.0,1.0,1363,5452,20445,14993
10910,1.0,1.0,1.0,1364,5456,20460,15004
10919,1.0,1.0,1.0,1365,5460,20475,15015
10925,1.0,1.0,1.0,1366,5464,20490,15026
10940,1.0,1.0,1.0,1367,5468,20505,15037
10949,1.0,1.0,1.0,1368,5472,20520,15048
10951,1.0,1.0,1.0,1369,5476,20535,15059
10966,1.0,1.0,1.0,1370,5480,20550,15070
10968,1.0,1.0,1.0,1371,5484,20565,15081
10980,1.0,1.0,1.0,1372,5488,20580,15092
10982,1.0,1.0,1.0,1373,5492,20595,15103
11000,1.0,1.0,1.0,1374,5496,20610,15114
11005,1.0,1.0,1.0,1375,5500,20625,15125
11008,1.0,1.0,1.0,1376,5504,20640,15136
11022,1.0,1.0,1.0,1377,5508,20655,15147
11033,1.0,1.0,1.0,1378,5512,20670,15158
11035,1.0,1.0,1.0,1379,5516,20685,15169
11047,1.0,1.0,1.0,1380,5520,20700,15180
11048,1.0,1.0,1.0,1381,5524,20715,15191
11052,1.0,1.0,1.0,1382,5528,20730,15202
11054,1.0,1.0,1.0,1383,5532,20745,15213
11073,1.0,1.0,1.0,1384,5536,20760,15224
11082,1.0,1.0,1.0,1385,5540,20775,15235
11085,1.0,1.0,1.0,1386,5544,20790,15246
11086,1.0,1.0,1.0,1387,5548,20805,15257
11097,1.0,1.0,1.0,1388,5552,20820,15268
11101,1.0,1.0,1.0,1389,5556,20835,15279
11122,1.0,1.0,1.0,1390,5560,20850,15290
11131,1.0,1.0,1.0,1391,5564,20865,15301
11140,1.0,1.0,1.0,1392,5568,20880,15312
11146,1.0,1.0,1.0,1393,5572,20895,15323
11147,1.0,1.0,1.0,1394,5576,20910,15334
11155,1.0,1.0,1.0,1395,5580,20925,15345
11164,1.0,1.0,1.0,1396,5584,20940,15356
11165,1.0,1.0,1.0,1397,5588,20955,15367
11168,1.0,1.0,1.0,1398,5592,20970,15378
11173,1.0,1.0,1.0,1399,5596,20985,15389
11174,1.0,1.0,1.0,1400,5600,21000,15400
11179,1.0,1.0,1.0,1401,5604,21015,15411
11185,1.0,1.0,1.0,1402,5608,21030,15422
11199,1.0,1.0,1.0,1403,5612,21045,15433
11202,1.0,1.0,1.0,1404,5616,21060,15444
11204,1.0,1.0,1.0,1405,5620,21075,15455
11207,1.0,1.0,1.0,1406,5624,21090,15466
11226,1.0,1.0,1.0,1407,5628,21105,15477
11229,1.0,1.0,1.0,1408,5632,21120,15488
11230,1.0,1.0,1.0,1409,5636,21135,15499
11235,1.0,1.0,1.0,1410,5640,21150,15510
11246,1.0,1.0,1.0,1411,5644,21165,15521
11258,1.0,1.0,1.0,1412,5648,21180,15532
11265,1.0,1.0,1.0,1413,5652,21195,15543
11268,1.0,1.0,1.0,1414,5656,21210,15554
11270,1.0,1.0,1.0,1415,5660,21225,15565
11272,1.0,1.0,1.0,1416,5664,21240,15576
11281,1.0,1.0,1.0,1417,5668,21255,15587
11296,1.0,1.0,1.0,1418,5672,21270,15598
11297,1.0,1.0,1.0,1419,5676,21285,15609
11303,1.0,1.0,1.0,1420,5680,21300,15620
11305,1.0,1.0,1.0,1421,5684,21315,15631
11327,1.0,1.0,1.0,1422,5688,21330,15642
11335,1.0,1.0,1.0,1423,5692,21345,15653
11337,1.0,1.0,1.0,1424,5696,21360,15664
11343,1.0,1.0,1.0,1425,5700,21375,15675
11351,1.0,1.0,1.0,1426,5704,21390,15686
11352,1.0,1.0,1.0,1427,5708,21405,15697
11356,1.0,1.0,1.0,1428,5712,21420,15708
11359,1.0,1.0,1.0,1429,5716,21435,15719
11366,1.0,1.0,1.0,1430,5720,21450,15730
11367,1.0,1.0,1.0,1431,5724,21465,15741
11373,1.0,1.0,1.0,1432,5728,21480,15752
11380,1.0,1.0,1.0,1433,5732,21495,15763
11385,1.0,1.0,1.0,1434,5736,21510,15774
11386,1.0,1.0,1.0,1435,5740,21525,15785
11389,1.0,1.0,1.0,1436,5744,21540,15796
11392,1.0,1.0,1.0,1437,5748,21555,15807
11410,1.0,1.0,1.0,1438,5752,21570,15818
11416,1.0,1.0,1.0,1439,5756,21585,15829
11417,1.0,1.0,1.0,1440,5760,21600,15840
11431,1.0,1.0,1.0,1441,5764,21615,15851
11439,1.0,1.0,1.0,1442,5768,21630,15862
11456,1.0,1.0,1.0,1443,5772,21645,15873
11457,1.0,1.0,1.0,1444,5776,21660,15884
11476,1.0,1.0,1.0,1445,5780,21675,15895
11488,1.0,1.0,1.0,1446,5784,21690,15906
11501,1.0,1.0,1.0,1447,5788,21705,15917
11513,1.0,1.0,1.0,1448,5792,21720,15928
11515,1.0,1.0,1.0,1449,5796,21735,15939
11522,1.0,1.0,1.0,1450,5800,21750,15950
11527,1.0,1.0,1.0,1451,5804,21765,15961
11535,1.0,1.0,1.0,1452,5808,21780,15972
11541,1.0,1.0,1.0,1453,5812,21795,15983
11552,1.0,1.0,1.0,1454,5816,21810,15994
11563,1.0,1.0,1.0,1455,5820,21825,16005
11565,1.0,1.0,1.0,1456,5824,21840,16016
11570,1.0,1.0,1.0,1457,5828,21855,16027
11571,1.0,1.0,1.0,1458,5832,21870,16038
11580,1.0,1.0,1.0,1459,5836,21885,16049
11591,1.0,1.0,1.0,1460,5840,21900,16060
11602,1.0,1.0,1.0,1461,5844,21915,16071
11606,1.0,1.0,1.0,1462,5848,21930,16082
11608,1.0,1.0,1.0,1463,5852,21945,16093
11611,1.0,1.0,1.0,1464,5856,21960,16104
11618,1.0,1.0,1.0,1465,5860,21975,16115
11652,1.0,1.0,1.0,1466,5864,21990,16126
11668,1.0,1.0,1.0,1467,5868,22005,16137
11677,1.0,1.0,1.0,1468,5872,22020,16148
11678,1.0,1.0,1.0,1469,5876,22035,16159
11679,1.0,1.0,1.0,1470,5880,22050,16170
11682,1.0,1.0,1.0,1471,5884,22065,16181
11690,1.0,1.0,1.0,1472,5888,22080,16192
11704,1.0,1.0,1.0,1473,5892,22095,16203
11716,1.0,1.0,1.0,1474,5896,22110,16214
11719,1.0,1.0,1.0,1475,5900,22125,16225
11731,1.0,1.0,1.0,1476,5904,22140,16236
11738,1.0,1.0,1.0,1477,5908,22155,16247
11739,1.0,1.0,1.0,1478,5912,22170,16258
11743,1.0,1.0,1.0,1479,5916,22185,16269
11755,1.0,1.0,1.0,1480,5920,22200,16280
11764,1.0,1.0,1.0,1481,5924,22215,16291
11766,1.0,1.0,1.0,1482,5928,22230,16302
11779,1.0,1.0,1.0,1483,5932,22245,16313
11781,1.0,1.0,1.0,1484,5936,22260,16324
11809,1.0,1.0,1.0,1485,5940,22275,16335
11812,1.0,1.0,1.0,1486,5944,22290,16346
11825,1.0,1.0,1.0,1487,5948,22305,16357
11827,1.0,1.0,1.0,1488,5952,22320,16368
11828,1.0,1.0,1.0,1489,5956,22335,16379
11839,1.0,1.0,1.0,1490,5960,22350,16390
11854,1.0,1.0,1.0,1491,5964,22365,16401
11857,1.0,1.0,1.0,1492,5968,22380,16412
11860,1.0,1.0,1.0,1493,5972,22395,16423
11866,1.0,1.0,1.0,1494,5976,22410,16434
11867,1.0,1.0,1.0,1495,5980,22425,16445
11877,1.0,1.0,1.0,1496,5984,22440,16456
11882,1.0,1.0,1.0,1497,5988,22455,16467
11885,1.0,1.0,1.0,1498,5992,22470,16478
11899,1.0,1.0,1.0,1499,5996,22485,16489
11912,1.0,1.0,1.0,1500,6000,22500,16500
11914,1.0,1.0,1.0,1501,6004,22515,16511
11920,1.0,1.0,1.0,1502,6008,22530,16522
11932,1.0,1.0,1.0,1503,6012,22545,16533
11940,1.0,1.0,1.0,1504,6016,22560,16544
11946,1.0,1.0,1.0,1505,6020,22575,16555
11951,1.0,1.0,1.0,1506,6024,22590,16566
11953,1.0,1.0,1.0,1507,6028,22605,16577
11954,1.0,1.0,1.0,1508,6032,22620,16588
11960,1.0,1.0,1.0,1509,6036,22635,16599
11961,1.0,1.0,1.0,1510,6040,22650,16610
11995,1.0,1.0,1.0,1511,6044,22665,16621
12000,1.0,1.0,1.0,1512,6048,22680,16632
12006,1.0,1.0,1.0,1513,6052,22695,16643
12010,1.0,1.0,1.0,1514,6056,22710,16654
12023,1.0,1.0,1.0,1515,6060,22725,16665
12033,1.0,1.0,1.0,1516,6064,22740,16676
12035,1.0,1.0,1.0,1517,6068,22755,16687
12052,1.0,1.0,1.0,1518,6072,22770,16698
12054,1.0,1.0,1.0,1519,6076,22785,16709
12055,1.0,1.0,1.0,1520,6080,22800,16720
12063,1.0,1.0,1.0,1521,6084,22815,16731
12080,1.0,1.0,1.0,1522,6088,22830,16742
12082,1.0,1.0,1.0,1523,6092,22845,16753
12084,1.0,1.0,1.0,1524,6096,22860,16764
12086,1.0,1.0,1.0,1525,6100,22875,16775
12088,1.0,1.0,1.0,1526,6104,22890,16786
12100,1.0,1.0,1.0,1527,6108,22905,16797
12106,1.0,1.0,1.0,1528,6112,22920,16808
12110,1.0,1.0,1.0,1529,6116,22935,16819
12114,1.0,1.0,1.0,1530,6120,22950,16830
12123,1.0,1.0,1.0,1531,6124,22965,16841
12128,1.0,1.0,1.0,1532,6128,22980,16852
12140,1.0,1.0,1.0,1533,6132,22995,16863
12150,1.0,1.0,1.0,1534,6136,23010,16874
12164,1.0,1.0,1.0,1535,6140,23025,16885
12174,1.0,1.0,1.0,1536,6144,23040,16896
12180,1.0,1.0,1.0,1537,6148,23055,16907
12201,1.0,1.0,1.0,1538,6152,23070,16918
12203,1.0,1.0,1.0,1539,6156,23085,16929
12207,1.0,1.0,1.0,1540,6160,23100,16940
12215,1.0,1.0,1.0,1541,6164,23115,16951
12216,1.0,1.0,1.0,1542,6168,23130,16962
12236,1.0,1.0,1.0,1543,6172,23145,16973
12251,1.0,1.0,1.0,1544,6176,23160,16984
12259,1.0,1.0,1.0,1545,6180,23175,16995
12273,1.0,1.0,1.0,1546,6184,23190,17006
12277,1.0,1.0,1.0,1547,6188,23205,17017
12278,1.0,1.0,1.0,1548,6192,23220,17028
12283,1.0,1.0,1.0,1549,6196,23235,17039
12286,1.0,1.0,1.0,1550,6200,23250,17050
12287,1.0,1.0,1.0,1551,6204,23265,17061
12291,1.0,1.0,1.0,1552,6208,23280,17072
12295,1.0,1.0,1.0,1553,6212,23295,17083
12300,1.0,1.0,1.0,1554,6216,23310,17094
12310,1.0,1.0,1.0,1555,6220,23325,17105
12317,1.0,1.0,1.0,1556,6224,23340,17116
12322,1.0,1.0,1.0,1557,6228,23355,17127
12327,1.0,1.0,1.0,1558,6232,23370,17138
12330,1.0,1.0,1.0,1559,6236,23385,17149
12346,1.0,1.0,1.0,1560,6240,23400,17160
12349,1.0,1.0,1.0,1561,6244,23415,17171
12360,1.0,1.0,1.0,1562,6248,23430,17182
12361,1.0,1.0,1.0,1563,6252,23445,17193
12366,1.0,1.0,1.0,1564,6256,23460,17204
12368,1.0,1.0,1.0,1565,6260,23475,17215
12379,1.0,1.0,1.0,1566,6264,23490,17226
12389,1.0,1.0,1.0,1567,6268,23505,17237
12400,1.0,1.0,1.0,1568,6272,23520,17248
12403,1.0,1.0,1.0,1569,6276,23535,17259
12408,1.0,1.0,1.0,1570,6280,23550,17270
12413,1.0,1.0,1.0,1571,6284,23565,17281
12415,1.0,1.0,1.0,1572,6288,23580,17292
12416,1.0,1.0,1.0,1573,6292,23595,17303
12420,1.0,1.0,1.0,1574,6296,23610,17314
12430,1.0,1.0,1.0,1575,6300,23625,17325
12439,1.0,1.0,1.0,1576,6304,23640,17336
12442,1.0,1.0,1.0,1577,6308,23655,17347
12451,1.0,1.0,1.0,1578,6312,23670,17358
12454,1.0,1.0,1.0,1579,6316,23685,17369
12460,1.0,1.0,1.0,1580,6320,23700,17380
12463,1.0,1.0,1.0,1581,6324,23715,17391
12479,1.0,1.0,1.0,1582,6328,23730,17402
12480,1.0,1.0,1.0,1583,6332,23745,17413
12482,1.0,1.0,1.0,1584,6336,23760,17424
12483,1.0,1.0,1.0,1585,6340,23775,17435
12485,1.0,1.0,1.0,1586,6344,23790,17446
12489,1.0,1.0,1.0,1587,6348,23805,17457
12497,1.0,1.0,1.0,1588,6352,23820,17468
12512,1.0,1.0,1.0,1589,6356,23835,17479
12513,1.0,1.0,1.0,1590,6360,23850,17490
12530,1.0,1.0,1.0,1591,6364,23865,17501
12532,1.0,1.0,1.0,1592,6368,23880,17512
12558,1.0,1.0,1.0,1593,6372,23895,17523
12567,1.0,1.0,1.0,1594,6376,23910,17534
12570,1.0,1.0,1.0,1595,6380,23925,17545
12573,1.0,1.0,1.0,1596,6384,23940,17556
12580,1.0,1.0,1.0,1597,6388,23955,17567
12581,1.0,1.0,1.0,1598,6392,23970,17578
12582,1.0,1.0,1.0,1599,6396,23985,17589
12589,1.0,1.0,1.0,1600,6400,24000,17600
12595,1.0,1.0,1.0,1601,6404,24015,17611
12607,1.0,1.0,1.0,1602,6408,24030,17622
12619,1.0,1.0,1.0,1603,6412,24045,17633
12638,1.0,1.0,1.0,1604,6416,24060,17644
12639,1.0,1.0,1.0,1605,6420,24075,17655
12642,1.0,1.0,1.0,1606,6424,24090,17666
12643,1.0,1.0,1.0,1607,6428,24105,17677
12662,1.0,1.0,1.0,1608,6432,24120,17688
12671,1.0,1.0,1.0,1609,6436,24135,17699
12672,1.0,1.0,1.0,1610,6440,24150,17710
12678,1.0,1.0,1.0,1611,6444,24165,17721
12690,1.0,1.0,1.0,1612,6448,24180,17732
12697,1.0,1.0,1.0,1613,6452,24195,17743
12699,1.0,1.0,1.0,1614,6456,24210,17754
12705,1.0,1.0,1.0,1615,6460,24225,17765
12709,1.0,1.0,1.0,1616,6464,24240,17776
12713,1.0,1.0,1.0,1617,6468,24255,17787
12715,1.0,1.0,1.0,1618,6472,24270,17798
12719,1.0,1.0,1.0,1619,6476,24285,17809
12724,1.0,1.0,1.0,1620,6480,24300,17820
12726,1.0,1.0,1.0,1621,6484,24315,17831
12733,1.0,1.0,1.0,1622,6488,24330,17842
12736,1.0,1.0,1.0,1623,6492,24345,17853
12749,1.0,1.0,1.0,1624,6496,24360,17864
12750,1.0,1.0,1.0,1625,6500,24375,17875
12757,1.0,1.0,1.0,1626,6504,24390,17886
12758,1.0,1.0,1.0,1627,6508,24405,17897
12775,1.0,1.0,1.0,1628,6512,24420,17908
12783,1.0,1.0,1.0,1629,6516,24435,17919
12799,1.0,1.0,1.0,1630,6520,24450,17930
12802,1.0,1.0,1.0,1631,6524,24465,17941
12803,1.0,1.0,1.0,1632,6528,24480,17952
12805,1.0,1.0,1.0,1633,6532,24495,17963
12812,1.0,1.0,1.0,1634,6536,24510,17974
12817,1.0,1.0,1.0,1635,6540,24525,17985
12818,1.0,1.0,1.0,1636,6544,24540,17996
12825,1.0,1.0,1.0,1637,6548,24555,18007
12826,1.0,1.0,1.0,1638,6552,24570,18018
12853,1.0,1.0,1.0,1639,6556,24585,18029
12866,1.0,1.0,1.0,1640,6560,24600,18040
12887,1.0,1.0,1.0,1641,6564,24615,18051
12888,1.0,1.0,1.0,1642,6568,24630,18062
12889,1.0,1.0,1.0,1643,6572,24645,18073
12892,1.0,1.0,1.0,1644,6576,24660,18084
12893,1.0,1.0,1.0,1645,6580,24675,18095
12901,1.0,1.0,1.0,1646,6584,24690,18106
12905,1.0,1.0,1.0,1647,6588,24705,18117
12909,1.0,1.0,1.0,1648,6592,24720,18128
12917,1.0,1.0,1.0,1649,6596,24735,18139
12940,1.0,1.0,1.0,1650,6600,24750,18150
12950,1.0,1.0,1.0,1651,6604,24765,18161
12951,1.0,1.0,1.0,1652,6608,24780,18172
12958,1.0,1.0,1.0,1653,6612,24795,18183
12959,1.0,1.0,1.0,1654,6616,24810,18194
12961,1.0,1.0,1.0,1655,6620,24825,18205
12962,1.0,1.0,1.0,1656,6624,24840,18216
12971,1.0,1.0,1.0,1657,6628,24855,18227
12978,1.0,1.0,1.0,1658,6632,24870,18238
12981,1.0,1.0,1.0,1659,6636,24885,18249
12985,1.0,1.0,1.0,1660,6640,24900,18260
12998,1.0,1.0,1.0,1661,6644,24915,18271
12999,1.0,1.0,1.0,1662,6648,24930,18282
13004,1.0,1.0,1.0,1663,6652,24945,18293
13010,1.0,1.0,1.0,1664,6656,24960,18304
13020,1.0,1.0,1.0,1665,6660,24975,18315
13028,1.0,1.0,1.0,1666,6664,24990,18326
13034,1.0,1.0,1.0,1667,6668,25005,18337
13037,1.0,1.0,1.0,1668,6672,25020,18348
13043,1.0,1.0,1.0,1669,6676,25035,18359
13060,1.0,1.0,1.0,1670,6680,25050,18370
13061,1.0,1.0,1.0,1671,6684,25065,18381
13097,1.0,1.0,1.0,1672,6688,25080,18392
13102,1.0,1.0,1.0,1673,6692,25095,18403
13103,1.0,1.0,1.0,1674,6696,25110,18414
13104,1.0,1.0,1.0,1675,6700,25125,18425
13118,1.0,1.0,1.0,1676,6704,25140,18436
13146,1.0,1.0,1.0,1677,6708,25155,18447
13158,1.0,1.0,1.0,1678,6712,25170,18458
13178,1.0,1.0,1.0,1679,6716,25185,18469
13179,1.0,1.0,1.0,1680,6720,25200,18480
13191,1.0,1.0,1.0,1681,6724,25215,18491
13194,1.0,1.0,1.0,1682,6728,25230,18502
13196,1.0,1.0,1.0,1683,6732,25245,18513
13198,1.0,1.0,1.0,1684,6736,25260,18524
13203,1.0,1.0,1.0,1685,6740,25275,18535
13204,1.0,1.0,1.0,1686,6744,25290,18546
13206,1.0,1.0,1.0,1687,6748,25305,18557
13209,1.0,1.0,1.0,1688,6752,25320,18568
13218,1.0,1.0,1.0,1689,6756,25335,18579
13220,1.0,1.0,1.0,1690,6760,25350,18590
13224,1.0,1.0,1.0,1691,6764,25365,18601
13239,1.0,1.0,1.0,1692,6768,25380,18612
13243,1.0,1.0,1.0,1693,6772,25395,18623
13246,1.0,1.0,1.0,1694,6776,25410,18634
13251,1.0,1.0,1.0,1695,6780,25425,18645
13254,1.0,1.0,1.0,1696,6784,25440,18656
13257,1.0,1.0,1.0,1697,6788,25455,18667
13259,1.0,1.0,1.0,1698,6792,25470,18678
13263,1.0,1.0,1.0,1699,6796,25485,18689
13276,1.0,1.0,1.0,1700,6800,25500,18700
13277,1.0,1.0,1.0,1701,6804,25515,18711
13282,1.0,1.0,1.0,1702,6808,25530,18722
13285,1.0,1.0,1.0,1703,6812,25545,18733
13286,1.0,1.0,1.0,1704,6816,25560,18744
13296,1.0,1.0,1.0,1705,6820,25575,18755
13297,1.0,1.0,1.0,1706,6824,25590,18766
13300,1.0,1.0,1.0,1707,6828,25605,18777
13303,1.0,1.0,1.0,1708,6832,25620,18788
13310,1.0,1.0,1.0,1709,6836,25635,18799
13315,1.0,1.0,1.0,1710,6840,25650,18810
13319,1.0,1.0,1.0,1711,6844,25665,18821
13322,1.0,1.0,1.0,1712,6848,25680,18832
13324,1.0,1.0,1.0,1713,6852,25695,18843
13325,1.0,1.0,1.0,1714,6856,25710,18854
13326,1.0,1.0,1.0,1715,6860,25725,18865
13327,1.0,1.0,1.0,1716,6864,25740,18876
13331,1.0,1.0,1.0,1717,6868,25755,18887
13338,1.0,1.0,1.0,1718,6872,25770,18898
13348,1.0,1.0,1.0,1719,6876,25785,18909
13353,1.0,1.0,1.0,1720,6880,25800,18920
13358,1.0,1.0,1.0,1721,6884,25815,18931
13363,1.0,1.0,1.0,1722,6888,25830,18942
13371,1.0,1.0,1.0,1723,6892,25845,18953
13379,1.0,1.0,1.0,1724,6896,25860,18964
13381,1.0,1.0,1.0,1725,6900,25875,18975
13402,1.0,1.0,1.0,1726,6904,25890,18986
13405,1.0,1.0,1.0,1727,6908,25905,18997
13422,1.0,1.0,1.0,1728,6912,25920,19008
13426,1.0,1.0,1.0,1729,6916,25935,19019
13479,1.0,1.0,1.0,1730,6920,25950,19030
13490,1.0,1.0,1.0,1731,6924,25965,19041
13493,1.0,1.0,1.0,1732,6928,25980,19052
13499,1.0,1.0,1.0,1733,6932,25995,19063
13513,1.0,1.0,1.0,1734,6936,26010,19074
13518,1.0,1.0,1.0,1735,6940,26025,19085
13524,1.0,1.0,1.0,1736,6944,26040,19096
13525,1.0,1.0,1.0,1737,6948,26055,19107
13530,1.0,1.0,1.0,1738,6952,26070,19118
13534,1.0,1.0,1.0,1739,6956,26085,19129
13535,1.0,1.0,1.0,1740,6960,26100,19140
13545,1.0,1.0,1.0,1741,6964,26115,19151
13548,1.0,1.0,1.0,1742,6968,26130,19162
13554,1.0,1.0,1.0,1743,6972,26145,19173
13584,1.0,1.0,1.0,1744,6976,26160,19184
13595,1.0,1.0,1.0,1745,6980,26175,19195
13602,1.0,1.0,1.0,1746,6984,26190,19206
13612,1.0,1.0,1.0,1747,6988,26205,19217
13617,1.0,1.0,1.0,1748,6992,26220,19228
13623,1.0,1.0,1.0,1749,6996,26235,19239
13627,1.0,1.0,1.0,1750,7000,26250,19250
13632,1.0,1.0,1.0,1751,7004,26265,19261
13634,1.0,1.0,1.0,1752,7008,26280,19272
13638,1.0,1.0,1.0,1753,7012,26295,19283
13639,1.0,1.0,1.0,1754,7016,26310,19294
13645,1.0,1.0,1.0,1755,7020,26325,19305
13646,1.0,1.0,1.0,1756,7024,26340,19316
13661,1.0,1.0,1.0,1757,7028,26355,19327
13663,1.0,1.0,1.0,1758,7032,26370,19338
13670,1.0,1.0,1.0,1759,7036,26385,19349
13672,1.0,1.0,1.0,1760,7040,26400,19360
13678,1.0,1.0,1.0,1761,7044,26415,19371
13686,1.0,1.0,1.0,1762,7048,26430,19382
13691,1.0,1.0,1.0,1763,7052,26445,19393
13694,1.0,1.0,1.0,1764,7056,26460,19404
13706,1.0,1.0,1.0,1765,7060,26475,19415
13713,1.0,1.0,1.0,1766,7064,26490,19426
13714,1.0,1.0,1.0,1767,7068,26505,19437
13718,1.0,1.0,1.0,1768,7072,26520,19448
13734,1.0,1.0,1.0,1769,7076,26535,19459
13737,1.0,1.0,1.0,1770,7080,26550,19470
13738,1.0,1.0,1.0,1771,7084,26565,19481
13741,1.0,1.0,1.0,1772,7088,26580,19492
13744,1.0,1.0,1.0,1773,7092,26595,19503
13745,1.0,1.0,1.0,1774,7096,26610,19514
13761,1.0,1.0,1.0,1775,7100,26625,19525
13769,1.0,1.0,1.0,1776,7104,26640,19536
13795,1.0,1.0,1.0,1777,7108,26655,19547
13800,1.0,1.0,1.0,1778,7112,26670,19558
13806,1.0,1.0,1.0,1779,7116,26685,19569
13808,1.0,1.0,1.0,1780,7120,26700,19580
13844,1.0,1.0,1.0,1781,7124,26715,19591
13845,1.0,1.0,1.0,1782,7128,26730,19602
13847,1.0,1.0,1.0,1783,7132,26745,19613
13848,1.0,1.0,1.0,1784,7136,26760,19624
13870,1.0,1.0,1.0,1785,7140,26775,19635
13890,1.0,1.0,1.0,1786,7144,26790,19646
13909,1.0,1.0,1.0,1787,7148,26805,19657
13927,1.0,1.0,1.0,1788,7152,26820,19668
13931,1.0,1.0,1.0,1789,7156,26835,19679
13939,1.0,1.0,1.0,1790,7160,26850,19690
13950,1.0,1.0,1.0,1791,7164,26865,19701
13954,1.0,1.0,1.0,1792,7168,26880,19712
13956,1.0,1.0,1.0,1793,7172,26895,19723
13958,1.0,1.0,1.0,1794,7176,26910,19734
13964,1.0,1.0,1.0,1795,7180,26925,19745
13968,1.0,1.0,1.0,1796,7184,26940,19756
13970,1.0,1.0,1.0,1797,7188,26955,19767
13978,1.0,1.0,1.0,1798,7192,26970,19778
14006,1.0,1.0,1.0,1799,7196,26985,19789
14010,1.0,1.0,1.0,1800,7200,27000,19800
14014,1.0,1.0,1.0,1801,7204,27015,19811
14017,1.0,1.0,1.0,1802,7208,27030,19822
14030,1.0,1.0,1.0,1803,7212,27045,19833
14035,1.0,1.0,1.0,1804,7216,27060,19844
14049,1.0,1.0,1.0,1805,7220,27075,19855
14052,1.0,1.0,1.0,1806,7224,27090,19866
14061,1.0,1.0,1.0,1807,7228,27105,19877
14091,1.0,1.0,1.0,1808,7232,27120,19888
14097,1.0,1.0,1.0,1809,7236,27135,19899
14105,1.0,1.0,1.0,1810,7240,27150,19910
14117,1.0,1.0,1.0,1811,7244,27165,19921
14137,1.0,1.0,1.0,1812,7248,27180,19932
14143,1.0,1.0,1.0,1813,7252,27195,19943
14144,1.0,1.0,1.0,1814,7256,27210,19954
14162,1.0,1.0,1.0,1815,7260,27225,19965
14186,1.0,1.0,1.0,1816,7264,27240,19976
14193,1.0,1.0,1.0,1817,7268,27255,19987
14194,1.0,1.0,1.0,1818,7272,27270,19998
14195,1.0,1.0,1.0,1819,7276,27285,20009
14196,1.0,1.0,1.0,1820,7280,27300,20020
14197,1.0,1.0,1.0,1821,7284,27315,20031
14199,1.0,1.0,1.0,1822,7288,27330,20042
14212,1.0,1.0,1.0,1823,7292,27345,20053
14213,1.0,1.0,1.0,1824,7296,27360,20064
14223,1.0,1.0,1.0,1825,7300,27375,20075
14228,1.0,1.0,1.0,1826,7304,27390,20086
14233,1.0,1.0,1.0,1827,7308,27405,20097
14236,1.0,1.0,1.0,1828,7312,27420,20108
14239,1.0,1.0,1.0,1829,7316,27435,20119
14241,1.0,1.0,1.0,1830,7320,27450,20130
14242,1.0,1.0,1.0,1831,7324,27465,20141
14247,1.0,1.0,1.0,1832,7328,27480,20152
14256,1.0,1.0,1.0,1833,7332,27495,20163
14260,1.0,1.0,1.0,1834,7336,27510,20174
14270,1.0,1.0,1.0,1835,7340,27525,20185
14274,1.0,1.0,1.0,1836,7344,27540,20196
14277,1.0,1.0,1.0,1837,7348,27555,20207
14287,1.0,1.0,1.0,1838,7352,27570,20218
14296,1.0,1.0,1.0,1839,7356,27585,20229
14298,1.0,1.0,1.0,1840,7360,27600,20240
14299,1.0,1.0,1.0,1841,7364,27615,20251
14302,1.0,1.0,1.0,1842,7368,27630,20262
14321,1.0,1.0,1.0,1843,7372,27645,20273
14323,1.0,1.0,1.0,1844,7376,27660,20284
14325,1.0,1.0,1.0,1845,7380,27675,20295
14330,1.0,1.0,1.0,1846,7384,27690,20306
14334,1.0,1.0,1.0,1847,7388,27705,20317
14352,1.0,1.0,1.0,1848,7392,27720,20328
14361,1.0,1.0,1.0,1849,7396,27735,20339
14366,1.0,1.0,1.0,1850,7400,27750,20350
14375,1.0,1.0,1.0,1851,7404,27765,20361
14379,1.0,1.0,1.0,1852,7408,27780,20372
14384,1.0,1.0,1.0,1853,7412,27795,20383
14390,1.0,1.0,1.0,1854,7416,27810,20394
14398,1.0,1.0,1.0,1855,7420,27825,20405
14400,1.0,1.0,1.0,1856,7424,27840,20416
14409,1.0,1.0,1.0,1857,7428,27855,20427
14410,1.0,1.0,1.0,1858,7432,27870,20438
14420,1.0,1.0,1.0,1859,7436,27885,20449
14430,1.0,1.0,1.0,1860,7440,27900,20460
14438,1.0,1.0,1.0,1861,7444,27915,20471
14439,1.0,1.0,1.0,1862,7448,27930,20482
14443,1.0,1.0,1.0,1863,7452,27945,20493
14446,1.0,1.0,1.0,1864,7456,27960,20504
14449,1.0,1.0,1.0,1865,7460,27975,20515
14466,1.0,1.0,1.0,1866,7464,27990,20526
14478,1.0,1.0,1.0,1867,7468,28005,20537
14510,1.0,1.0,1.0,1868,7472,28020,20548
14513,1.0,1.0,1.0,1869,7476,28035,20559
14525,1.0,1.0,1.0,1870,7480,28050,20570
14527,1.0,1.0,1.0,1871,7484,28065,20581
14536,1.0,1.0,1.0,1872,7488,28080,20592
14545,1.0,1.0,1.0,1873,7492,28095,20603
14573,1.0,1.0,1.0,1874,7496,28110,20614
14581,1.0,1.0,1.0,1875,7500,28125,20625
14591,1.0,1.0,1.0,1876,7504,28140,20636
14608,1.0,1.0,1.0,1877,7508,28155,20647
14609,1.0,1.0,1.0,1878,7512,28170,20658
14613,1.0,1.0,1.0,1879,7516,28185,20669
14615,1.0,1.0,1.0,1880,7520,28200,20680
14633,1.0,1.0,1.0,1881,7524,28215,20691
14635,1.0,1.0,1.0,1882,7528,28230,20702
14637,1.0,1.0,1.0,1883,7532,28245,20713
14644,1.0,1.0,1.0,1884,7536,28260,20724
14646,1.0,1.0,1.0,1885,7540,28275,20735
14651,1.0,1.0,1.0,1886,7544,28290,20746
14653,1.0,1.0,1.0,1887,7548,28305,20757
14657,1.0,1.0,1.0,1888,7552,28320,20768
14660,1.0,1.0,1.0,1889,7556,28335,20779
14671,1.0,1.0,1.0,1890,7560,28350,20790
14676,1.0,1.0,1.0,1891,7564,28365,20801
14692,1.0,1.0,1.0,1892,7568,28380,20812
14696,1.0,1.0,1.0,1893,7572,28395,20823
14721,1.0,1.0,1.0,1894,7576,28410,20834
14742,1.0,1.0,1.0,1895,7580,28425,20845
14761,1.0,1.0,1.0,1896,7584,28440,20856
14765,1.0,1.0,1.0,1897,7588,28455,20867
14776,1.0,1.0,1.0,1898,7592,28470,20878
14808,1.0,1.0,1.0,1899,7596,28485,20889
14814,1.0,1.0,1.0,1900,7600,28500,20900
14817,1.0,1.0,1.0,1901,7604,28515,20911
14821,1.0,1.0,1.0,1902,7608,28530,20922
14822,1.0,1.0,1.0,1903,7612,28545,20933
14865,1.0,1.0,1.0,1904,7616,28560,20944
14868,1.0,1.0,1.0,1905,7620,28575,20955
14873,1.0,1.0,1.0,1906,7624,28590,20966
14877,1.0,1.0,1.0,1907,7628,28605,20977
14880,1.0,1.0,1.0,1908,7632,28620,20988
14886,1.0,1.0,1.0,1909,7636,28635,20999
14890,1.0,1.0,1.0,1910,7640,28650,21010
14902,1.0,1.0,1.0,1911,7644,28665,21021
14925,1.0,1.0,1.0,1912,7648,28680,21032
14926,1.0,1.0,1.0,1913,7652,28695,21043
14927,1.0,1.0,1.0,1914,7656,28710,21054
14932,1.0,1.0,1.0,1915,7660,28725,21065
14954,1.0,1.0,1.0,1916,7664,28740,21076
14970,1.0,1.0,1.0,1917,7668,28755,21087
14972,1.0,1.0,1.0,1918,7672,28770,21098
14979,1.0,1.0,1.0,1919,7676,28785,21109
14982,1.0,1.0,1.0,1920,7680,28800,21120
14993,1.0,1.0,1.0,1921,7684,28815,21131
14998,1.0,1.0,1.0,1922,7688,28830,21142
14999,1.0,1.0,1.0,1923,7692,28845,21153
15011,1.0,1.0,1.0,1924,7696,28860,21164
15016,1.0,1.0,1.0,1925,7700,28875,21175
15033,1.0,1.0,1.0,1926,7704,28890,21186
15036,1.0,1.0,1.0,1927,7708,28905,21197
15045,1.0,1.0,1.0,1928,7712,28920,21208
15056,1.0,1.0,1.0,1929,7716,28935,21219
15070,1.0,1.0,1.0,1930,7720,28950,21230
15073,1.0,1.0,1.0,1931,7724,28965,21241
15099,1.0,1.0,1.0,1932,7728,28980,21252
15101,1.0,1.0,1.0,1933,7732,28995,21263
15107,1.0,1.0,1.0,1934,7736,29010,21274
15113,1.0,1.0,1.0,1935,7740,29025,21285
15115,1.0,1.0,1.0,1936,7744,29040,21296
15118,1.0,1.0,1.0,1937,7748,29055,21307
15124,1.0,1.0,1.0,1938,7752,29070,21318
15143,1.0,1.0,1.0,1939,7756,29085,21329
15155,1.0,1.0,1.0,1940,7760,29100,21340
15158,1.0,1.0,1.0,1941,7764,29115,21351
15163,1.0,1.0,1.0,1942,7768,29130,21362
15169,1.0,1.0,1.0,1943,7772,29145,21373
15172,1.0,1.0,1.0,1944,7776,29160,21384
15175,1.0,1.0,1.0,1945,7780,29175,21395
15187,1.0,1.0,1.0,1946,7784,29190,21406
15200,1.0,1.0,1.0,1947,7788,29205,21417
15210,1.0,1.0,1.0,1948,7792,29220,21428
15220,1.0,1.0,1.0,1949,7796,29235,21439
15228,1.0,1.0,1.0,1950,7800,29250,21450
15231,1.0,1.0,1.0,1951,7804,29265,21461
15240,1.0,1.0,1.0,1952,7808,29280,21472
15243,1.0,1.0,1.0,1953,7812,29295,21483
15245,1.0,1.0,1.0,1954,7816,29310,21494
15250,1.0,1.0,1.0,1955,7820,29325,21505
15253,1.0,1.0,1.0,1956,7824,29340,21516
15254,1.0,1.0,1.0,1957,7828,29355,21527
15261,1.0,1.0,1.0,1958,7832,29370,21538
15262,1.0,1.0,1.0,1959,7836,29385,21549
15264,1.0,1.0,1.0,1960,7840,29400,21560
15277,1.0,1.0,1.0,1961,7844,29415,21571
15285,1.0,1.0,1.0,1962,7848,29430,21582
15292,1.0,1.0,1.0,1963,7852,29445,21593
15301,1.0,1.0,1.0,1964,7856,29460,21604
15317,1.0,1.0,1.0,1965,7860,29475,21615
15359,1.0,1.0,1.0,1966,7864,29490,21626
15360,1.0,1.0,1.0,1967,7868,29505,21637
15362,1.0,1.0,1.0,1968,7872,29520,21648
15366,1.0,1.0,1.0,1969,7876,29535,21659
15376,1.0,1.0,1.0,1970,7880,29550,21670
15377,1.0,1.0,1.0,1971,7884,29565,21681
15385,1.0,1.0,1.0,1972,7888,29580,21692
15386,1.0,1.0,1.0,1973,7892,29595,21703
15399,1.0,1.0,1.0,1974,7896,29610,21714
15405,1.0,1.0,1.0,1975,7900,29625,21725
15413,1.0,1.0,1.0,1976,7904,29640,21736
15419,1.0,1.0,1.0,1977,7908,29655,21747
15423,1.0,1.0,1.0,1978,7912,29670,21758
15428,1.0,1.0,1.0,1979,7916,29685,21769
15435,1.0,1.0,1.0,1980,7920,29700,21780
15437,1.0,1.0,1.0,1981,7924,29715,21791
15443,1.0,1.0,1.0,1982,7928,29730,21802
15444,1.0,1.0,1.0,1983,7932,29745,21813
15447,1.0,1.0,1.0,1984,7936,29760,21824
15459,1.0,1.0,1.0,1985,7940,29775,21835
15475,1.0,1.0,1.0,1986,7944,29790,21846
15484,1.0,1.0,1.0,1987,7948,29805,21857
15515,1.0,1.0,1.0,1988,7952,29820,21868
15522,1.0,1.0,1.0,1989,7956,29835,21879
15538,1.0,1.0,1.0,1990,7960,29850,21890
15544,1.0,1.0,1.0,1991,7964,29865,21901
15545,1.0,1.0,1.0,1992,7968,29880,21912
15553,1.0,1.0,1.0,1993,7972,29895,21923
15558,1.0,1.0,1.0,1994,7976,29910,21934
15559,1.0,1.0,1.0,1995,7980,29925,21945
15561,1.0,1.0,1.0,1996,7984,29940,21956
15568,1.0,1.0,1.0,1997,7988,29955,21967
15572,1.0,1.0,1.0,1998,7992,29970,21978
15589,1.0,1.0,1.0,1999,7996,29985,21989
15609,1.0,1.0,1.0,2000,8000,30000,22000
15614,1.0,1.0,1.0,2001,8004,30015,22011
15621,1.0,1.0,1.0,2002,8008,30030,22022
15623,1.0,1.0,1.0,2003,8012,30045,22033
15628,1.0,1.0,1.0,2004,8016,30060,22044
15632,1.0,1.0,1.0,2005,8020,30075,22055
15635,1.0,1.0,1.0,2006,8024,30090,22066
15637,1.0,1.0,1.0,2007,8028,30105,22077
15641,1.0,1.0,1.0,2008,8032,30120,22088
15682,1.0,1.0,1.0,2009,8036,30135,22099
15688,1.0,1.0,1.0,2010,8040,30150,22110
15693,1.0,1.0,1.0,2011,8044,30165,22121
15694,1.0,1.0,1.0,2012,8048,30180,22132
15695,1.0,1.0,1.0,2013,8052,30195,22143
15709,1.0,1.0,1.0,2014,8056,30210,22154
15721,1.0,1.0,1.0,2015,8060,30225,22165
15724,1.0,1.0,1.0,2016,8064,30240,22176
15740,1.0,1.0,1.0,2017,8068,30255,22187
15741,1.0,1.0,1.0,2018,8072,30270,22198
15750,1.0,1.0,1.0,2019,8076,30285,22209
15753,1.0,1.0,1.0,2020,8080,30300,22220
15764,1.0,1.0,1.0,2021,8084,30315,22231
15767,1.0,1.0,1.0,2022,8088,30330,22242
15774,1.0,1.0,1.0,2023,8092,30345,22253
15778,1.0,1.0,1.0,2024,8096,30360,22264
15779,1.0,1.0,1.0,2025,8100,30375,22275
15787,1.0,1.0,1.0,2026,8104,30390,22286
15788,1.0,1.0,1.0,2027,8108,30405,22297
15792,1.0,1.0,1.0,2028,8112,30420,22308
15800,1.0,1.0,1.0,2029,8116,30435,22319
15804,1.0,1.0,1.0,2030,8120,30450,22330
15811,1.0,1.0,1.0,2031,8124,30465,22341
15813,1.0,1.0,1.0,2032,8128,30480,22352
15817,1.0,1.0,1.0,2033,8132,30495,22363
15835,1.0,1.0,1.0,2034,8136,30510,22374
15836,1.0,1.0,1.0,2035,8140,30525,22385
15842,1.0,1.0,1.0,2036,8144,30540,22396
15843,1.0,1.0,1.0,2037,8148,30555,22407
15847,1.0,1.0,1.0,2038,8152,30570,22418
15852,1.0,1.0,1.0,2039,8156,30585,22429
15856,1.0,1.0,1.0,2040,8160,30600,22440
15858,1.0,1.0,1.0,2041,8164,30615,22451
15876,1.0,1.0,1.0,2042,8168,30630,22462
15883,1.0,1.0,1.0,2043,8172,30645,22473
15901,1.0,1.0,1.0,2044,8176,30660,22484
15911,1.0,1.0,1.0,2045,8180,30675,22495
15944,1.0,1.0,1.0,2046,8184,30690,22506
15952,1.0,1.0,1.0,2047,8188,30705,22517
15957,1.0,1.0,1.0,2048,8192,30720,22528
15958,1.0,1.0,1.0,2049,8196,30735,22539
15959,1.0,1.0,1.0,2050,8200,30750,22550
15960,1.0,1.0,1.0,2051,8204,30765,22561
15961,1.0,1.0,1.0,2052,8208,30780,22572
15962,1.0,1.0,1.0,2053,8212,30795,22583
15969,1.0,1.0,1.0,2054,8216,30810,22594
15979,1.0,1.0,1.0,2055,8220,30825,22605
15992,1.0,1.0,1.0,2056,8224,30840,22616
15993,1.0,1.0,1.0,2057,8228,30855,22627
15997,1.0,1.0,1.0,2058,8232,30870,22638
16009,1.0,1.0,1.0,2059,8236,30885,22649
16018,1.0,1.0,1.0,2060,8240,30900,22660
16021,1.0,1.0,1.0,2061,8244,30915,22671
16032,1.0,1.0,1.0,2062,8248,30930,22682
16035,1.0,1.0,1.0,2063,8252,30945,22693
16038,1.0,1.0,1.0,2064,8256,30960,22704
16039,1.0,1.0,1.0,2065,8260,30975,22715
16051,1.0,1.0,1.0,2066,8264,30990,22726
16072,1.0,1.0,1.0,2067,8268,31005,22737
16076,1.0,1.0,1.0,2068,8272,31020,22748
16088,1.0,1.0,1.0,2069,8276,31035,22759
16114,1.0,1.0,1.0,2070,8280,31050,22770
16129,1.0,1.0,1.0,2071,8284,31065,22781
16130,1.0,1.0,1.0,2072,8288,31080,22792
16132,1.0,1.0,1.0,2073,8292,31095,22803
16133,1.0,1.0,1.0,2074,8296,31110,22814
16135,1.0,1.0,1.0,2075,8300,31125,22825
16138,1.0,1.0,1.0,2076,8304,31140,22836
16139,1.0,1.0,1.0,2077,8308,31155,22847
16140,1.0,1.0,1.0,2078,8312,31170,22858
16143,1.0,1.0,1.0,2079,8316,31185,22869
16152,1.0,1.0,1.0,2080,8320,31200,22880
16155,1.0,1.0,1.0,2081,8324,31215,22891
16177,1.0,1.0,1.0,2082,8328,31230,22902
16179,1.0,1.0,1.0,2083,8332,31245,22913
16191,1.0,1.0,1.0,2084,8336,31260,22924
16192,1.0,1.0,1.0,2085,8340,31275,22935
16213,1.0,1.0,1.0,2086,8344,31290,22946
16215,1.0,1.0,1.0,2087,8348,31305,22957
16221,1.0,1.0,1.0,2088,8352,31320,22968
16230,1.0,1.0,1.0,2089,8356,31335,22979
16234,1.0,1.0,1.0,2090,8360,31350,22990
16236,1.0,1.0,1.0,2091,8364,31365,23001
16237,1.0,1.0,1.0,2092,8368,31380,23012
16242,1.0,1.0,1.0,2093,8372,31395,23023
16243,1.0,1.0,1.0,2094,8376,31410,23034
16244,1.0,1.0,1.0,2095,8380,31425,23045
16246,1.0,1.0,1.0,2096,8384,31440,23056
16247,1.0,1.0,1.0,2097,8388,31455,23067
16248,1.0,1.0,1.0,2098,8392,31470,23078
16255,1.0,1.0,1.0,2099,8396,31485,23089
16265,1.0,1.0,1.0,2100,8400,31500,23100
16271,1.0,1.0,1.0,2101,8404,31515,23111
16272,1.0,1.0,1.0,2102,8408,31530,23122
16273,1.0,1.0,1.0,2103,8412,31545,23133
16275,1.0,1.0,1.0,2104,8416,31560,23144
16280,1.0,1.0,1.0,2105,8420,31575,23155
16286,1.0,1.0,1.0,2106,8424,31590,23166
16296,1.0,1.0,1.0,2107,8428,31605,23177
16303,1.0,1.0,1.0,2108,8432,31620,23188
16305,1.0,1.0,1.0,2109,8436,31635,23199
16309,1.0,1.0,1.0,2110,8440,31650,23210
16311,1.0,1.0,1.0,2111,8444,31665,23221
16313,1.0,1.0,1.0,2112,8448,31680,23232
16317,1.0,1.0,1.0,2113,8452,31695,23243
16325,1.0,1.0,1.0,2114,8456,31710,23254
16328,1.0,1.0,1.0,2115,8460,31725,23265
16370,1.0,1.0,1.0,2116,8464,31740,23276
16371,1.0,1.0,1.0,2117,8468,31755,23287
16377,1.0,1.0,1.0,2118,8472,31770,23298
16384,1.0,1.0,1.0,2119,8476,31785,23309
16394,1.0,1.0,1.0,2120,8480,31800,23320
16395,1.0,1.0,1.0,2121,8484,31815,23331
16396,1.0,1.0,1.0,2122,8488,31830,23342
16417,1.0,1.0,1.0,2123,8492,31845,23353
16424,1.0,1.0,1.0,2124,8496,31860,23364
16430,1.0,1.0,1.0,2125,8500,31875,23375
16438,1.0,1.0,1.0,2126,8504,31890,23386
16441,1.0,1.0,1.0,2127,8508,31905,23397
16445,1.0,1.0,1.0,2128,8512,31920,23408
16447,1.0,1.0,1.0,2129,8516,31935,23419
16452,1.0,1.0,1.0,2130,8520,31950,23430
16459,1.0,1.0,1.0,2131,8524,31965,23441
16462,1.0,1.0,1.0,2132,8528,31980,23452
16464,1.0,1.0,1.0,2133,8532,31995,23463
16475,1.0,1.0,1.0,2134,8536,32010,23474
16483,1.0,1.0,1.0,2135,8540,32025,23485
16486,1.0,1.0,1.0,2136,8544,32040,23496
16487,1.0,1.0,1.0,2137,8548,32055,23507
16497,1.0,1.0,1.0,2138,8552,32070,23518
16499,1.0,1.0,1.0,2139,8556,32085,23529
16506,1.0,1.0,1.0,2140,8560,32100,23540
16520,1.0,1.0,1.0,2141,8564,32115,23551
16527,1.0,1.0,1.0,2142,8568,32130,23562
16538,1.0,1.0,1.0,2143,8572,32145,23573
16549,1.0,1.0,1.0,2144,8576,32160,23584
16550,1.0,1.0,1.0,2145,8580,32175,23595
16560,1.0,1.0,1.0,2146,8584,32190,23606
16567,1.0,1.0,1.0,2147,8588,32205,23617
16573,1.0,1.0,1.0,2148,8592,32220,23628
16580,1.0,1.0,1.0,2149,8596,32235,23639
16594,1.0,1.0,1.0,2150,8600,32250,23650
16598,1.0,1.0,1.0,2151,8604,32265,23661
16599,1.0,1.0,1.0,2152,8608,32280,23672
16602,1.0,1.0,1.0,2153,8612,32295,23683
16607,1.0,1.0,1.0,2154,8616,32310,23694
16609,1.0,1.0,1.0,2155,8620,32325,23705
16614,1.0,1.0,1.0,2156,8624,32340,23716
16615,1.0,1.0,1.0,2157,8628,32355,23727
16620,1.0,1.0,1.0,2158,8632,32370,23738
16623,1.0,1.0,1.0,2159,8636,32385,23749
16624,1.0,1.0,1.0,2160,8640,32400,23760
16638,1.0,1.0,1.0,2161,8644,32415,23771
16642,1.0,1.0,1.0,2162,8648,32430,23782
16644,1.0,1.0,1.0,2163,8652,32445,23793
16656,1.0,1.0,1.0,2164,8656,32460,23804
16661,1.0,1.0,1.0,2165,8660,32475,23815
16662,1.0,1.0,1.0,2166,8664,32490,23826
16671,1.0,1.0,1.0,2167,8668,32505,23837
16674,1.0,1.0,1.0,2168,8672,32520,23848
16675,1.0,1.0,1.0,2169,8676,32535,23859
16683,1.0,1.0,1.0,2170,8680,32550,23870
16685,1.0,1.0,1.0,2171,8684,32565,23881
16690,1.0,1.0,1.0,2172,8688,32580,23892
16691,1.0,1.0,1.0,2173,8692,32595,23903
16701,1.0,1.0,1.0,2174,8696,32610,23914
16707,1.0,1.0,1.0,2175,8700,32625,23925
16714,1.0,1.0,1.0,2176,8704,32640,23936
16720,1.0,1.0,1.0,2177,8708,32655,23947
16723,1.0,1.0,1.0,2178,8712,32670,23958
16725,1.0,1.0,1.0,2179,8716,32685,23969
16734,1.0,1.0,1.0,2180,8720,32700,23980
16735,1.0,1.0,1.0,2181,8724,32715,23991
16736,1.0,1.0,1.0,2182,8728,32730,24002
16737,1.0,1.0,1.0,2183,8732,32745,24013
16749,1.0,1.0,1.0,2184,8736,32760,24024
16757,1.0,1.0,1.0,2185,8740,32775,24035
16764,1.0,1.0,1.0,2186,8744,32790,24046
16767,1.0,1.0,1.0,2187,8748,32805,24057
16778,1.0,1.0,1.0,2188,8752,32820,24068
16812,1.0,1.0,1.0,2189,8756,32835,24079
16820,1.0,1.0,1.0,2190,8760,32850,24090
16830,1.0,1.0,1.0,2191,8764,32865,24101
16840,1.0,1.0,1.0,2192,8768,32880,24112
16844,1.0,1.0,1.0,2193,8772,32895,24123
16845,1.0,1.0,1.0,2194,8776,32910,24134
16850,1.0,1.0,1.0,2195,8780,32925,24145
16863,1.0,1.0,1.0,2196,8784,32940,24156
16881,1.0,1.0,1.0,2197,8788,32955,24167
16914,1.0,1.0,1.0,2198,8792,32970,24178
16920,1.0,1.0,1.0,2199,8796,32985,24189
16940,1.0,1.0,1.0,2200,8800,33000,24200
16942,1.0,1.0,1.0,2201,8804,33015,24211
16945,1.0,1.0,1.0,2202,8808,33030,24222
16950,1.0,1.0,1.0,2203,8812,33045,24233
16958,1.0,1.0,1.0,2204,8816,33060,24244
16959,1.0,1.0,1.0,2205,8820,33075,24255
16973,1.0,1.0,1.0,2206,8824,33090,24266
16975,1.0,1.0,1.0,2207,8828,33105,24277
16977,1.0,1.0,1.0,2208,8832,33120,24288
16993,1.0,1.0,1.0,2209,8836,33135,24299
16995,1.0,1.0,1.0,2210,8840,33150,24310
17017,1.0,1.0,1.0,2211,8844,33165,24321
17021,1.0,1.0,1.0,2212,8848,33180,24332
17046,1.0,1.0,1.0,2213,8852,33195,24343
17050,1.0,1.0,1.0,2214,8856,33210,24354
17059,1.0,1.0,1.0,2215,8860,33225,24365
17061,1.0,1.0,1.0,2216,8864,33240,24376
17062,1.0,1.0,1.0,2217,8868,33255,24387
17100,1.0,1.0,1.0,2218,8872,33270,24398
17104,1.0,1.0,1.0,2219,8876,33285,24409
17106,1.0,1.0,1.0,2220,8880,33300,24420
17125,1.0,1.0,1.0,2221,8884,33315,24431
17130,1.0,1.0,1.0,2222,8888,33330,24442
17140,1.0,1.0,1.0,2223,8892,33345,24453
17153,1.0,1.0,1.0,2224,8896,33360,24464
17155,1.0,1.0,1.0,2225,8900,33375,24475
17181,1.0,1.0,1.0,2226,8904,33390,24486
17183,1.0,1.0,1.0,2227,8908,33405,24497
17189,1.0,1.0,1.0,2228,8912,33420,24508
17193,1.0,1.0,1.0,2229,8916,33435,24519
17205,1.0,1.0,1.0,2230,8920,33450,24530
17208,1.0,1.0,1.0,2231,8924,33465,24541
17215,1.0,1.0,1.0,2232,8928,33480,24552
17223,1.0,1.0,1.0,2233,8932,33495,24563
17236,1.0,1.0,1.0,2234,8936,33510,24574
17237,1.0,1.0,1.0,2235,8940,33525,24585
17238,1.0,1.0,1.0,2236,8944,33540,24596
17243,1.0,1.0,1.0,2237,8948,33555,24607
17245,1.0,1.0,1.0,2238,8952,33570,24618
17252,1.0,1.0,1.0,2239,8956,33585,24629
17259,1.0,1.0,1.0,2240,8960,33600,24640
17263,1.0,1.0,1.0,2241,8964,33615,24651
17277,1.0,1.0,1.0,2242,8968,33630,24662
17291,1.0,1.0,1.0,2243,8972,33645,24673
17297,1.0,1.0,1.0,2244,8976,33660,24684
17301,1.0,1.0,1.0,2245,8980,33675,24695
17308,1.0,1.0,1.0,2246,8984,33690,24706
17310,1.0,1.0,1.0,2247,8988,33705,24717
17317,1.0,1.0,1.0,2248,8992,33720,24728
17328,1.0,1.0,1.0,2249,8996,33735,24739
17340,1.0,1.0,1.0,2250,9000,33750,24750
17350,1.0,1.0,1.0,2251,9004,33765,24761
17368,1.0,1.0,1.0,2252,9008,33780,24772
17378,1.0,1.0,1.0,2253,9012,33795,24783
17387,1.0,1.0,1.0,2254,9016,33810,24794
17408,1.0,1.0,1.0,2255,9020,33825,24805
17428,1.0,1.0,1.0,2256,9024,33840,24816
17435,1.0,1.0,1.0,2257,9028,33855,24827
17438,1.0,1.0,1.0,2258,9032,33870,24838
17446,1.0,1.0,1.0,2259,9036,33885,24849
17448,1.0,1.0,1.0,2260,9040,33900,24860
17453,1.0,1.0,1.0,2261,9044,33915,24871
17456,1.0,1.0,1.0,2262,9048,33930,24882
17459,1.0,1.0,1.0,2263,9052,33945,24893
17481,1.0,1.0,1.0,2264,9056,33960,24904
17487,1.0,1.0,1.0,2265,9060,33975,24915
17493,1.0,1.0,1.0,2266,9064,33990,24926
17494,1.0,1.0,1.0,2267,9068,34005,24937
17500,1.0,1.0,1.0,2268,9072,34020,24948
17512,1.0,1.0,1.0,2269,9076,34035,24959
17519,1.0,1.0,1.0,2270,9080,34050,24970
17525,1.0,1.0,1.0,2271,9084,34065,24981
17532,1.0,1.0,1.0,2272,9088,34080,24992
17540,1.0,1.0,1.0,2273,9092,34095,25003
17543,1.0,1.0,1.0,2274,9096,34110,25014
17544,1.0,1.0,1.0,2275,9100,34125,25025
17547,1.0,1.0,1.0,2276,9104,34140,25036
17556,1.0,1.0,1.0,2277,9108,34155,25047
17575,1.0,1.0,1.0,2278,9112,34170,25058
17606,1.0,1.0,1.0,2279,9116,34185,25069
17616,1.0,1.0,1.0,2280,9120,34200,25080
17617,1.0,1.0,1.0,2281,9124,34215,25091
17623,1.0,1.0,1.0,2282,9128,34230,25102
17632,1.0,1.0,1.0,2283,9132,34245,25113
17639,1.0,1.0,1.0,2284,9136,34260,25124
17656,1.0,1.0,1.0,2285,9140,34275,25135
17662,1.0,1.0,1.0,2286,9144,34290,25146
17680,1.0,1.0,1.0,2287,9148,34305,25157
17682,1.0,1.0,1.0,2288,9152,34320,25168
17685,1.0,1.0,1.0,2289,9156,34335,25179
17689,1.0,1.0,1.0,2290,9160,34350,25190
17711,1.0,1.0,1.0,2291,9164,34365,25201
17736,1.0,1.0,1.0,2292,9168,34380,25212
17750,1.0,1.0,1.0,2293,9172,34395,25223
17767,1.0,1.0,1.0,2294,9176,34410,25234
17769,1.0,1.0,1.0,2295,9180,34425,25245
17783,1.0,1.0,1.0,2296,9184,34440,25256
17785,1.0,1.0,1.0,2297,9188,34455,25267
17805,1.0,1.0,1.0,2298,9192,34470,25278
17819,1.0,1.0,1.0,2299,9196,34485,25289
17821,1.0,1.0,1.0,2300,9200,34500,25300
17823,1.0,1.0,1.0,2301,9204,34515,25311
17830,1.0,1.0,1.0,2302,9208,34530,25322
17835,1.0,1.0,1.0,2303,9212,34545,25333
17838,1.0,1.0,1.0,2304,9216,34560,25344
17846,1.0,1.0,1.0,2305,9220,34575,25355
17848,1.0,1.0,1.0,2306,9224,34590,25366
17850,1.0,1.0,1.0,2307,9228,34605,25377
17859,1.0,1.0,1.0,2308,9232,34620,25388
17893,1.0,1.0,1.0,2309,9236,34635,25399
17900,1.0,1.0,1.0,2310,9240,34650,25410
17909,1.0,1.0,1.0,2311,9244,34665,25421
17916,1.0,1.0,1.0,2312,9248,34680,25432
17921,1.0,1.0,1.0,2313,9252,34695,25443
17924,1.0,1.0,1.0,2314,9256,34710,25454
17925,1.0,1.0,1.0,2315,9260,34725,25465
17927,1.0,1.0,1.0,2316,9264,34740,25476
17928,1.0,1.0,1.0,2317,9268,34755,25487
17931,1.0,1.0,1.0,2318,9272,34770,25498
17932,1.0,1.0,1.0,2319,9276,34785,25509
17935,1.0,1.0,1.0,2320,9280,34800,25520
17936,1.0,1.0,1.0,2321,9284,34815,25531
17941,1.0,1.0,1.0,2322,9288,34830,25542
17951,1.0,1.0,1.0,2323,9292,34845,25553
17961,1.0,1.0,1.0,2324,9296,34860,25564
17971,1.0,1.0,1.0,2325,9300,34875,25575
17984,1.0,1.0,1.0,2326,9304,34890,25586
18032,1.0,1.0,1.0,2327,9308,34905,25597
18033,1.0,1.0,1.0,2328,9312,34920,25608
18047,1.0,1.0,1.0,2329,9316,34935,25619
18069,1.0,1.0,1.0,2330,9320,34950,25630
18090,1.0,1.0,1.0,2331,9324,34965,25641
18121,1.0,1.0,1.0,2332,9328,34980,25652
18123,1.0,1.0,1.0,2333,9332,34995,25663
18145,1.0,1.0,1.0,2334,9336,35010,25674
18147,1.0,1.0,1.0,2335,9340,35025,25685
18169,1.0,1.0,1.0,2336,9344,35040,25696
18176,1.0,1.0,1.0,2337,9348,35055,25707
18178,1.0,1.0,1.0,2338,9352,35070,25718
18179,1.0,1.0,1.0,2339,9356,35085,25729
18183,1.0,1.0,1.0,2340,9360,35100,25740
18202,1.0,1.0,1.0,2341,9364,35115,25751
18215,1.0,1.0,1.0,2342,9368,35130,25762
18234,1.0,1.0,1.0,2343,9372,35145,25773
18254,1.0,1.0,1.0,2344,9376,35160,25784
18258,1.0,1.0,1.0,2345,9380,35175,25795
18264,1.0,1.0,1.0,2346,9384,35190,25806
18266,1.0,1.0,1.0,2347,9388,35205,25817
18273,1.0,1.0,1.0,2348,9392,35220,25828
18283,1.0,1.0,1.0,2349,9396,35235,25839
18285,1.0,1.0,1.0,2350,9400,35250,25850
18288,1.0,1.0,1.0,2351,9404,35265,25861
18299,1.0,1.0,1.0,2352,9408,35280,25872
18305,1.0,1.0,1.0,2353,9412,35295,25883
18316,1.0,1.0,1.0,2354,9416,35310,25894
18317,1.0,1.0,1.0,2355,9420,35325,25905
18322,1.0,1.0,1.0,2356,9424,35340,25916
18333,1.0,1.0,1.0,2357,9428,35355,25927
18341,1.0,1.0,1.0,2358,9432,35370,25938
18347,1.0,1.0,1.0,2359,9436,35385,25949
18366,1.0,1.0,1.0,2360,9440,35400,25960
18381,1.0,1.0,1.0,2361,9444,35415,25971
18383,1.0,1.0,1.0,2362,9448,35430,25982
18389,1.0,1.0,1.0,2363,9452,35445,25993
18394,1.0,1.0,1.0,2364,9456,35460,26004
18396,1.0,1.0,1.0,2365,9460,35475,26015
18401,1.0,1.0,1.0,2366,9464,35490,26026
18411,1.0,1.0,1.0,2367,9468,35505,26037
18432,1.0,1.0,1.0,2368,9472,35520,26048
18451,1.0,1.0,1.0,2369,9476,35535,26059
18461,1.0,1.0,1.0,2370,9480,35550,26070
18462,1.0,1.0,1.0,2371,9484,35565,26081
18474,1.0,1.0,1.0,2372,9488,35580,26092
18483,1.0,1.0,1.0,2373,9492,35595,26103
18484,1.0,1.0,1.0,2374,9496,35610,26114
18531,1.0,1.0,1.0,2375,9500,35625,26125
18539,1.0,1.0,1.0,2376,9504,35640,26136
18549,1.0,1.0,1.0,2377,9508,35655,26147
18568,1.0,1.0,1.0,2378,9512,35670,26158
18580,1.0,1.0,1.0,2379,9516,35685,26169
18598,1.0,1.0,1.0,2380,9520,35700,26180
18599,1.0,1.0,1.0,2381,9524,35715,26191
18601,1.0,1.0,1.0,2382,9528,35730,26202
18608,1.0,1.0,1.0,2383,9532,35745,26213
18609,1.0,1.0,1.0,2384,9536,35760,26224
18615,1.0,1.0,1.0,2385,9540,35775,26235
18622,1.0,1.0,1.0,2386,9544,35790,26246
18626,1.0,1.0,1.0,2387,9548,35805,26257
18630,1.0,1.0,1.0,2388,9552,35820,26268
18642,1.0,1.0,1.0,2389,9556,35835,26279
18667,1.0,1.0,1.0,2390,9560,35850,26290
18672,1.0,1.0,1.0,2391,9564,35865,26301
18678,1.0,1.0,1.0,2392,9568,35880,26312
18699,1.0,1.0,1.0,2393,9572,35895,26323
18716,1.0,1.0,1.0,2394,9576,35910,26334
18721,1.0,1.0,1.0,2395,9580,35925,26345
18722,1.0,1.0,1.0,2396,9584,35940,26356
18725,1.0,1.0,1.0,2397,9588,35955,26367
18734,1.0,1.0,1.0,2398,9592,35970,26378
18739,1.0,1.0,1.0,2399,9596,35985,26389
18746,1.0,1.0,1.0,2400,9600,36000,26400
18749,1.0,1.0,1.0,2401,9604,36015,26411
18750,1.0,1.0,1.0,2402,9608,36030,26422
18784,1.0,1.0,1.0,2403,9612,36045,26433
18802,1.0,1.0,1.0,2404,9616,36060,26444
18810,1.0,1.0,1.0,2405,9620,36075,26455
18813,1.0,1.0,1.0,2406,9624,36090,26466
18844,1.0,1.0,1.0,2407,9628,36105,26477
18850,1.0,1.0,1.0,2408,9632,36120,26488
18863,1.0,1.0,1.0,2409,9636,36135,26499
18866,1.0,1.0,1.0,2410,9640,36150,26510
18867,1.0,1.0,1.0,2411,9644,36165,26521
18877,1.0,1.0,1.0,2412,9648,36180,26532
18879,1.0,1.0,1.0,2413,9652,36195,26543
18880,1.0,1.0,1.0,2414,9656,36210,26554
18897,1.0,1.0,1.0,2415,9660,36225,26565
18924,1.0,1.0,1.0,2416,9664,36240,26576
18930,1.0,1.0,1.0,2417,9668,36255,26587
18950,1.0,1.0,1.0,2418,9672,36270,26598
18956,1.0,1.0,1.0,2419,9676,36285,26609
18959,1.0,1.0,1.0,2420,9680,36300,26620
18961,1.0,1.0,1.0,2421,9684,36315,26631
18962,1.0,1.0,1.0,2422,9688,36330,26642
18963,1.0,1.0,1.0,2423,9692,36345,26653
18971,1.0,1.0,1.0,2424,9696,36360,26664
18979,1.0,1.0,1.0,2425,9700,36375,26675
18982,1.0,1.0,1.0,2426,9704,36390,26686
18989,1.0,1.0,1.0,2427,9708,36405,26697
18990,1.0,1.0,1.0,2428,9712,36420,26708
18997,1.0,1.0,1.0,2429,9716,36435,26719
19010,1.0,1.0,1.0,2430,9720,36450,26730
19020,1.0,1.0,1.0,2431,9724,36465,26741
19027,1.0,1.0,1.0,2432,9728,36480,26752
19056,1.0,1.0,1.0,2433,9732,36495,26763
19074,1.0,1.0,1.0,2434,9736,36510,26774
19083,1.0,1.0,1.0,2435,9740,36525,26785
19093,1.0,1.0,1.0,2436,9744,36540,26796
19149,1.0,1.0,1.0,2437,9748,36555,26807
19155,1.0,1.0,1.0,2438,9752,36570,26818
19161,1.0,1.0,1.0,2439,9756,36585,26829
19163,1.0,1.0,1.0,2440,9760,36600,26840
19171,1.0,1.0,1.0,2441,9764,36615,26851
19180,1.0,1.0,1.0,2442,9768,36630,26862
19187,1.0,1.0,1.0,2443,9772,36645,26873
19222,1.0,1.0,1.0,2444,9776,36660,26884
19233,1.0,1.0,1.0,2445,9780,36675,26895
19236,1.0,1.0,1.0,2446,9784,36690,26906
19240,1.0,1.0,1.0,2447,9788,36705,26917
19251,1.0,1.0,1.0,2448,9792,36720,26928
19256,1.0,1.0,1.0,2449,9796,36735,26939
19265,1.0,1.0,1.0,2450,9800,36750,26950
19292,1.0,1.0,1.0,2451,9804,36765,26961
19319,1.0,1.0,1.0,2452,9808,36780,26972
19339,1.0,1.0,1.0,2453,9812,36795,26983
19373,1.0,1.0,1.0,2454,9816,36810,26994
19388,1.0,1.0,1.0,2455,9820,36825,27005
19398,1.0,1.0,1.0,2456,9824,36840,27016
19409,1.0,1.0,1.0,2457,9828,36855,27027
19416,1.0,1.0,1.0,2458,9832,36870,27038
19421,1.0,1.0,1.0,2459,9836,36885,27049
19423,1.0,1.0,1.0,2460,9840,36900,27060
19433,1.0,1.0,1.0,2461,9844,36915,27071
19438,1.0,1.0,1.0,2462,9848,36930,27082
19476,1.0,1.0,1.0,2463,9852,36945,27093
19479,1.0,1.0,1.0,2464,9856,36960,27104
19483,1.0,1.0,1.0,2465,9860,36975,27115
19496,1.0,1.0,1.0,2466,9864,36990,27126
19548,1.0,1.0,1.0,2467,9868,37005,27137
19557,1.0,1.0,1.0,2468,9872,37020,27148
19588,1.0,1.0,1.0,2469,9876,37035,27159
19606,1.0,1.0,1.0,2470,9880,37050,27170
19617,1.0,1.0,1.0,2471,9884,37065,27181
19621,1.0,1.0,1.0,2472,9888,37080,27192
19645,1.0,1.0,1.0,2473,9892,37095,27203
19697,1.0,1.0,1.0,2474,9896,37110,27214
19707,1.0,1.0,1.0,2475,9900,37125,27225
19716,1.0,1.0,1.0,2476,9904,37140,27236
19754,1.0,1.0,1.0,2477,9908,37155,27247
19768,1.0,1.0,1.0,2478,9912,37170,27258
19783,1.0,1.0,1.0,2479,9916,37185,27269
19794,1.0,1.0,1.0,2480,9920,37200,27280
19812,1.0,1.0,1.0,2481,9924,37215,27291
19815,1.0,1.0,1.0,2482,9928,37230,27302
19825,1.0,1.0,1.0,2483,9932,37245,27313
19833,1.0,1.0,1.0,2484,9936,37260,27324
19840,1.0,1.0,1.0,2485,9940,37275,27335
19857,1.0,1.0,1.0,2486,9944,37290,27346
19865,1.0,1.0,1.0,2487,9948,37305,27357
19870,1.0,1.0,1.0,2488,9952,37320,27368
19881,1.0,1.0,1.0,2489,9956,37335,27379
19902,1.0,1.0,1.0,2490,9960,37350,27390
19906,1.0,1.0,1.0,2491,9964,37365,27401
19921,1.0,1.0,1.0,2492,9968,37380,27412
19922,1.0,1.0,1.0,2493,9972,37395,27423
19923,1.0,1.0,1.0,2494,9976,37410,27434
19926,1.0,1.0,1.0,2495,9980,37425,27445
19927,1.0,1.0,1.0,2496,9984,37440,27456
19946,1.0,1.0,1.0,2497,9988,37455,27467
19952,1.0,1.0,1.0,2498,9992,37470,27478
19953,1.0,1.0,1.0,2499,9996,37485,27489
19957,1.0,1.0,1.0,2500,10000,37500,27500
19959,1.0,1.0,1.0,2501,10004,37515,27511
19961,1.0,1.0,1.0,2502,10008,37530,27522
19967,1.0,1.0,1.0,2503,10012,37545,27533
19969,1.0,1.0,1.0,2504,10016,37560,27544
19973,1.0,1.0,1.0,2505,10020,37575,27555
19990,1.0,1.0,1.0,2506,10024,37590,27566
20000,1.0,1.0,1.0,2507,10028,37605,27577
20031,1.0,1.0,1.0,2508,10032,37620,27588
20032,1.0,1.0,1.0,2509,10036,37635,27599
20046,1.0,1.0,1.0,2510,10040,37650,27610
20063,1.0,1.0,1.0,2511,10044,37665,27621
20068,1.0,1.0,1.0,2512,10048,37680,27632
20086,1.0,1.0,1.0,2513,10052,37695,27643
20090,1.0,1.0,1.0,2514,10056,37710,27654
20111,1.0,1.0,1.0,2515,10060,37725,27665
20117,1.0,1.0,1.0,2516,10064,37740,27676
20120,1.0,1.0,1.0,2517,10068,37755,27687
20127,1.0,1.0,1.0,2518,10072,37770,27698
20147,1.0,1.0,1.0,2519,10076,37785,27709
20154,1.0,1.0,1.0,2520,10080,37800,27720
20172,1.0,1.0,1.0,2521,10084,37815,27731
20179,1.0,1.0,1.0,2522,10088,37830,27742
20182,1.0,1.0,1.0,2523,10092,37845,27753
20194,1.0,1.0,1.0,2524,10096,37860,27764
20201,1.0,1.0,1.0,2525,10100,37875,27775
20205,1.0,1.0,1.0,2526,10104,37890,27786
20207,1.0,1.0,1.0,2527,10108,37905,27797
20218,1.0,1.0,1.0,2528,10112,37920,27808
20221,1.0,1.0,1.0,2529,10116,37935,27819
20230,1.0,1.0,1.0,2530,10120,37950,27830
20231,1.0,1.0,1.0,2531,10124,37965,27841
20237,1.0,1.0,1.0,2532,10128,37980,27852
20251,1.0,1.0,1.0,2533,10132,37995,27863
20259,1.0,1.0,1.0,2534,10136,38010,27874
20267,1.0,1.0,1.0,2535,10140,38025,27885
20270,1.0,1.0,1.0,2536,10144,38040,27896
20271,1.0,1.0,1.0,2537,10148,38055,27907
20285,1.0,1.0,1.0,2538,10152,38070,27918
20294,1.0,1.0,1.0,2539,10156,38085,27929
20299,1.0,1.0,1.0,2540,10160,38100,27940
20304,1.0,1.0,1.0,2541,10164,38115,27951
20329,1.0,1.0,1.0,2542,10168,38130,27962
20333,1.0,1.0,1.0,2543,10172,38145,27973
20341,1.0,1.0,1.0,2544,10176,38160,27984
20347,1.0,1.0,1.0,2545,10180,38175,27995
20366,1.0,1.0,1.0,2546,10184,38190,28006
20372,1.0,1.0,1.0,2547,10188,38205,28017
20378,1.0,1.0,1.0,2548,10192,38220,28028
20383,1.0,1.0,1.0,2549,10196,38235,28039
20397,1.0,1.0,1.0,2550,10200,38250,28050
20410,1.0,1.0,1.0,2551,10204,38265,28061
20414,1.0,1.0,1.0,2552,10208,38280,28072
20415,1.0,1.0,1.0,2553,10212,38295,28083
20419,1.0,1.0,1.0,2554,10216,38310,28094
20421,1.0,1.0,1.0,2555,10220,38325,28105
20425,1.0,1.0,1.0,2556,10224,38340,28116
20438,1.0,1.0,1.0,2557,10228,38355,28127
20451,1.0,1.0,1.0,2558,10232,38370,28138
20452,1.0,1.0,1.0,2559,10236,38385,28149
20457,1.0,1.0,1.0,2560,10240,38400,28160
20461,1.0,1.0,1.0,2561,10244,38415,28171
20468,1.0,1.0,1.0,2562,10248,38430,28182
20475,1.0,1.0,1.0,2563,10252,38445,28193
20478,1.0,1.0,1.0,2564,10256,38460,28204
20485,1.0,1.0,1.0,2565,10260,38475,28215
20491,1.0,1.0,1.0,2566,10264,38490,28226
20497,1.0,1.0,1.0,2567,10268,38505,28237
20500,1.0,1.0,1.0,2568,10272,38520,28248
20502,1.0,1.0,1.0,2569,10276,38535,28259
20513,1.0,1.0,1.0,2570,10280,38550,28270
20517,1.0,1.0,1.0,2571,10284,38565,28281
20520,1.0,1.0,1.0,2572,10288,38580,28292
20558,1.0,1.0,1.0,2573,10292,38595,28303
20578,1.0,1.0,1.0,2574,10296,38610,28314
20580,1.0,1.0,1.0,2575,10300,38625,28325
20596,1.0,1.0,1.0,2576,10304,38640,28336
20603,1.0,1.0,1.0,2577,10308,38655,28347
20615,1.0,1.0,1.0,2578,10312,38670,28358
20617,1.0,1.0,1.0,2579,10316,38685,28369
20621,1.0,1.0,1.0,2580,10320,38700,28380
20630,1.0,1.0,1.0,2581,10324,38715,28391
20636,1.0,1.0,1.0,2582,10328,38730,28402
20643,1.0,1.0,1.0,2583,10332,38745,28413
20645,1.0,1.0,1.0,2584,10336,38760,28424
20651,1.0,1.0,1.0,2585,10340,38775,28435
20656,1.0,1.0,1.0,2586,10344,38790,28446
20673,1.0,1.0,1.0,2587,10348,38805,28457
20688,1.0,1.0,1.0,2588,10352,38820,28468
20692,1.0,1.0,1.0,2589,10356,38835,28479
20701,1.0,1.0,1.0,2590,10360,38850,28490
20703,1.0,1.0,1.0,2591,10364,38865,28501
20714,1.0,1.0,1.0,2592,10368,38880,28512
20715,1.0,1.0,1.0,2593,10372,38895,28523
20716,1.0,1.0,1.0,2594,10376,38910,28534
20721,1.0,1.0,1.0,2595,10380,38925,28545
20724,1.0,1.0,1.0,2596,10384,38940,28556
20739,1.0,1.0,1.0,2597,10388,38955,28567
20756,1.0,1.0,1.0,2598,10392,38970,28578
20769,1.0,1.0,1.0,2599,10396,38985,28589
20770,1.0,1.0,1.0,2600,10400,39000,28600
20772,1.0,1.0,1.0,2601,10404,39015,28611
20775,1.0,1.0,1.0,2602,10408,39030,28622
20781,1.0,1.0,1.0,2603,10412,39045,28633
20782,1.0,1.0,1.0,2604,10416,39060,28644
20798,1.0,1.0,1.0,2605,10420,39075,28655
20804,1.0,1.0,1.0,2606,10424,39090,28666
20810,1.0,1.0,1.0,2607,10428,39105,28677
20816,1.0,1.0,1.0,2608,10432,39120,28688
20818,1.0,1.0,1.0,2609,10436,39135,28699
20825,1.0,1.0,1.0,2610,10440,39150,28710
20841,1.0,1.0,1.0,2611,10444,39165,28721
20845,1.0,1.0,1.0,2612,10448,39180,28732
20862,1.0,1.0,1.0,2613,10452,39195,28743
20869,1.0,1.0,1.0,2614,10456,39210,28754
20873,1.0,1.0,1.0,2615,10460,39225,28765
20882,1.0,1.0,1.0,2616,10464,39240,28776
20921,1.0,1.0,1.0,2617,10468,39255,28787
20924,1.0,1.0,1.0,2618,10472,39270,28798
20926,1.0,1.0,1.0,2619,10476,39285,28809
20945,1.0,1.0,1.0,2620,10480,39300,28820
20947,1.0,1.0,1.0,2621,10484,39315,28831
20967,1.0,1.0,1.0,2622,10488,39330,28842
20979,1.0,1.0,1.0,2623,10492,39345,28853
20982,1.0,1.0,1.0,2624,10496,39360,28864
21014,1.0,1.0,1.0,2625,10500,39375,28875
21019,1.0,1.0,1.0,2626,10504,39390,28886
21041,1.0,1.0,1.0,2627,10508,39405,28897
21047,1.0,1.0,1.0,2628,10512,39420,28908
21065,1.0,1.0,1.0,2629,10516,39435,28919
21075,1.0,1.0,1.0,2630,10520,39450,28930
21083,1.0,1.0,1.0,2631,10524,39465,28941
21088,1.0,1.0,1.0,2632,10528,39480,28952
21090,1.0,1.0,1.0,2633,10532,39495,28963
21092,1.0,1.0,1.0,2634,10536,39510,28974
21107,1.0,1.0,1.0,2635,10540,39525,28985
21118,1.0,1.0,1.0,2636,10544,39540,28996
21123,1.0,1.0,1.0,2637,10548,39555,29007
21143,1.0,1.0,1.0,2638,10552,39570,29018
21156,1.0,1.0,1.0,2639,10556,39585,29029
21159,1.0,1.0,1.0,2640,10560,39600,29040
21174,1.0,1.0,1.0,2641,10564,39615,29051
21188,1.0,1.0,1.0,2642,10568,39630,29062
21225,1.0,1.0,1.0,2643,10572,39645,29073
21229,1.0,1.0,1.0,2644,10576,39660,29084
21231,1.0,1.0,1.0,2645,10580,39675,29095
21240,1.0,1.0,1.0,2646,10584,39690,29106
21242,1.0,1.0,1.0,2647,10588,39705,29117
21264,1.0,1.0,1.0,2648,10592,39720,29128
21301,1.0,1.0,1.0,2649,10596,39735,29139
21318,1.0,1.0,1.0,2650,10600,39750,29150
21323,1.0,1.0,1.0,2651,10604,39765,29161
21332,1.0,1.0,1.0,2652,10608,39780,29172
21336,1.0,1.0,1.0,2653,10612,39795,29183
21339,1.0,1.0,1.0,2654,10616,39810,29194
21354,1.0,1.0,1.0,2655,10620,39825,29205
21393,1.0,1.0,1.0,2656,10624,39840,29216
21397,1.0,1.0,1.0,2657,10628,39855,29227
21399,1.0,1.0,1.0,2658,10632,39870,29238
21426,1.0,1.0,1.0,2659,10636,39885,29249
21437,1.0,1.0,1.0,2660,10640,39900,29260
21449,1.0,1.0,1.0,2661,10644,39915,29271
21460,1.0,1.0,1.0,2662,10648,39930,29282
21467,1.0,1.0,1.0,2663,10652,39945,29293
21493,1.0,1.0,1.0,2664,10656,39960,29304
21496,1.0,1.0,1.0,2665,10660,39975,29315
21518,1.0,1.0,1.0,2666,10664,39990,29326
21537,1.0,1.0,1.0,2667,10668,40005,29337
21538,1.0,1.0,1.0,2668,10672,40020,29348
21550,1.0,1.0,1.0,2669,10676,40035,29359
21561,1.0,1.0,1.0,2670,10680,40050,29370
21563,1.0,1.0,1.0,2671,10684,40065,29381
21565,1.0,1.0,1.0,2672,10688,40080,29392
21570,1.0,1.0,1.0,2673,10692,40095,29403
21571,1.0,1.0,1.0,2674,10696,40110,29414
21574,1.0,1.0,1.0,2675,10700,40125,29425
21575,1.0,1.0,1.0,2676,10704,40140,29436
21579,1.0,1.0,1.0,2677,10708,40155,29447
21592,1.0,1.0,1.0,2678,10712,40170,29458
21593,1.0,1.0,1.0,2679,10716,40185,29469
21623,1.0,1.0,1.0,2680,10720,40200,29480
21626,1.0,1.0,1.0,2681,10724,40215,29491
21635,1.0,1.0,1.0,2682,10728,40230,29502
21648,1.0,1.0,1.0,2683,10732,40245,29513
21655,1.0,1.0,1.0,2684,10736,40260,29524
21657,1.0,1.0,1.0,2685,10740,40275,29535
21663,1.0,1.0,1.0,2686,10744,40290,29546
21676,1.0,1.0,1.0,2687,10748,40305,29557
21678,1.0,1.0,1.0,2688,10752,40320,29568
21685,1.0,1.0,1.0,2689,10756,40335,29579
21689,1.0,1.0,1.0,2690,10760,40350,29590
21696,1.0,1.0,1.0,2691,10764,40365,29601
21701,1.0,1.0,1.0,2692,10768,40380,29612
21702,1.0,1.0,1.0,2693,10772,40395,29623
21703,1.0,1.0,1.0,2694,10776,40410,29634
21704,1.0,1.0,1.0,2695,10780,40425,29645
21707,1.0,1.0,1.0,2696,10784,40440,29656
21721,1.0,1.0,1.0,2697,10788,40455,29667
21727,1.0,1.0,1.0,2698,10792,40470,29678
21731,1.0,1.0,1.0,2699,10796,40485,29689
21732,1.0,1.0,1.0,2700,10800,40500,29700
21740,1.0,1.0,1.0,2701,10804,40515,29711
414,1.0,1.0,0.8,2702,10808,40530,29722
471,1.0,1.0,0.8,2703,10812,40545,29733
1845,1.0,1.0,0.8,2704,10816,40560,29744
2095,1.0,1.0,0.8,2705,10820,40575,29755
2179,1.0,1.0,0.8,2706,10824,40590,29766
2313,1.0,1.0,0.8,2707,10828,40605,29777
2613,1.0,1.0,0.8,2708,10832,40620,29788
2977,1.0,1.0,0.8,2709,10836,40635,29799
3197,1.0,1.0,0.8,2710,10840,40650,29810
3395,1.0,1.0,0.8,2711,10844,40665,29821
4330,1.0,1.0,0.8,2712,10848,40680,29832
4440,1.0,1.0,0.8,2713,10852,40695,29843
4631,1.0,1.0,0.8,2714,10856,40710,29854
4768,1.0,1.0,0.8,2715,10860,40725,29865
5187,1.0,1.0,0.8,2716,10864,40740,29876
5934,1.0,1.0,0.8,2717,10868,40755,29887
6527,1.0,1.0,0.8,2718,10872,40770,29898
7358,1.0,1.0,0.8,2719,10876,40785,29909
7479,0.0,1.0,0.8,2719,10880,40785,29905
7753,1.0,1.0,0.8,2720,10884,40800,29916
8094,1.0,1.0,0.8,2721,10888,40815,29927
8125,1.0,1.0,0.8,2722,10892,40830,29938
8224,1.0,1.0,0.8,2723,10896,40845,29949
8476,1.0,1.0,0.8,2724,10900,40860,29960
8854,0.0,1.0,0.8,2724,10904,40860,29956
9548,1.0,1.0,0.8,2725,10908,40875,29967
9669,1.0,1.0,0.8,2726,10912,40890,29978
9815,1.0,1.0,0.8,2727,10916,40905,29989
10046,0.0,1.0,0.8,2727,10920,40905,29985
10077,1.0,1.0,0.8,2728,10924,40920,29996
10248,0.0,1.0,0.8,2728,10928,40920,29992
10252,1.0,1.0,0.8,2729,10932,40935,30003
10473,0.0,1.0,0.8,2729,10936,40935,29999
10487,1.0,1.0,0.8,2730,10940,40950,30010
10639,1.0,1.0,0.8,2731,10944,40965,30021
10781,1.0,1.0,0.8,2732,10948,40980,30032
10977,1.0,1.0,0.8,2733,10952,40995,30043
11056,1.0,1.0,0.8,2734,10956,41010,30054
11187,1.0,1.0,0.8,2735,10960,41025,30065
11189,1.0,1.0,0.8,2736,10964,41040,30076
11262,1.0,1.0,0.8,2737,10968,41055,30087
11384,1.0,1.0,0.8,2738,10972,41070,30098
11398,1.0,1.0,0.8,2739,10976,41085,30109
11413,1.0,1.0,0.8,2740,10980,41100,30120
12264,0.0,1.0,0.8,2740,10984,41100,30116
12426,0.0,1.0,0.8,2740,10988,41100,30112
12500,1.0,1.0,0.8,2741,10992,41115,30123
12668,1.0,1.0,0.8,2742,10996,41130,30134
12894,0.0,1.0,0.8,2742,11000,41130,30130
13067,1.0,1.0,0.8,2743,11004,41145,30141
13309,1.0,1.0,0.8,2744,11008,41160,30152
13468,1.0,1.0,0.8,2745,11012,41175,30163
13815,1.0,1.0,0.8,2746,11016,41190,30174
13824,1.0,1.0,0.8,2747,11020,41205,30185
13912,0.0,1.0,0.8,2747,11024,41205,30181
13944,1.0,1.0,0.8,2748,11028,41220,30192
14041,0.0,1.0,0.8,2748,11032,41220,30188
14101,1.0,1.0,0.8,2749,11036,41235,30199
14394,1.0,1.0,0.8,2750,11040,41250,30210
14550,1.0,1.0,0.8,2751,11044,41265,30221
14595,0.0,1.0,0.8,2751,11048,41265,30217
14949,0.0,1.0,0.8,2751,11052,41265,30213
14990,1.0,1.0,0.8,2752,11056,41280,30224
15068,1.0,1.0,0.8,2753,11060,41295,30235
15505,1.0,1.0,0.8,2754,11064,41310,30246
15516,0.0,1.0,0.8,2754,11068,41310,30242
15645,0.0,1.0,0.8,2754,11072,41310,30238
15765,1.0,1.0,0.8,2755,11076,41325,30249
16091,1.0,1.0,0.8,2756,11080,41340,30260
16252,1.0,1.0,0.8,2757,11084,41355,30271
16338,1.0,1.0,0.8,2758,11088,41370,30282
16342,1.0,1.0,0.8,2759,11092,41385,30293
16400,0.0,1.0,0.8,2759,11096,41385,30289
16495,1.0,1.0,0.8,2760,11100,41400,30300
16569,1.0,1.0,0.8,2761,11104,41415,30311
16791,1.0,1.0,0.8,2762,11108,41430,30322
16803,1.0,1.0,0.8,2763,11112,41445,30333
16987,1.0,1.0,0.8,2764,11116,41460,30344
17160,1.0,1.0,0.8,2765,11120,41475,30355
17191,1.0,1.0,0.8,2766,11124,41490,30366
17703,1.0,1.0,0.8,2767,11128,41505,30377
19137,1.0,1.0,0.8,2768,11132,41520,30388
19822,1.0,1.0,0.8,2769,11136,41535,30399
19871,0.0,1.0,0.8,2769,11140,41535,30395
20089,1.0,1.0,0.8,2770,11144,41550,30406
20241,1.0,1.0,0.8,2771,11148,41565,30417
20493,1.0,1.0,0.8,2772,11152,41580,30428
20641,0.0,1.0,0.8,2772,11156,41580,30424
21152,0.0,1.0,0.8,2772,11160,41580,30420
21420,1.0,1.0,0.8,2773,11164,41595,30431
273,1.0,1.0,0.75,2774,11168,41610,30442
728,0.0,1.0,0.75,2774,11172,41610,30438
898,1.0,1.0,0.75,2775,11176,41625,30449
1171,0.0,1.0,0.75,2775,11180,41625,30445
1232,0.0,1.0,0.75,2775,11184,41625,30441
1238,0.0,1.0,0.75,2775,11188,41625,30437
1274,1.0,1.0,0.75,2776,11192,41640,30448
1426,1.0,1.0,0.75,2777,11196,41655,30459
1631,1.0,1.0,0.75,2778,11200,41670,30470
2232,1.0,1.0,0.75,2779,11204,41685,30481
2336,1.0,1.0,0.75,2780,11208,41700,30492
2362,0.0,1.0,0.75,2780,11212,41700,30488
2451,0.0,1.0,0.75,2780,11216,41700,30484
2949,1.0,1.0,0.75,2781,11220,41715,30495
3194,1.0,1.0,0.75,2782,11224,41730,30506
3219,1.0,1.0,0.75,2783,11228,41745,30517
3740,1.0,1.0,0.75,2784,11232,41760,30528
4029,0.0,1.0,0.75,2784,11236,41760,30524
4210,1.0,1.0,0.75,2785,11240,41775,30535
4262,1.0,1.0,0.75,2786,11244,41790,30546
4288,1.0,1.0,0.75,2787,11248,41805,30557
4789,0.0,1.0,0.75,2787,11252,41805,30553
4910,1.0,1.0,0.75,2788,11256,41820,30564
4982,0.0,1.0,0.75,2788,11260,41820,30560
5190,1.0,1.0,0.75,2789,11264,41835,30571
5434,1.0,1.0,0.75,2790,11268,41850,30582
5469,1.0,1.0,0.75,2791,11272,41865,30593
5561,1.0,1.0,0.75,2792,11276,41880,30604
5800,1.0,1.0,0.75,2793,11280,41895,30615
5822,1.0,1.0,0.75,2794,11284,41910,30626
5983,1.0,1.0,0.75,2795,11288,41925,30637
5993,1.0,1.0,0.75,2796,11292,41940,30648
6127,1.0,1.0,0.75,2797,11296,41955,30659
6323,0.0,1.0,0.75,2797,11300,41955,30655
6416,0.0,1.0,0.75,2797,11304,41955,30651
6458,1.0,1.0,0.75,2798,11308,41970,30662
6576,1.0,1.0,0.75,2799,11312,41985,30673
6707,1.0,1.0,0.75,2800,11316,42000,30684
6956,0.0,1.0,0.75,2800,11320,42000,30680
7316,1.0,1.0,0.75,2801,11324,42015,30691
7348,0.0,1.0,0.75,2801,11328,42015,30687
7419,1.0,1.0,0.75,2802,11332,42030,30698
7494,1.0,1.0,0.75,2803,11336,42045,30709
7533,1.0,1.0,0.75,2804,11340,42060,30720
7542,1.0,1.0,0.75,2805,11344,42075,30731
7546,1.0,1.0,0.75,2806,11348,42090,30742
7603,0.0,1.0,0.75,2806,11352,42090,30738
8183,1.0,1.0,0.75,2807,11356,42105,30749
8314,1.0,1.0,0.75,2808,11360,42120,30760
8340,1.0,1.0,0.75,2809,11364,42135,30771
8564,0.0,1.0,0.75,2809,11368,42135,30767
8635,0.0,1.0,0.75,2809,11372,42135,30763
8971,0.0,1.0,0.75,2809,11376,42135,30759
8992,1.0,1.0,0.75,2810,11380,42150,30770
9024,1.0,1.0,0.75,2811,11384,42165,30781
9088,1.0,1.0,0.75,2812,11388,42180,30792
9133,0.0,1.0,0.75,2812,11392,42180,30788
9337,1.0,1.0,0.75,2813,11396,42195,30799
9350,1.0,1.0,0.75,2814,11400,42210,30810
9791,1.0,1.0,0.75,2815,11404,42225,30821
9865,1.0,1.0,0.75,2816,11408,42240,30832
9885,1.0,1.0,0.75,2817,11412,42255,30843
9958,0.0,1.0,0.75,2817,11416,42255,30839
10040,1.0,1.0,0.75,2818,11420,42270,30850
10091,1.0,1.0,0.75,2819,11424,42285,30861
10111,1.0,1.0,0.75,2820,11428,42300,30872
10185,0.0,1.0,0.75,2820,11432,42300,30868
10283,0.0,1.0,0.75,2820,11436,42300,30864
10457,1.0,1.0,0.75,2821,11440,42315,30875
10821,1.0,1.0,0.75,2822,11444,42330,30886
10963,1.0,1.0,0.75,2823,11448,42345,30897
11142,0.0,1.0,0.75,2823,11452,42345,30893
11292,1.0,1.0,0.75,2824,11456,42360,30904
11345,0.0,1.0,0.75,2824,11460,42360,30900
11374,1.0,1.0,0.75,2825,11464,42375,30911
11399,1.0,1.0,0.75,2826,11468,42390,30922
11642,1.0,1.0,0.75,2827,11472,42405,30933
11848,0.0,1.0,0.75,2827,11476,42405,30929
12009,1.0,1.0,0.75,2828,11480,42420,30940
12226,1.0,1.0,0.75,2829,11484,42435,30951
12267,1.0,1.0,0.75,2830,11488,42450,30962
12396,1.0,1.0,0.75,2831,11492,42465,30973
12525,1.0,1.0,0.75,2832,11496,42480,30984
12764,1.0,1.0,0.75,2833,11500,42495,30995
12815,1.0,1.0,0.75,2834,11504,42510,31006
12987,1.0,1.0,0.75,2835,11508,42525,31017
13008,1.0,1.0,0.75,2836,11512,42540,31028
13227,1.0,1.0,0.75,2837,11516,42555,31039
13500,1.0,1.0,0.75,2838,11520,42570,31050
13567,1.0,1.0,0.75,2839,11524,42585,31061
13961,1.0,1.0,0.75,2840,11528,42600,31072
14165,1.0,1.0,0.75,2841,11532,42615,31083
14166,1.0,1.0,0.75,2842,11536,42630,31094
14181,1.0,1.0,0.75,2843,11540,42645,31105
14452,1.0,1.0,0.75,2844,11544,42660,31116
14863,0.0,1.0,0.75,2844,11548,42660,31112
15013,0.0,1.0,0.75,2844,11552,42660,31108
15042,1.0,1.0,0.75,2845,11556,42675,31119
15091,1.0,1.0,0.75,2846,11560,42690,31130
15242,1.0,1.0,0.75,2847,11564,42705,31141
15373,1.0,1.0,0.75,2848,11568,42720,31152
15445,1.0,1.0,0.75,2849,11572,42735,31163
15736,1.0,1.0,0.75,2850,11576,42750,31174
15866,0.0,1.0,0.75,2850,11580,42750,31170
15995,1.0,1.0,0.75,2851,11584,42765,31181
16028,1.0,1.0,0.75,2852,11588,42780,31192
16113,1.0,1.0,0.75,2853,11592,42795,31203
16116,1.0,1.0,0.75,2854,11596,42810,31214
16260,1.0,1.0,0.75,2855,11600,42825,31225
16284,0.0,1.0,0.75,2855,11604,42825,31221
16456,1.0,1.0,0.75,2856,11608,42840,31232
16492,0.0,1.0,0.75,2856,11612,42840,31228
16509,1.0,1.0,0.75,2857,11616,42855,31239
16628,1.0,1.0,0.75,2858,11620,42870,31250
16763,1.0,1.0,0.75,2859,11624,42885,31261
16781,1.0,1.0,0.75,2860,11628,42900,31272
16894,0.0,1.0,0.75,2860,11632,42900,31268
16915,1.0,1.0,0.75,2861,11636,42915,31279
17026,0.0,1.0,0.75,2861,11640,42915,31275
17088,0.0,1.0,0.75,2861,11644,42915,31271
17224,0.0,1.0,0.75,2861,11648,42915,31267
17281,0.0,1.0,0.75,2861,11652,42915,31263
17451,1.0,1.0,0.75,2862,11656,42930,31274
17503,1.0,1.0,0.75,2863,11660,42945,31285
17598,1.0,1.0,0.75,2864,11664,42960,31296
18419,1.0,1.0,0.75,2865,11668,42975,31307
18635,1.0,1.0,0.75,2866,11672,42990,31318
18666,1.0,1.0,0.75,2867,11676,43005,31329
18681,1.0,1.0,0.75,2868,11680,43020,31340
19014,1.0,1.0,0.75,2869,11684,43035,31351
19272,1.0,1.0,0.75,2870,11688,43050,31362
19929,1.0,1.0,0.75,2871,11692,43065,31373
20026,1.0,1.0,0.75,2872,11696,43080,31384
20035,1.0,1.0,0.75,2873,11700,43095,31395
20463,1.0,1.0,0.75,2874,11704,43110,31406
21203,1.0,1.0,0.75,2875,11708,43125,31417
21224,1.0,1.0,0.75,2876,11712,43140,31428
21250,1.0,1.0,0.75,2877,11716,43155,31439
21251,0.0,1.0,0.75,2877,11720,43155,31435
21615,1.0,1.0,0.75,2878,11724,43170,31446
32,1.0,1.0,0.6666666666666666,2879,11728,43185,31457
39,0.0,1.0,0.6666666666666666,2879,11732,43185,31453
61,1.0,1.0,0.6666666666666666,2880,11736,43200,31464
91,1.0,1.0,0.6666666666666666,2881,11740,43215,31475
143,1.0,1.0,0.6666666666666666,2882,11744,43230,31486
238,1.0,1.0,0.6666666666666666,2883,11748,43245,31497
494,1.0,1.0,0.6666666666666666,2884,11752,43260,31508
522,1.0,1.0,0.6666666666666666,2885,11756,43275,31519
795,1.0,1.0,0.6666666666666666,2886,11760,43290,31530
807,1.0,1.0,0.6666666666666666,2887,11764,43305,31541
808,0.0,1.0,0.6666666666666666,2887,11768,43305,31537
852,0.0,1.0,0.6666666666666666,2887,11772,43305,31533
1031,1.0,1.0,0.6666666666666666,2888,11776,43320,31544
1051,0.0,1.0,0.6666666666666666,2888,11780,43320,31540
1229,1.0,1.0,0.6666666666666666,2889,11784,43335,31551
1278,0.0,1.0,0.6666666666666666,2889,11788,43335,31547
1286,1.0,1.0,0.6666666666666666,2890,11792,43350,31558
1319,1.0,1.0,0.6666666666666666,2891,11796,43365,31569
1332,1.0,1.0,0.6666666666666666,2892,11800,43380,31580
1465,1.0,1.0,0.6666666666666666,2893,11804,43395,31591
1478,0.0,1.0,0.6666666666666666,2893,11808,43395,31587
1540,1.0,1.0,0.6666666666666666,2894,11812,43410,31598
1644,1.0,1.0,0.6666666666666666,2895,11816,43425,31609
1652,1.0,1.0,0.6666666666666666,2896,11820,43440,31620
1702,1.0,1.0,0.6666666666666666,2897,11824,43455,31631
1764,1.0,1.0,0.6666666666666666,2898,11828,43470,31642
1886,1.0,1.0,0.6666666666666666,2899,11832,43485,31653
1893,1.0,1.0,0.6666666666666666,2900,11836,43500,31664
1956,0.0,1.0,0.6666666666666666,2900,11840,43500,31660
2018,1.0,1.0,0.6666666666666666,2901,11844,43515,31671
2030,1.0,1.0,0.6666666666666666,2902,11848,43530,31682
2055,0.0,1.0,0.6666666666666666,2902,11852,43530,31678
2074,1.0,1.0,0.6666666666666666,2903,11856,43545,31689
2263,0.0,1.0,0.6666666666666666,2903,11860,43545,31685
2293,0.0,1.0,0.6666666666666666,2903,11864,43545,31681
2305,1.0,1.0,0.6666666666666666,2904,11868,43560,31692
2330,0.0,1.0,0.6666666666666666,2904,11872,43560,31688
2361,0.0,1.0,0.6666666666666666,2904,11876,43560,31684
2412,1.0,1.0,0.6666666666666666,2905,11880,43575,31695
2435,0.0,1.0,0.6666666666666666,2905,11884,43575,31691
2441,1.0,1.0,0.6666666666666666,2906,11888,43590,31702
2449,1.0,1.0,0.6666666666666666,2907,11892,43605,31713
2489,1.0,1.0,0.6666666666666666,2908,11896,43620,31724
2502,1.0,1.0,0.6666666666666666,2909,11900,43635,31735
2517,1.0,1.0,0.6666666666666666,2910,11904,43650,31746
2630,0.0,1.0,0.6666666666666666,2910,11908,43650,31742
2682,1.0,1.0,0.6666666666666666,2911,11912,43665,31753
2769,1.0,1.0,0.6666666666666666,2912,11916,43680,31764
2812,0.0,1.0,0.6666666666666666,2912,11920,43680,31760
3012,1.0,1.0,0.6666666666666666,2913,11924,43695,31771
3139,0.0,1.0,0.6666666666666666,2913,11928,43695,31767
3176,0.0,1.0,0.6666666666666666,2913,11932,43695,31763
3233,0.0,1.0,0.6666666666666666,2913,11936,43695,31759
3251,1.0,1.0,0.6666666666666666,2914,11940,43710,31770
3287,1.0,1.0,0.6666666666666666,2915,11944,43725,31781
3356,1.0,1.0,0.6666666666666666,2916,11948,43740,31792
3437,0.0,1.0,0.6666666666666666,2916,11952,43740,31788
3481,1.0,1.0,0.6666666666666666,2917,11956,43755,31799
3565,1.0,1.0,0.6666666666666666,2918,11960,43770,31810
3627,1.0,1.0,0.6666666666666666,2919,11964,43785,31821
3797,0.0,1.0,0.6666666666666666,2919,11968,43785,31817
3816,0.0,1.0,0.6666666666666666,2919,11972,43785,31813
3848,1.0,1.0,0.6666666666666666,2920,11976,43800,31824
3937,1.0,1.0,0.6666666666666666,2921,11980,43815,31835
3952,0.0,1.0,0.6666666666666666,2921,11984,43815,31831
4039,1.0,1.0,0.6666666666666666,2922,11988,43830,31842
4106,1.0,1.0,0.6666666666666666,2923,11992,43845,31853
4120,0.0,1.0,0.6666666666666666,2923,11996,43845,31849
4166,1.0,1.0,0.6666666666666666,2924,12000,43860,31860
4172,1.0,1.0,0.6666666666666666,2925,12004,43875,31871
4221,1.0,1.0,0.6666666666666666,2926,12008,43890,31882
4349,0.0,1.0,0.6666666666666666,2926,12012,43890,31878
4350,0.0,1.0,0.6666666666666666,2926,12016,43890,31874
4383,0.0,1.0,0.6666666666666666,2926,12020,43890,31870
4385,1.0,1.0,0.6666666666666666,2927,12024,43905,31881
4388,1.0,1.0,0.6666666666666666,2928,12028,43920,31892
4451,0.0,1.0,0.6666666666666666,2928,12032,43920,31888
4470,1.0,1.0,0.6666666666666666,2929,12036,43935,31899
4497,1.0,1.0,0.6666666666666666,2930,12040,43950,31910
4540,0.0,1.0,0.6666666666666666,2930,12044,43950,31906
4704,0.0,1.0,0.6666666666666666,2930,12048,43950,31902
4752,1.0,1.0,0.6666666666666666,2931,12052,43965,31913
4827,0.0,1.0,0.6666666666666666,2931,12056,43965,31909
4828,0.0,1.0,0.6666666666666666,2931,12060,43965,31905
4939,1.0,1.0,0.6666666666666666,2932,12064,43980,31916
4970,1.0,1.0,0.6666666666666666,2933,12068,43995,31927
4998,0.0,1.0,0.6666666666666666,2933,12072,43995,31923
5012,1.0,1.0,0.6666666666666666,2934,12076,44010,31934
5044,0.0,1.0,0.6666666666666666,2934,12080,44010,31930
5067,1.0,1.0,0.6666666666666666,2935,12084,44025,31941
5070,1.0,1.0,0.6666666666666666,2936,12088,44040,31952
5075,1.0,1.0,0.6666666666666666,2937,12092,44055,31963
5131,0.0,1.0,0.6666666666666666,2937,12096,44055,31959
5169,1.0,1.0,0.6666666666666666,2938,12100,44070,31970
5249,0.0,1.0,0.6666666666666666,2938,12104,44070,31966
5357,1.0,1.0,0.6666666666666666,2939,12108,44085,31977
5406,0.0,1.0,0.6666666666666666,2939,12112,44085,31973
5427,1.0,1.0,0.6666666666666666,2940,12116,44100,31984
5463,1.0,1.0,0.6666666666666666,2941,12120,44115,31995
5568,1.0,1.0,0.6666666666666666,2942,12124,44130,32006
5631,1.0,1.0,0.6666666666666666,2943,12128,44145,32017
5719,1.0,1.0,0.6666666666666666,2944,12132,44160,32028
5755,1.0,1.0,0.6666666666666666,2945,12136,44175,32039
5801,0.0,1.0,0.6666666666666666,2945,12140,44175,32035
5914,1.0,1.0,0.6666666666666666,2946,12144,44190,32046
5922,1.0,1.0,0.6666666666666666,2947,12148,44205,32057
5955,1.0,1.0,0.6666666666666666,2948,12152,44220,32068
5987,1.0,1.0,0.6666666666666666,2949,12156,44235,32079
6073,1.0,1.0,0.6666666666666666,2950,12160,44250,32090
6151,1.0,1.0,0.6666666666666666,2951,12164,44265,32101
6256,1.0,1.0,0.6666666666666666,2952,12168,44280,32112
6278,0.0,1.0,0.6666666666666666,2952,12172,44280,32108
6288,1.0,1.0,0.6666666666666666,2953,12176,44295,32119
6388,0.0,1.0,0.6666666666666666,2953,12180,44295,32115
6412,0.0,1.0,0.6666666666666666,2953,12184,44295,32111
6437,0.0,1.0,0.6666666666666666,2953,12188,44295,32107
6448,1.0,1.0,0.6666666666666666,2954,12192,44310,32118
6459,0.0,1.0,0.6666666666666666,2954,12196,44310,32114
6461,1.0,1.0,0.6666666666666666,2955,12200,44325,32125
6503,1.0,1.0,0.6666666666666666,2956,12204,44340,32136
6554,1.0,1.0,0.6666666666666666,2957,12208,44355,32147
6621,1.0,1.0,0.6666666666666666,2958,12212,44370,32158
6640,0.0,1.0,0.6666666666666666,2958,12216,44370,32154
6697,0.0,1.0,0.6666666666666666,2958,12220,44370,32150
6752,1.0,1.0,0.6666666666666666,2959,12224,44385,32161
6837,1.0,1.0,0.6666666666666666,2960,12228,44400,32172
6863,1.0,1.0,0.6666666666666666,2961,12232,44415,32183
6931,0.0,1.0,0.6666666666666666,2961,12236,44415,32179
6947,1.0,1.0,0.6666666666666666,2962,12240,44430,32190
6974,0.0,1.0,0.6666666666666666,2962,12244,44430,32186
6983,1.0,1.0,0.6666666666666666,2963,12248,44445,32197
7066,1.0,1.0,0.6666666666666666,2964,12252,44460,32208
7092,0.0,1.0,0.6666666666666666,2964,12256,44460,32204
7104,0.0,1.0,0.6666666666666666,2964,12260,44460,32200
7161,1.0,1.0,0.6666666666666666,2965,12264,44475,32211
7225,1.0,1.0,0.6666666666666666,2966,12268,44490,32222
7274,1.0,1.0,0.6666666666666666,2967,12272,44505,32233
7294,1.0,1.0,0.6666666666666666,2968,12276,44520,32244
7298,1.0,1.0,0.6666666666666666,2969,12280,44535,32255
7307,0.0,1.0,0.6666666666666666,2969,12284,44535,32251
7355,1.0,1.0,0.6666666666666666,2970,12288,44550,32262
7387,1.0,1.0,0.6666666666666666,2971,12292,44565,32273
7388,1.0,1.0,0.6666666666666666,2972,12296,44580,32284
7427,1.0,1.0,0.6666666666666666,2973,12300,44595,32295
7461,1.0,1.0,0.6666666666666666,2974,12304,44610,32306
7475,1.0,1.0,0.6666666666666666,2975,12308,44625,32317
7519,0.0,1.0,0.6666666666666666,2975,12312,44625,32313
7537,0.0,1.0,0.6666666666666666,2975,12316,44625,32309
7628,1.0,1.0,0.6666666666666666,2976,12320,44640,32320
7632,1.0,1.0,0.6666666666666666,2977,12324,44655,32331
7654,1.0,1.0,0.6666666666666666,2978,12328,44670,32342
7666,1.0,1.0,0.6666666666666666,2979,12332,44685,32353
7771,0.0,1.0,0.6666666666666666,2979,12336,44685,32349
7817,0.0,1.0,0.6666666666666666,2979,12340,44685,32345
7871,1.0,1.0,0.6666666666666666,2980,12344,44700,32356
8038,1.0,1.0,0.6666666666666666,2981,12348,44715,32367
8051,1.0,1.0,0.6666666666666666,2982,12352,44730,32378
8236,0.0,1.0,0.6666666666666666,2982,12356,44730,32374
8274,1.0,1.0,0.6666666666666666,2983,12360,44745,32385
8286,1.0,1.0,0.6666666666666666,2984,12364,44760,32396
8338,1.0,1.0,0.6666666666666666,2985,12368,44775,32407
8343,0.0,1.0,0.6666666666666666,2985,12372,44775,32403
8487,0.0,1.0,0.6666666666666666,2985,12376,44775,32399
8558,1.0,1.0,0.6666666666666666,2986,12380,44790,32410
8566,1.0,1.0,0.6666666666666666,2987,12384,44805,32421
8707,1.0,1.0,0.6666666666666666,2988,12388,44820,32432
8767,0.0,1.0,0.6666666666666666,2988,12392,44820,32428
8847,0.0,1.0,0.6666666666666666,2988,12396,44820,32424
8931,0.0,1.0,0.6666666666666666,2988,12400,44820,32420
8959,1.0,1.0,0.6666666666666666,2989,12404,44835,32431
8977,1.0,1.0,0.6666666666666666,2990,12408,44850,32442
9011,1.0,1.0,0.6666666666666666,2991,12412,44865,32453
9070,1.0,1.0,0.6666666666666666,2992,12416,44880,32464
9109,1.0,1.0,0.6666666666666666,2993,12420,44895,32475
9214,0.0,1.0,0.6666666666666666,2993,12424,44895,32471
9286,0.0,1.0,0.6666666666666666,2993,12428,44895,32467
9294,1.0,1.0,0.6666666666666666,2994,12432,44910,32478
9339,1.0,1.0,0.6666666666666666,2995,12436,44925,32489
9441,1.0,1.0,0.6666666666666666,2996,12440,44940,32500
9465,1.0,1.0,0.6666666666666666,2997,12444,44955,32511
9552,1.0,1.0,0.6666666666666666,2998,12448,44970,32522
9580,0.0,1.0,0.6666666666666666,2998,12452,44970,32518
9667,1.0,1.0,0.6666666666666666,2999,12456,44985,32529
9787,0.0,1.0,0.6666666666666666,2999,12460,44985,32525
9855,0.0,1.0,0.6666666666666666,2999,12464,44985,32521
9888,1.0,1.0,0.6666666666666666,3000,12468,45000,32532
9926,1.0,1.0,0.6666666666666666,3001,12472,45015,32543
9968,0.0,1.0,0.6666666666666666,3001,12476,45015,32539
9995,0.0,1.0,0.6666666666666666,3001,12480,45015,32535
10018,1.0,1.0,0.6666666666666666,3002,12484,45030,32546
10049,1.0,1.0,0.6666666666666666,3003,12488,45045,32557
10139,1.0,1.0,0.6666666666666666,3004,12492,45060,32568
10188,1.0,1.0,0.6666666666666666,3005,12496,45075,32579
10277,1.0,1.0,0.6666666666666666,3006,12500,45090,32590
10278,0.0,1.0,0.6666666666666666,3006,12504,45090,32586
10306,1.0,1.0,0.6666666666666666,3007,12508,45105,32597
10368,1.0,1.0,0.6666666666666666,3008,12512,45120,32608
10370,0.0,1.0,0.6666666666666666,3008,12516,45120,32604
10423,1.0,1.0,0.6666666666666666,3009,12520,45135,32615
10572,0.0,1.0,0.6666666666666666,3009,12524,45135,32611
10576,1.0,1.0,0.6666666666666666,3010,12528,45150,32622
10582,1.0,1.0,0.6666666666666666,3011,12532,45165,32633
10593,0.0,1.0,0.6666666666666666,3011,12536,45165,32629
10641,0.0,1.0,0.6666666666666666,3011,12540,45165,32625
10647,1.0,1.0,0.6666666666666666,3012,12544,45180,32636
10661,0.0,1.0,0.6666666666666666,3012,12548,45180,32632
10662,1.0,1.0,0.6666666666666666,3013,12552,45195,32643
10682,1.0,1.0,0.6666666666666666,3014,12556,45210,32654
10705,1.0,1.0,0.6666666666666666,3015,12560,45225,32665
10754,0.0,1.0,0.6666666666666666,3015,12564,45225,32661
10845,1.0,1.0,0.6666666666666666,3016,12568,45240,32672
10971,1.0,1.0,0.6666666666666666,3017,12572,45255,32683
11061,1.0,1.0,0.6666666666666666,3018,12576,45270,32694
11153,1.0,1.0,0.6666666666666666,3019,12580,45285,32705
11177,0.0,1.0,0.6666666666666666,3019,12584,45285,32701
11188,1.0,1.0,0.6666666666666666,3020,12588,45300,32712
11278,1.0,1.0,0.6666666666666666,3021,12592,45315,32723
11503,0.0,1.0,0.6666666666666666,3021,12596,45315,32719
11659,1.0,1.0,0.6666666666666666,3022,12600,45330,32730
11671,1.0,1.0,0.6666666666666666,3023,12604,45345,32741
11723,1.0,1.0,0.6666666666666666,3024,12608,45360,32752
11751,1.0,1.0,0.6666666666666666,3025,12612,45375,32763
11778,1.0,1.0,0.6666666666666666,3026,12616,45390,32774
11855,0.0,1.0,0.6666666666666666,3026,12620,45390,32770
11916,1.0,1.0,0.6666666666666666,3027,12624,45405,32781
11992,0.0,1.0,0.6666666666666666,3027,12628,45405,32777
12008,0.0,1.0,0.6666666666666666,3027,12632,45405,32773
12085,0.0,1.0,0.6666666666666666,3027,12636,45405,32769
12167,0.0,1.0,0.6666666666666666,3027,12640,45405,32765
12243,1.0,1.0,0.6666666666666666,3028,12644,45420,32776
12268,1.0,1.0,0.6666666666666666,3029,12648,45435,32787
12333,1.0,1.0,0.6666666666666666,3030,12652,45450,32798
12365,1.0,1.0,0.6666666666666666,3031,12656,45465,32809
12367,1.0,1.0,0.6666666666666666,3032,12660,45480,32820
12484,1.0,1.0,0.6666666666666666,3033,12664,45495,32831
12522,1.0,1.0,0.6666666666666666,3034,12668,45510,32842
12536,1.0,1.0,0.6666666666666666,3035,12672,45525,32853
12537,0.0,1.0,0.6666666666666666,3035,12676,45525,32849
12593,0.0,1.0,0.6666666666666666,3035,12680,45525,32845
12650,1.0,1.0,0.6666666666666666,3036,12684,45540,32856
12657,1.0,1.0,0.6666666666666666,3037,12688,45555,32867
12706,1.0,1.0,0.6666666666666666,3038,12692,45570,32878
12720,1.0,1.0,0.6666666666666666,3039,12696,45585,32889
12762,1.0,1.0,0.6666666666666666,3040,12700,45600,32900
12793,0.0,1.0,0.6666666666666666,3040,12704,45600,32896
12820,1.0,1.0,0.6666666666666666,3041,12708,45615,32907
12824,0.0,1.0,0.6666666666666666,3041,12712,45615,32903
12840,1.0,1.0,0.6666666666666666,3042,12716,45630,32914
12856,1.0,1.0,0.6666666666666666,3043,12720,45645,32925
12857,1.0,1.0,0.6666666666666666,3044,12724,45660,32936
12907,0.0,1.0,0.6666666666666666,3044,12728,45660,32932
12915,1.0,1.0,0.6666666666666666,3045,12732,45675,32943
12924,1.0,1.0,0.6666666666666666,3046,12736,45690,32954
12974,0.0,1.0,0.6666666666666666,3046,12740,45690,32950
12979,1.0,1.0,0.6666666666666666,3047,12744,45705,32961
12996,1.0,1.0,0.6666666666666666,3048,12748,45720,32972
13027,1.0,1.0,0.6666666666666666,3049,12752,45735,32983
13123,1.0,1.0,0.6666666666666666,3050,12756,45750,32994
13155,1.0,1.0,0.6666666666666666,3051,12760,45765,33005
13184,1.0,1.0,0.6666666666666666,3052,12764,45780,33016
13230,0.0,1.0,0.6666666666666666,3052,12768,45780,33012
13235,0.0,1.0,0.6666666666666666,3052,12772,45780,33008
13244,0.0,1.0,0.6666666666666666,3052,12776,45780,33004
13252,1.0,1.0,0.6666666666666666,3053,12780,45795,33015
13290,1.0,1.0,0.6666666666666666,3054,12784,45810,33026
13364,1.0,1.0,0.6666666666666666,3055,12788,45825,33037
13368,1.0,1.0,0.6666666666666666,3056,12792,45840,33048
13501,0.0,1.0,0.6666666666666666,3056,12796,45840,33044
13549,0.0,1.0,0.6666666666666666,3056,12800,45840,33040
13606,0.0,1.0,0.6666666666666666,3056,12804,45840,33036
13619,1.0,1.0,0.6666666666666666,3057,12808,45855,33047
13681,1.0,1.0,0.6666666666666666,3058,12812,45870,33058
13751,1.0,1.0,0.6666666666666666,3059,12816,45885,33069
13894,1.0,1.0,0.6666666666666666,3060,12820,45900,33080
13915,1.0,1.0,0.6666666666666666,3061,12824,45915,33091
13930,1.0,1.0,0.6666666666666666,3062,12828,45930,33102
14009,0.0,1.0,0.6666666666666666,3062,12832,45930,33098
14100,0.0,1.0,0.6666666666666666,3062,12836,45930,33094
14102,0.0,1.0,0.6666666666666666,3062,12840,45930,33090
14131,1.0,1.0,0.6666666666666666,3063,12844,45945,33101
14172,0.0,1.0,0.6666666666666666,3063,12848,45945,33097
14216,1.0,1.0,0.6666666666666666,3064,12852,45960,33108
14272,0.0,1.0,0.6666666666666666,3064,12856,45960,33104
14326,1.0,1.0,0.6666666666666666,3065,12860,45975,33115
14363,1.0,1.0,0.6666666666666666,3066,12864,45990,33126
14382,1.0,1.0,0.6666666666666666,3067,12868,46005,33137
14396,1.0,1.0,0.6666666666666666,3068,12872,46020,33148
14417,1.0,1.0,0.6666666666666666,3069,12876,46035,33159
14588,1.0,1.0,0.6666666666666666,3070,12880,46050,33170
14611,0.0,1.0,0.6666666666666666,3070,12884,46050,33166
14649,1.0,1.0,0.6666666666666666,3071,12888,46065,33177
14809,1.0,1.0,0.6666666666666666,3072,12892,46080,33188
14928,1.0,1.0,0.6666666666666666,3073,12896,46095,33199
14976,0.0,1.0,0.6666666666666666,3073,12900,46095,33195
14977,1.0,1.0,0.6666666666666666,3074,12904,46110,33206
15022,0.0,1.0,0.6666666666666666,3074,12908,46110,33202
15051,0.0,1.0,0.6666666666666666,3074,12912,46110,33198
15138,1.0,1.0,0.6666666666666666,3075,12916,46125,33209
15148,0.0,1.0,0.6666666666666666,3075,12920,46125,33205
15190,1.0,1.0,0.6666666666666666,3076,12924,46140,33216
15303,1.0,1.0,0.6666666666666666,3077,12928,46155,33227
15308,1.0,1.0,0.6666666666666666,3078,12932,46170,33238
15341,1.0,1.0,0.6666666666666666,3079,12936,46185,33249
15404,1.0,1.0,0.6666666666666666,3080,12940,46200,33260
15426,1.0,1.0,0.6666666666666666,3081,12944,46215,33271
15547,0.0,1.0,0.6666666666666666,3081,12948,46215,33267
15596,1.0,1.0,0.6666666666666666,3082,12952,46230,33278
15631,1.0,1.0,0.6666666666666666,3083,12956,46245,33289
15640,1.0,1.0,0.6666666666666666,3084,12960,46260,33300
15690,1.0,1.0,0.6666666666666666,3085,12964,46275,33311
15712,0.0,1.0,0.6666666666666666,3085,12968,46275,33307
15720,1.0,1.0,0.6666666666666666,3086,12972,46290,33318
15757,0.0,1.0,0.6666666666666666,3086,12976,46290,33314
15771,1.0,1.0,0.6666666666666666,3087,12980,46305,33325
15818,0.0,1.0,0.6666666666666666,3087,12984,46305,33321
15899,1.0,1.0,0.6666666666666666,3088,12988,46320,33332
15947,0.0,1.0,0.6666666666666666,3088,12992,46320,33328
15967,1.0,1.0,0.6666666666666666,3089,12996,46335,33339
15984,0.0,1.0,0.6666666666666666,3089,13000,46335,33335
16012,0.0,1.0,0.6666666666666666,3089,13004,46335,33331
16061,1.0,1.0,0.6666666666666666,3090,13008,46350,33342
16068,0.0,1.0,0.6666666666666666,3090,13012,46350,33338
16105,1.0,1.0,0.6666666666666666,3091,13016,46365,33349
16118,1.0,1.0,0.6666666666666666,3092,13020,46380,33360
16162,1.0,1.0,0.6666666666666666,3093,13024,46395,33371
16217,1.0,1.0,0.6666666666666666,3094,13028,46410,33382
16258,0.0,1.0,0.6666666666666666,3094,13032,46410,33378
16360,1.0,1.0,0.6666666666666666,3095,13036,46425,33389
16374,1.0,1.0,0.6666666666666666,3096,13040,46440,33400
16420,0.0,1.0,0.6666666666666666,3096,13044,46440,33396
16448,1.0,1.0,0.6666666666666666,3097,13048,46455,33407
16466,1.0,1.0,0.6666666666666666,3098,13052,46470,33418
16473,0.0,1.0,0.6666666666666666,3098,13056,46470,33414
16562,1.0,1.0,0.6666666666666666,3099,13060,46485,33425
16677,1.0,1.0,0.6666666666666666,3100,13064,46500,33436
16709,1.0,1.0,0.6666666666666666,3101,13068,46515,33447
16753,1.0,1.0,0.6666666666666666,3102,13072,46530,33458
16761,1.0,1.0,0.6666666666666666,3103,13076,46545,33469
16794,1.0,1.0,0.6666666666666666,3104,13080,46560,33480
16851,0.0,1.0,0.6666666666666666,3104,13084,46560,33476
16944,0.0,1.0,0.6666666666666666,3104,13088,46560,33472
17015,0.0,1.0,0.6666666666666666,3104,13092,46560,33468
17052,1.0,1.0,0.6666666666666666,3105,13096,46575,33479
17087,1.0,1.0,0.6666666666666666,3106,13100,46590,33490
17157,1.0,1.0,0.6666666666666666,3107,13104,46605,33501
17275,0.0,1.0,0.6666666666666666,3107,13108,46605,33497
17285,1.0,1.0,0.6666666666666666,3108,13112,46620,33508
17303,1.0,1.0,0.6666666666666666,3109,13116,46635,33519
17319,1.0,1.0,0.6666666666666666,3110,13120,46650,33530
17445,1.0,1.0,0.6666666666666666,3111,13124,46665,33541
17452,1.0,1.0,0.6666666666666666,3112,13128,46680,33552
17498,1.0,1.0,0.6666666666666666,3113,13132,46695,33563
17542,0.0,1.0,0.6666666666666666,3113,13136,46695,33559
17555,1.0,1.0,0.6666666666666666,3114,13140,46710,33570
17579,0.0,1.0,0.6666666666666666,3114,13144,46710,33566
17585,0.0,1.0,0.6666666666666666,3114,13148,46710,33562
17646,1.0,1.0,0.6666666666666666,3115,13152,46725,33573
17672,0.0,1.0,0.6666666666666666,3115,13156,46725,33569
17675,1.0,1.0,0.6666666666666666,3116,13160,46740,33580
17698,0.0,1.0,0.6666666666666666,3116,13164,46740,33576
17760,1.0,1.0,0.6666666666666666,3117,13168,46755,33587
17766,0.0,1.0,0.6666666666666666,3117,13172,46755,33583
17917,0.0,1.0,0.6666666666666666,3117,13176,46755,33579
18012,0.0,1.0,0.6666666666666666,3117,13180,46755,33575
18212,1.0,1.0,0.6666666666666666,3118,13184,46770,33586
18256,1.0,1.0,0.6666666666666666,3119,13188,46785,33597
18281,1.0,1.0,0.6666666666666666,3120,13192,46800,33608
18376,1.0,1.0,0.6666666666666666,3121,13196,46815,33619
18481,1.0,1.0,0.6666666666666666,3122,13200,46830,33630
18482,1.0,1.0,0.6666666666666666,3123,13204,46845,33641
18624,0.0,1.0,0.6666666666666666,3123,13208,46845,33637
18723,0.0,1.0,0.6666666666666666,3123,13212,46845,33633
18742,0.0,1.0,0.6666666666666666,3123,13216,46845,33629
18754,0.0,1.0,0.6666666666666666,3123,13220,46845,33625
18763,1.0,1.0,0.6666666666666666,3124,13224,46860,33636
18885,1.0,1.0,0.6666666666666666,3125,13228,46875,33647
18972,1.0,1.0,0.6666666666666666,3126,13232,46890,33658
18976,1.0,1.0,0.6666666666666666,3127,13236,46905,33669
18999,1.0,1.0,0.6666666666666666,3128,13240,46920,33680
19017,0.0,1.0,0.6666666666666666,3128,13244,46920,33676
19055,1.0,1.0,0.6666666666666666,3129,13248,46935,33687
19088,1.0,1.0,0.6666666666666666,3130,13252,46950,33698
19261,1.0,1.0,0.6666666666666666,3131,13256,46965,33709
19383,1.0,1.0,0.6666666666666666,3132,13260,46980,33720
19392,1.0,1.0,0.6666666666666666,3133,13264,46995,33731
19481,0.0,1.0,0.6666666666666666,3133,13268,46995,33727
19526,1.0,1.0,0.6666666666666666,3134,13272,47010,33738
19561,1.0,1.0,0.6666666666666666,3135,13276,47025,33749
19595,0.0,1.0,0.6666666666666666,3135,13280,47025,33745
19633,0.0,1.0,0.6666666666666666,3135,13284,47025,33741
19806,0.0,1.0,0.6666666666666666,3135,13288,47025,33737
19942,0.0,1.0,0.6666666666666666,3135,13292,47025,33733
19968,1.0,1.0,0.6666666666666666,3136,13296,47040,33744
20052,0.0,1.0,0.6666666666666666,3136,13300,47040,33740
20062,1.0,1.0,0.6666666666666666,3137,13304,47055,33751
20138,1.0,1.0,0.6666666666666666,3138,13308,47070,33762
20274,1.0,1.0,0.6666666666666666,3139,13312,47085,33773
20279,1.0,1.0,0.6666666666666666,3140,13316,47100,33784
20350,1.0,1.0,0.6666666666666666,3141,13320,47115,33795
20431,1.0,1.0,0.6666666666666666,3142,13324,47130,33806
20482,1.0,1.0,0.6666666666666666,3143,13328,47145,33817
20548,0.0,1.0,0.6666666666666666,3143,13332,47145,33813
20587,1.0,1.0,0.6666666666666666,3144,13336,47160,33824
20605,1.0,1.0,0.6666666666666666,3145,13340,47175,33835
20638,0.0,1.0,0.6666666666666666,3145,13344,47175,33831
20650,1.0,1.0,0.6666666666666666,3146,13348,47190,33842
20738,1.0,1.0,0.6666666666666666,3147,13352,47205,33853
20823,1.0,1.0,0.6666666666666666,3148,13356,47220,33864
20895,1.0,1.0,0.6666666666666666,3149,13360,47235,33875
21085,1.0,1.0,0.6666666666666666,3150,13364,47250,33886
21087,1.0,1.0,0.6666666666666666,3151,13368,47265,33897
21110,1.0,1.0,0.6666666666666666,3152,13372,47280,33908
21140,1.0,1.0,0.6666666666666666,3153,13376,47295,33919
21155,1.0,1.0,0.6666666666666666,3154,13380,47310,33930
21335,1.0,1.0,0.6666666666666666,3155,13384,47325,33941
21337,1.0,1.0,0.6666666666666666,3156,13388,47340,33952
21400,0.0,1.0,0.6666666666666666,3156,13392,47340,33948
21525,0.0,1.0,0.6666666666666666,3156,13396,47340,33944
21614,1.0,1.0,0.6666666666666666,3157,13400,47355,33955
21631,1.0,1.0,0.6666666666666666,3158,13404,47370,33966
21642,1.0,1.0,0.6666666666666666,3159,13408,47385,33977
21691,1.0,1.0,0.6666666666666666,3160,13412,47400,33988
21716,0.0,1.0,0.6666666666666666,3160,13416,47400,33984
160,0.0,1.0,0.6,3160,13420,47400,33980
171,1.0,1.0,0.6,3161,13424,47415,33991
408,1.0,1.0,0.6,3162,13428,47430,34002
727,1.0,1.0,0.6,3163,13432,47445,34013
923,0.0,1.0,0.6,3163,13436,47445,34009
1262,0.0,1.0,0.6,3163,13440,47445,34005
1366,0.0,1.0,0.6,3163,13444,47445,34001
1447,0.0,1.0,0.6,3163,13448,47445,33997
1791,1.0,1.0,0.6,3164,13452,47460,34008
1926,0.0,1.0,0.6,3164,13456,47460,34004
1932,1.0,1.0,0.6,3165,13460,47475,34015
2222,0.0,1.0,0.6,3165,13464,47475,34011
2281,1.0,1.0,0.6,3166,13468,47490,34022
2485,1.0,1.0,0.6,3167,13472,47505,34033
2718,1.0,1.0,0.6,3168,13476,47520,34044
2721,1.0,1.0,0.6,3169,13480,47535,34055
2800,1.0,1.0,0.6,3170,13484,47550,34066
2829,0.0,1.0,0.6,3170,13488,47550,34062
2968,0.0,1.0,0.6,3170,13492,47550,34058
3231,1.0,1.0,0.6,3171,13496,47565,34069
3383,0.0,1.0,0.6,3171,13500,47565,34065
3487,1.0,1.0,0.6,3172,13504,47580,34076
3566,0.0,1.0,0.6,3172,13508,47580,34072
3618,0.0,1.0,0.6,3172,13512,47580,34068
3727,1.0,1.0,0.6,3173,13516,47595,34079
4655,0.0,1.0,0.6,3173,13520,47595,34075
4803,0.0,1.0,0.6,3173,13524,47595,34071
4884,0.0,1.0,0.6,3173,13528,47595,34067
5219,1.0,1.0,0.6,3174,13532,47610,34078
5875,1.0,1.0,0.6,3175,13536,47625,34089
6309,1.0,1.0,0.6,3176,13540,47640,34100
6351,0.0,1.0,0.6,3176,13544,47640,34096
6424,1.0,1.0,0.6,3177,13548,47655,34107
6597,1.0,1.0,0.6,3178,13552,47670,34118
6736,0.0,1.0,0.6,3178,13556,47670,34114
6820,1.0,1.0,0.6,3179,13560,47685,34125
7230,1.0,1.0,0.6,3180,13564,47700,34136
7300,1.0,1.0,0.6,3181,13568,47715,34147
7394,0.0,1.0,0.6,3181,13572,47715,34143
7411,1.0,1.0,0.6,3182,13576,47730,34154
7510,1.0,1.0,0.6,3183,13580,47745,34165
7591,0.0,1.0,0.6,3183,13584,47745,34161
7671,0.0,1.0,0.6,3183,13588,47745,34157
7697,0.0,1.0,0.6,3183,13592,47745,34153
7796,1.0,1.0,0.6,3184,13596,47760,34164
7802,0.0,1.0,0.6,3184,13600,47760,34160
7934,0.0,1.0,0.6,3184,13604,47760,34156
8165,1.0,1.0,0.6,3185,13608,47775,34167
8176,0.0,1.0,0.6,3185,13612,47775,34163
8248,1.0,1.0,0.6,3186,13616,47790,34174
8399,1.0,1.0,0.6,3187,13620,47805,34185
8555,1.0,1.0,0.6,3188,13624,47820,34196
8710,1.0,1.0,0.6,3189,13628,47835,34207
8736,1.0,1.0,0.6,3190,13632,47850,34218
8895,1.0,1.0,0.6,3191,13636,47865,34229
9035,0.0,1.0,0.6,3191,13640,47865,34225
9136,1.0,1.0,0.6,3192,13644,47880,34236
9291,0.0,1.0,0.6,3192,13648,47880,34232
9378,1.0,1.0,0.6,3193,13652,47895,34243
9560,0.0,1.0,0.6,3193,13656,47895,34239
9626,0.0,1.0,0.6,3193,13660,47895,34235
9917,1.0,1.0,0.6,3194,13664,47910,34246
9929,1.0,1.0,0.6,3195,13668,47925,34257
10125,0.0,1.0,0.6,3195,13672,47925,34253
10644,0.0,1.0,0.6,3195,13676,47925,34249
11245,1.0,1.0,0.6,3196,13680,47940,34260
11387,1.0,1.0,0.6,3197,13684,47955,34271
11397,1.0,1.0,0.6,3198,13688,47970,34282
11462,0.0,1.0,0.6,3198,13692,47970,34278
11470,1.0,1.0,0.6,3199,13696,47985,34289
11494,1.0,1.0,0.6,3200,13700,48000,34300
11547,0.0,1.0,0.6,3200,13704,48000,34296
11785,1.0,1.0,0.6,3201,13708,48015,34307
11853,1.0,1.0,0.6,3202,13712,48030,34318
12105,0.0,1.0,0.6,3202,13716,48030,34314
12135,0.0,1.0,0.6,3202,13720,48030,34310
12495,1.0,1.0,0.6,3203,13724,48045,34321
12499,0.0,1.0,0.6,3203,13728,48045,34317
12808,0.0,1.0,0.6,3203,13732,48045,34313
12965,1.0,1.0,0.6,3204,13736,48060,34324
12973,1.0,1.0,0.6,3205,13740,48075,34335
13051,1.0,1.0,0.6,3206,13744,48090,34346
13105,1.0,1.0,0.6,3207,13748,48105,34357
13397,0.0,1.0,0.6,3207,13752,48105,34353
13464,0.0,1.0,0.6,3207,13756,48105,34349
13591,1.0,1.0,0.6,3208,13760,48120,34360
13976,1.0,1.0,0.6,3209,13764,48135,34371
14238,1.0,1.0,0.6,3210,13768,48150,34382
14546,1.0,1.0,0.6,3211,13772,48165,34393
14652,1.0,1.0,0.6,3212,13776,48180,34404
14764,0.0,1.0,0.6,3212,13780,48180,34400
14780,0.0,1.0,0.6,3212,13784,48180,34396
14895,1.0,1.0,0.6,3213,13788,48195,34407
14922,0.0,1.0,0.6,3213,13792,48195,34403
15499,1.0,1.0,0.6,3214,13796,48210,34414
15557,1.0,1.0,0.6,3215,13800,48225,34425
15663,0.0,1.0,0.6,3215,13804,48225,34421
15714,1.0,1.0,0.6,3216,13808,48240,34432
15855,0.0,1.0,0.6,3216,13812,48240,34428
16301,1.0,1.0,0.6,3217,13816,48255,34439
16446,1.0,1.0,0.6,3218,13820,48270,34450
16706,1.0,1.0,0.6,3219,13824,48285,34461
16816,1.0,1.0,0.6,3220,13828,48300,34472
17150,0.0,1.0,0.6,3220,13832,48300,34468
17198,0.0,1.0,0.6,3220,13836,48300,34464
17546,1.0,1.0,0.6,3221,13840,48315,34475
17592,1.0,1.0,0.6,3222,13844,48330,34486
18023,0.0,1.0,0.6,3222,13848,48330,34482
18497,1.0,1.0,0.6,3223,13852,48345,34493
18933,1.0,1.0,0.6,3224,13856,48360,34504
19113,1.0,1.0,0.6,3225,13860,48375,34515
19186,1.0,1.0,0.6,3226,13864,48390,34526
19285,0.0,1.0,0.6,3226,13868,48390,34522
19535,1.0,1.0,0.6,3227,13872,48405,34533
19696,1.0,1.0,0.6,3228,13876,48420,34544
19899,0.0,1.0,0.6,3228,13880,48420,34540
20044,1.0,1.0,0.6,3229,13884,48435,34551
20057,1.0,1.0,0.6,3230,13888,48450,34562
20266,1.0,1.0,0.6,3231,13892,48465,34573
20301,0.0,1.0,0.6,3231,13896,48465,34569
20398,1.0,1.0,0.6,3232,13900,48480,34580
20572,1.0,1.0,0.6,3233,13904,48495,34591
20711,0.0,1.0,0.6,3233,13908,48495,34587
21033,1.0,1.0,0.6,3234,13912,48510,34598
21481,1.0,1.0,0.6,3235,13916,48525,34609
11,1.0,0.0,0.5,3236,13920,48540,34620
46,1.0,0.0,0.5,3237,13924,48555,34631
74,0.0,0.0,0.5,3237,13928,48555,34627
111,1.0,0.0,0.5,3238,13932,48570,34638
185,0.0,0.0,0.5,3238,13936,48570,34634
241,1.0,0.0,0.5,3239,13940,48585,34645
425,1.0,0.0,0.5,3240,13944,48600,34656
594,0.0,0.0,0.5,3240,13948,48600,34652
753,0.0,0.0,0.5,3240,13952,48600,34648
811,1.0,0.0,0.5,3241,13956,48615,34659
973,0.0,0.0,0.5,3241,13960,48615,34655
981,0.0,0.0,0.5,3241,13964,48615,34651
1101,1.0,0.0,0.5,3242,13968,48630,34662
1158,0.0,0.0,0.5,3242,13972,48630,34658
1214,0.0,0.0,0.5,3242,13976,48630,34654
1259,1.0,0.0,0.5,3243,13980,48645,34665
1307,1.0,0.0,0.5,3244,13984,48660,34676
1327,0.0,0.0,0.5,3244,13988,48660,34672
1330,1.0,0.0,0.5,3245,13992,48675,34683
1469,1.0,0.0,0.5,3246,13996,48690,34694
1656,1.0,0.0,0.5,3247,14000,48705,34705
1674,0.0,0.0,0.5,3247,14004,48705,34701
1704,0.0,0.0,0.5,3247,14008,48705,34697
1738,1.0,0.0,0.5,3248,14012,48720,34708
1768,1.0,0.0,0.5,3249,14016,48735,34719
1799,1.0,0.0,0.5,3250,14020,48750,34730
1880,0.0,0.0,0.5,3250,14024,48750,34726
1892,1.0,0.0,0.5,3251,14028,48765,34737
2069,0.0,0.0,0.5,3251,14032,48765,34733
2181,0.0,0.0,0.5,3251,14036,48765,34729
3518,1.0,0.0,0.5,3252,14040,48780,34740
3519,0.0,0.0,0.5,3252,14044,48780,34736
3592,0.0,0.0,0.5,3252,14048,48780,34732
3940,0.0,0.0,0.5,3252,14052,48780,34728
4308,1.0,0.0,0.5,3253,14056,48795,34739
4361,0.0,0.0,0.5,3253,14060,48795,34735
4438,0.0,0.0,0.5,3253,14064,48795,34731
4738,1.0,0.0,0.5,3254,14068,48810,34742
5052,1.0,0.0,0.5,3255,14072,48825,34753
5958,0.0,0.0,0.5,3255,14076,48825,34749
6312,0.0,0.0,0.5,3255,14080,48825,34745
6429,0.0,0.0,0.5,3255,14084,48825,34741
6485,0.0,0.0,0.5,3255,14088,48825,34737
6754,1.0,0.0,0.5,3256,14092,48840,34748
6991,0.0,0.0,0.5,3256,14096,48840,34744
7029,0.0,0.0,0.5,3256,14100,48840,34740
7196,1.0,0.0,0.5,3257,14104,48855,34751
7399,0.0,0.0,0.5,3257,14108,48855,34747
7511,1.0,0.0,0.5,3258,14112,48870,34758
7647,1.0,0.0,0.5,3259,14116,48885,34769
7673,0.0,0.0,0.5,3259,14120,48885,34765
7835,0.0,0.0,0.5,3259,14124,48885,34761
7966,1.0,0.0,0.5,3260,14128,48900,34772
8060,1.0,0.0,0.5,3261,14132,48915,34783
8182,0.0,0.0,0.5,3261,14136,48915,34779
8508,0.0,0.0,0.5,3261,14140,48915,34775
8572,1.0,0.0,0.5,3262,14144,48930,34786
8607,0.0,0.0,0.5,3262,14148,48930,34782
8626,0.0,0.0,0.5,3262,14152,48930,34778
8691,0.0,0.0,0.5,3262,14156,48930,34774
9001,1.0,0.0,0.5,3263,14160,48945,34785
9036,1.0,0.0,0.5,3264,14164,48960,34796
9376,0.0,0.0,0.5,3264,14168,48960,34792
9385,0.0,0.0,0.5,3264,14172,48960,34788
9395,1.0,0.0,0.5,3265,14176,48975,34799
9404,1.0,0.0,0.5,3266,14180,48990,34810
9415,0.0,0.0,0.5,3266,14184,48990,34806
9531,0.0,0.0,0.5,3266,14188,48990,34802
9736,0.0,0.0,0.5,3266,14192,48990,34798
9753,0.0,0.0,0.5,3266,14196,48990,34794
9884,1.0,0.0,0.5,3267,14200,49005,34805
9967,1.0,0.0,0.5,3268,14204,49020,34816
10078,1.0,0.0,0.5,3269,14208,49035,34827
10250,1.0,0.0,0.5,3270,14212,49050,34838
10463,0.0,0.0,0.5,3270,14216,49050,34834
10481,1.0,0.0,0.5,3271,14220,49065,34845
10721,1.0,0.0,0.5,3272,14224,49080,34856
11182,1.0,0.0,0.5,3273,14228,49095,34867
11220,0.0,0.0,0.5,3273,14232,49095,34863
11353,1.0,0.0,0.5,3274,14236,49110,34874
11360,1.0,0.0,0.5,3275,14240,49125,34885
11575,1.0,0.0,0.5,3276,14244,49140,34896
11774,0.0,0.0,0.5,3276,14248,49140,34892
11856,1.0,0.0,0.5,3277,14252,49155,34903
11911,1.0,0.0,0.5,3278,14256,49170,34914
11923,1.0,0.0,0.5,3279,14260,49185,34925
11972,1.0,0.0,0.5,3280,14264,49200,34936
12043,0.0,0.0,0.5,3280,14268,49200,34932
12089,0.0,0.0,0.5,3280,14272,49200,34928
12221,1.0,0.0,0.5,3281,14276,49215,34939
12248,1.0,0.0,0.5,3282,14280,49230,34950
12469,1.0,0.0,0.5,3283,14284,49245,34961
12587,0.0,0.0,0.5,3283,14288,49245,34957
13187,0.0,0.0,0.5,3283,14292,49245,34953
13362,0.0,0.0,0.5,3283,14296,49245,34949
13377,0.0,0.0,0.5,3283,14300,49245,34945
13442,0.0,0.0,0.5,3283,14304,49245,34941
13472,0.0,0.0,0.5,3283,14308,49245,34937
13650,1.0,0.0,0.5,3284,14312,49260,34948
13673,1.0,0.0,0.5,3285,14316,49275,34959
13786,0.0,0.0,0.5,3285,14320,49275,34955
13951,1.0,0.0,0.5,3286,14324,49290,34966
14391,1.0,0.0,0.5,3287,14328,49305,34977
14404,0.0,0.0,0.5,3287,14332,49305,34973
15223,0.0,0.0,0.5,3287,14336,49305,34969
15496,0.0,0.0,0.5,3287,14340,49305,34965
15642,1.0,0.0,0.5,3288,14344,49320,34976
15860,0.0,0.0,0.5,3288,14348,49320,34972
16063,1.0,0.0,0.5,3289,14352,49335,34983
16425,1.0,0.0,0.5,3290,14356,49350,34994
16510,0.0,0.0,0.5,3290,14360,49350,34990
16613,0.0,0.0,0.5,3290,14364,49350,34986
16617,0.0,0.0,0.5,3290,14368,49350,34982
16795,1.0,0.0,0.5,3291,14372,49365,34993
16814,1.0,0.0,0.5,3292,14376,49380,35004
16918,1.0,0.0,0.5,3293,14380,49395,35015
16988,0.0,0.0,0.5,3293,14384,49395,35011
17287,0.0,0.0,0.5,3293,14388,49395,35007
17386,1.0,0.0,0.5,3294,14392,49410,35018
17666,0.0,0.0,0.5,3294,14396,49410,35014
17866,1.0,0.0,0.5,3295,14400,49425,35025
18200,0.0,0.0,0.5,3295,14404,49425,35021
18538,1.0,0.0,0.5,3296,14408,49440,35032
18738,1.0,0.0,0.5,3297,14412,49455,35043
18854,0.0,0.0,0.5,3297,14416,49455,35039
18869,0.0,0.0,0.5,3297,14420,49455,35035
19181,1.0,0.0,0.5,3298,14424,49470,35046
19268,0.0,0.0,0.5,3298,14428,49470,35042
19325,1.0,0.0,0.5,3299,14432,49485,35053
19425,0.0,0.0,0.5,3299,14436,49485,35049
19570,0.0,0.0,0.5,3299,14440,49485,35045
19625,1.0,0.0,0.5,3300,14444,49500,35056
19692,0.0,0.0,0.5,3300,14448,49500,35052
19904,1.0,0.0,0.5,3301,14452,49515,35063
20020,0.0,0.0,0.5,3301,14456,49515,35059
20196,0.0,0.0,0.5,3301,14460,49515,35055
20256,1.0,0.0,0.5,3302,14464,49530,35066
20331,0.0,0.0,0.5,3302,14468,49530,35062
20355,0.0,0.0,0.5,3302,14472,49530,35058
20370,1.0,0.0,0.5,3303,14476,49545,35069
20401,1.0,0.0,0.5,3304,14480,49560,35080
20430,1.0,0.0,0.5,3305,14484,49575,35091
20462,1.0,0.0,0.5,3306,14488,49590,35102
20541,1.0,0.0,0.5,3307,14492,49605,35113
20868,0.0,0.0,0.5,3307,14496,49605,35109
20980,0.0,0.0,0.5,3307,14500,49605,35105
21196,0.0,0.0,0.5,3307,14504,49605,35101
21257,1.0,0.0,0.5,3308,14508,49620,35112
21297,1.0,0.0,0.5,3309,14512,49635,35123
21308,0.0,0.0,0.5,3309,14516,49635,35119
21326,1.0,0.0,0.5,3310,14520,49650,35130
21738,1.0,0.0,0.5,3311,14524,49665,35141
457,0.0,0.0,0.4,3311,14528,49665,35137
734,0.0,0.0,0.4,3311,14532,49665,35133
770,0.0,0.0,0.4,3311,14536,49665,35129
901,1.0,0.0,0.4,3312,14540,49680,35140
914,1.0,0.0,0.4,3313,14544,49695,35151
1014,0.0,0.0,0.4,3313,14548,49695,35147
1022,0.0,0.0,0.4,3313,14552,49695,35143
1583,1.0,0.0,0.4,3314,14556,49710,35154
1723,1.0,0.0,0.4,3315,14560,49725,35165
1829,0.0,0.0,0.4,3315,14564,49725,35161
1977,0.0,0.0,0.4,3315,14568,49725,35157
1998,0.0,0.0,0.4,3315,14572,49725,35153
2037,0.0,0.0,0.4,3315,14576,49725,35149
2073,1.0,0.0,0.4,3316,14580,49740,35160
2219,0.0,0.0,0.4,3316,14584,49740,35156
2251,0.0,0.0,0.4,3316,14588,49740,35152
2275,1.0,0.0,0.4,3317,14592,49755,35163
2354,1.0,0.0,0.4,3318,14596,49770,35174
2418,1.0,0.0,0.4,3319,14600,49785,35185
2547,1.0,0.0,0.4,3320,14604,49800,35196
2659,0.0,0.0,0.4,3320,14608,49800,35192
2740,0.0,0.0,0.4,3320,14612,49800,35188
3038,1.0,0.0,0.4,3321,14616,49815,35199
3099,0.0,0.0,0.4,3321,14620,49815,35195
3154,1.0,0.0,0.4,3322,14624,49830,35206
3201,0.0,0.0,0.4,3322,14628,49830,35202
3702,1.0,0.0,0.4,3323,14632,49845,35213
3755,1.0,0.0,0.4,3324,14636,49860,35224
3818,1.0,0.0,0.4,3325,14640,49875,35235
4003,1.0,0.0,0.4,3326,14644,49890,35246
4051,1.0,0.0,0.4,3327,14648,49905,35257
4430,1.0,0.0,0.4,3328,14652,49920,35268
4550,0.0,0.0,0.4,3328,14656,49920,35264
4700,0.0,0.0,0.4,3328,14660,49920,35260
4914,1.0,0.0,0.4,3329,14664,49935,35271
4969,0.0,0.0,0.4,3329,14668,49935,35267
5003,1.0,0.0,0.4,3330,14672,49950,35278
5072,0.0,0.0,0.4,3330,14676,49950,35274
5375,1.0,0.0,0.4,3331,14680,49965,35285
5482,0.0,0.0,0.4,3331,14684,49965,35281
5508,0.0,0.0,0.4,3331,14688,49965,35277
5738,0.0,0.0,0.4,3331,14692,49965,35273
6318,1.0,0.0,0.4,3332,14696,49980,35284
6547,1.0,0.0,0.4,3333,14700,49995,35295
6587,0.0,0.0,0.4,3333,14704,49995,35291
6702,0.0,0.0,0.4,3333,14708,49995,35287
7249,1.0,0.0,0.4,3334,14712,50010,35298
7305,1.0,0.0,0.4,3335,14716,50025,35309
7364,0.0,0.0,0.4,3335,14720,50025,35305
7413,0.0,0.0,0.4,3335,14724,50025,35301
7525,0.0,0.0,0.4,3335,14728,50025,35297
7694,0.0,0.0,0.4,3335,14732,50025,35293
7748,0.0,0.0,0.4,3335,14736,50025,35289
7749,0.0,0.0,0.4,3335,14740,50025,35285
7908,0.0,0.0,0.4,3335,14744,50025,35281
7982,1.0,0.0,0.4,3336,14748,50040,35292
8085,1.0,0.0,0.4,3337,14752,50055,35303
8177,1.0,0.0,0.4,3338,14756,50070,35314
8616,0.0,0.0,0.4,3338,14760,50070,35310
8720,0.0,0.0,0.4,3338,14764,50070,35306
8724,0.0,0.0,0.4,3338,14768,50070,35302
8894,0.0,0.0,0.4,3338,14772,50070,35298
9063,0.0,0.0,0.4,3338,14776,50070,35294
9142,0.0,0.0,0.4,3338,14780,50070,35290
9160,1.0,0.0,0.4,3339,14784,50085,35301
9223,0.0,0.0,0.4,3339,14788,50085,35297
9267,1.0,0.0,0.4,3340,14792,50100,35308
9327,1.0,0.0,0.4,3341,14796,50115,35319
9463,1.0,0.0,0.4,3342,14800,50130,35330
9479,1.0,0.0,0.4,3343,14804,50145,35341
9508,0.0,0.0,0.4,3343,14808,50145,35337
9606,0.0,0.0,0.4,3343,14812,50145,35333
9652,0.0,0.0,0.4,3343,14816,50145,35329
9708,0.0,0.0,0.4,3343,14820,50145,35325
9749,0.0,0.0,0.4,3343,14824,50145,35321
9840,0.0,0.0,0.4,3343,14828,50145,35317
10208,1.0,0.0,0.4,3344,14832,50160,35328
10227,0.0,0.0,0.4,3344,14836,50160,35324
10296,0.0,0.0,0.4,3344,14840,50160,35320
10491,0.0,0.0,0.4,3344,14844,50160,35316
10498,1.0,0.0,0.4,3345,14848,50175,35327
10649,0.0,0.0,0.4,3345,14852,50175,35323
10732,0.0,0.0,0.4,3345,14856,50175,35319
10820,1.0,0.0,0.4,3346,14860,50190,35330
10870,0.0,0.0,0.4,3346,14864,50190,35326
11080,0.0,0.0,0.4,3346,14868,50190,35322
11196,0.0,0.0,0.4,3346,14872,50190,35318
11449,0.0,0.0,0.4,3346,14876,50190,35314
12045,0.0,0.0,0.4,3346,14880,50190,35310
12298,1.0,0.0,0.4,3347,14884,50205,35321
12380,0.0,0.0,0.4,3347,14888,50205,35317
12450,1.0,0.0,0.4,3348,14892,50220,35328
13115,0.0,0.0,0.4,3348,14896,50220,35324
13429,1.0,0.0,0.4,3349,14900,50235,35335
13626,0.0,0.0,0.4,3349,14904,50235,35331
14104,1.0,0.0,0.4,3350,14908,50250,35342
14129,1.0,0.0,0.4,3351,14912,50265,35353
14132,0.0,0.0,0.4,3351,14916,50265,35349
14259,0.0,0.0,0.4,3351,14920,50265,35345
14515,0.0,0.0,0.4,3351,14924,50265,35341
14529,1.0,0.0,0.4,3352,14928,50280,35352
14586,1.0,0.0,0.4,3353,14932,50295,35363
14735,0.0,0.0,0.4,3353,14936,50295,35359
15050,1.0,0.0,0.4,3354,14940,50310,35370
15284,0.0,0.0,0.4,3354,14944,50310,35366
15420,0.0,0.0,0.4,3354,14948,50310,35362
15662,0.0,0.0,0.4,3354,14952,50310,35358
15697,0.0,0.0,0.4,3354,14956,50310,35354
15920,0.0,0.0,0.4,3354,14960,50310,35350
16223,0.0,0.0,0.4,3354,14964,50310,35346
16267,0.0,0.0,0.4,3354,14968,50310,35342
16308,0.0,0.0,0.4,3354,14972,50310,35338
16553,0.0,0.0,0.4,3354,14976,50310,35334
16663,0.0,0.0,0.4,3354,14980,50310,35330
16796,0.0,0.0,0.4,3354,14984,50310,35326
17032,0.0,0.0,0.4,3354,14988,50310,35322
17053,0.0,0.0,0.4,3354,14992,50310,35318
17109,0.0,0.0,0.4,3354,14996,50310,35314
17248,1.0,0.0,0.4,3355,15000,50325,35325
17332,0.0,0.0,0.4,3355,15004,50325,35321
17588,1.0,0.0,0.4,3356,15008,50340,35332
17640,1.0,0.0,0.4,3357,15012,50355,35343
17729,0.0,0.0,0.4,3357,15016,50355,35339
18010,1.0,0.0,0.4,3358,15020,50370,35350
18097,1.0,0.0,0.4,3359,15024,50385,35361
18475,1.0,0.0,0.4,3360,15028,50400,35372
18819,1.0,0.0,0.4,3361,15032,50415,35383
19106,1.0,0.0,0.4,3362,15036,50430,35394
19250,1.0,0.0,0.4,3363,15040,50445,35405
19260,0.0,0.0,0.4,3363,15044,50445,35401
19638,1.0,0.0,0.4,3364,15048,50460,35412
20480,1.0,0.0,0.4,3365,15052,50475,35423
20598,0.0,0.0,0.4,3365,15056,50475,35419
20699,1.0,0.0,0.4,3366,15060,50490,35430
20707,0.0,0.0,0.4,3366,15064,50490,35426
20729,0.0,0.0,0.4,3366,15068,50490,35422
20765,1.0,0.0,0.4,3367,15072,50505,35433
21606,0.0,0.0,0.4,3367,15076,50505,35429
21694,0.0,0.0,0.4,3367,15080,50505,35425
21724,0.0,0.0,0.4,3367,15084,50505,35421
24,0.0,0.0,0.3333333333333333,3367,15088,50505,35417
182,0.0,0.0,0.3333333333333333,3367,15092,50505,35413
190,1.0,0.0,0.3333333333333333,3368,15096,50520,35424
230,0.0,0.0,0.3333333333333333,3368,15100,50520,35420
434,1.0,0.0,0.3333333333333333,3369,15104,50535,35431
468,0.0,0.0,0.3333333333333333,3369,15108,50535,35427
499,0.0,0.0,0.3333333333333333,3369,15112,50535,35423
511,0.0,0.0,0.3333333333333333,3369,15116,50535,35419
538,1.0,0.0,0.3333333333333333,3370,15120,50550,35430
611,0.0,0.0,0.3333333333333333,3370,15124,50550,35426
631,0.0,0.0,0.3333333333333333,3370,15128,50550,35422
695,0.0,0.0,0.3333333333333333,3370,15132,50550,35418
742,0.0,0.0,0.3333333333333333,3370,15136,50550,35414
755,1.0,0.0,0.3333333333333333,3371,15140,50565,35425
765,0.0,0.0,0.3333333333333333,3371,15144,50565,35421
827,0.0,0.0,0.3333333333333333,3371,15148,50565,35417
889,0.0,0.0,0.3333333333333333,3371,15152,50565,35413
921,0.0,0.0,0.3333333333333333,3371,15156,50565,35409
938,0.0,0.0,0.3333333333333333,3371,15160,50565,35405
955,1.0,0.0,0.3333333333333333,3372,15164,50580,35416
958,1.0,0.0,0.3333333333333333,3373,15168,50595,35427
1028,1.0,0.0,0.3333333333333333,3374,15172,50610,35438
1045,0.0,0.0,0.3333333333333333,3374,15176,50610,35434
1121,1.0,0.0,0.3333333333333333,3375,15180,50625,35445
1139,0.0,0.0,0.3333333333333333,3375,15184,50625,35441
1221,0.0,0.0,0.3333333333333333,3375,15188,50625,35437
1261,0.0,0.0,0.3333333333333333,3375,15192,50625,35433
1271,0.0,0.0,0.3333333333333333,3375,15196,50625,35429
1289,0.0,0.0,0.3333333333333333,3375,15200,50625,35425
1336,0.0,0.0,0.3333333333333333,3375,15204,50625,35421
1349,1.0,0.0,0.3333333333333333,3376,15208,50640,35432
1396,1.0,0.0,0.3333333333333333,3377,15212,50655,35443
1483,0.0,0.0,0.3333333333333333,3377,15216,50655,35439
1489,1.0,0.0,0.3333333333333333,3378,15220,50670,35450
1537,0.0,0.0,0.3333333333333333,3378,15224,50670,35446
1601,0.0,0.0,0.3333333333333333,3378,15228,50670,35442
1624,0.0,0.0,0.3333333333333333,3378,15232,50670,35438
1625,0.0,0.0,0.3333333333333333,3378,15236,50670,35434
1637,0.0,0.0,0.3333333333333333,3378,15240,50670,35430
1649,1.0,0.0,0.3333333333333333,3379,15244,50685,35441
1680,0.0,0.0,0.3333333333333333,3379,15248,50685,35437
1763,1.0,0.0,0.3333333333333333,3380,15252,50700,35448
1802,0.0,0.0,0.3333333333333333,3380,15256,50700,35444
1835,1.0,0.0,0.3333333333333333,3381,15260,50715,35455
1848,0.0,0.0,0.3333333333333333,3381,15264,50715,35451
1849,0.0,0.0,0.3333333333333333,3381,15268,50715,35447
1866,1.0,0.0,0.3333333333333333,3382,15272,50730,35458
1914,0.0,0.0,0.3333333333333333,3382,15276,50730,35454
1944,0.0,0.0,0.3333333333333333,3382,15280,50730,35450
1953,1.0,0.0,0.3333333333333333,3383,15284,50745,35461
1973,0.0,0.0,0.3333333333333333,3383,15288,50745,35457
1989,0.0,0.0,0.3333333333333333,3383,15292,50745,35453
2102,0.0,0.0,0.3333333333333333,3383,15296,50745,35449
2116,1.0,0.0,0.3333333333333333,3384,15300,50760,35460
2152,0.0,0.0,0.3333333333333333,3384,15304,50760,35456
2167,1.0,0.0,0.3333333333333333,3385,15308,50775,35467
2176,0.0,0.0,0.3333333333333333,3385,15312,50775,35463
2178,0.0,0.0,0.3333333333333333,3385,15316,50775,35459
2188,0.0,0.0,0.3333333333333333,3385,15320,50775,35455
2197,0.0,0.0,0.3333333333333333,3385,15324,50775,35451
2235,1.0,0.0,0.3333333333333333,3386,15328,50790,35462
2311,0.0,0.0,0.3333333333333333,3386,15332,50790,35458
2423,0.0,0.0,0.3333333333333333,3386,15336,50790,35454
2524,0.0,0.0,0.3333333333333333,3386,15340,50790,35450
2525,0.0,0.0,0.3333333333333333,3386,15344,50790,35446
2537,1.0,0.0,0.3333333333333333,3387,15348,50805,35457
2551,0.0,0.0,0.3333333333333333,3387,15352,50805,35453
2584,0.0,0.0,0.3333333333333333,3387,15356,50805,35449
2611,1.0,0.0,0.3333333333333333,3388,15360,50820,35460
2629,1.0,0.0,0.3333333333333333,3389,15364,50835,35471
2702,0.0,0.0,0.3333333333333333,3389,15368,50835,35467
2712,1.0,0.0,0.3333333333333333,3390,15372,50850,35478
2722,0.0,0.0,0.3333333333333333,3390,15376,50850,35474
2746,0.0,0.0,0.3333333333333333,3390,15380,50850,35470
2753,0.0,0.0,0.3333333333333333,3390,15384,50850,35466
2857,0.0,0.0,0.3333333333333333,3390,15388,50850,35462
2926,0.0,0.0,0.3333333333333333,3390,15392,50850,35458
2946,0.0,0.0,0.3333333333333333,3390,15396,50850,35454
2987,0.0,0.0,0.3333333333333333,3390,15400,50850,35450
3007,0.0,0.0,0.3333333333333333,3390,15404,50850,35446
3027,0.0,0.0,0.3333333333333333,3390,15408,50850,35442
3031,0.0,0.0,0.3333333333333333,3390,15412,50850,35438
3080,0.0,0.0,0.3333333333333333,3390,15416,50850,35434
3178,0.0,0.0,0.3333333333333333,3390,15420,50850,35430
3199,1.0,0.0,0.3333333333333333,3391,15424,50865,35441
3241,1.0,0.0,0.3333333333333333,3392,15428,50880,35452
3248,1.0,0.0,0.3333333333333333,3393,15432,50895,35463
3260,1.0,0.0,0.3333333333333333,3394,15436,50910,35474
3309,1.0,0.0,0.3333333333333333,3395,15440,50925,35485
3322,1.0,0.0,0.3333333333333333,3396,15444,50940,35496
3411,1.0,0.0,0.3333333333333333,3397,15448,50955,35507
3423,1.0,0.0,0.3333333333333333,3398,15452,50970,35518
3441,1.0,0.0,0.3333333333333333,3399,15456,50985,35529
3455,0.0,0.0,0.3333333333333333,3399,15460,50985,35525
3482,1.0,0.0,0.3333333333333333,3400,15464,51000,35536
3531,0.0,0.0,0.3333333333333333,3400,15468,51000,35532
3583,1.0,0.0,0.3333333333333333,3401,15472,51015,35543
3668,0.0,0.0,0.3333333333333333,3401,15476,51015,35539
3674,0.0,0.0,0.3333333333333333,3401,15480,51015,35535
3694,0.0,0.0,0.3333333333333333,3401,15484,51015,35531
3726,0.0,0.0,0.3333333333333333,3401,15488,51015,35527
3735,1.0,0.0,0.3333333333333333,3402,15492,51030,35538
3795,0.0,0.0,0.3333333333333333,3402,15496,51030,35534
3820,0.0,0.0,0.3333333333333333,3402,15500,51030,35530
3822,0.0,0.0,0.3333333333333333,3402,15504,51030,35526
3830,0.0,0.0,0.3333333333333333,3402,15508,51030,35522
3851,0.0,0.0,0.3333333333333333,3402,15512,51030,35518
3857,0.0,0.0,0.3333333333333333,3402,15516,51030,35514
3935,1.0,0.0,0.3333333333333333,3403,15520,51045,35525
3945,0.0,0.0,0.3333333333333333,3403,15524,51045,35521
4002,0.0,0.0,0.3333333333333333,3403,15528,51045,35517
4009,0.0,0.0,0.3333333333333333,3403,15532,51045,35513
4011,0.0,0.0,0.3333333333333333,3403,15536,51045,35509
4165,0.0,0.0,0.3333333333333333,3403,15540,51045,35505
4219,0.0,0.0,0.3333333333333333,3403,15544,51045,35501
4237,1.0,0.0,0.3333333333333333,3404,15548,51060,35512
4239,1.0,0.0,0.3333333333333333,3405,15552,51075,35523
4399,1.0,0.0,0.3333333333333333,3406,15556,51090,35534
4546,0.0,0.0,0.3333333333333333,3406,15560,51090,35530
4555,1.0,0.0,0.3333333333333333,3407,15564,51105,35541
4574,1.0,0.0,0.3333333333333333,3408,15568,51120,35552
4582,0.0,0.0,0.3333333333333333,3408,15572,51120,35548
4601,1.0,0.0,0.3333333333333333,3409,15576,51135,35559
4644,0.0,0.0,0.3333333333333333,3409,15580,51135,35555
4689,0.0,0.0,0.3333333333333333,3409,15584,51135,35551
4698,0.0,0.0,0.3333333333333333,3409,15588,51135,35547
4713,1.0,0.0,0.3333333333333333,3410,15592,51150,35558
4727,1.0,0.0,0.3333333333333333,3411,15596,51165,35569
4846,0.0,0.0,0.3333333333333333,3411,15600,51165,35565
4902,0.0,0.0,0.3333333333333333,3411,15604,51165,35561
4938,0.0,0.0,0.3333333333333333,3411,15608,51165,35557
5021,0.0,0.0,0.3333333333333333,3411,15612,51165,35553
5028,0.0,0.0,0.3333333333333333,3411,15616,51165,35549
5111,0.0,0.0,0.3333333333333333,3411,15620,51165,35545
5268,0.0,0.0,0.3333333333333333,3411,15624,51165,35541
5269,1.0,0.0,0.3333333333333333,3412,15628,51180,35552
5271,0.0,0.0,0.3333333333333333,3412,15632,51180,35548
5278,1.0,0.0,0.3333333333333333,3413,15636,51195,35559
5330,1.0,0.0,0.3333333333333333,3414,15640,51210,35570
5355,0.0,0.0,0.3333333333333333,3414,15644,51210,35566
5356,1.0,0.0,0.3333333333333333,3415,15648,51225,35577
5401,0.0,0.0,0.3333333333333333,3415,15652,51225,35573
5412,0.0,0.0,0.3333333333333333,3415,15656,51225,35569
5522,1.0,0.0,0.3333333333333333,3416,15660,51240,35580
5530,0.0,0.0,0.3333333333333333,3416,15664,51240,35576
5560,0.0,0.0,0.3333333333333333,3416,15668,51240,35572
5598,1.0,0.0,0.3333333333333333,3417,15672,51255,35583
5637,1.0,0.0,0.3333333333333333,3418,15676,51270,35594
5670,0.0,0.0,0.3333333333333333,3418,15680,51270,35590
5678,0.0,0.0,0.3333333333333333,3418,15684,51270,35586
5775,0.0,0.0,0.3333333333333333,3418,15688,51270,35582
5859,0.0,0.0,0.3333333333333333,3418,15692,51270,35578
5861,0.0,0.0,0.3333333333333333,3418,15696,51270,35574
5893,0.0,0.0,0.3333333333333333,3418,15700,51270,35570
5926,0.0,0.0,0.3333333333333333,3418,15704,51270,35566
5956,0.0,0.0,0.3333333333333333,3418,15708,51270,35562
6010,0.0,0.0,0.3333333333333333,3418,15712,51270,35558
6015,1.0,0.0,0.3333333333333333,3419,15716,51285,35569
6029,0.0,0.0,0.3333333333333333,3419,15720,51285,35565
6048,0.0,0.0,0.3333333333333333,3419,15724,51285,35561
6050,0.0,0.0,0.3333333333333333,3419,15728,51285,35557
6217,1.0,0.0,0.3333333333333333,3420,15732,51300,35568
6314,0.0,0.0,0.3333333333333333,3420,15736,51300,35564
6376,0.0,0.0,0.3333333333333333,3420,15740,51300,35560
6386,1.0,0.0,0.3333333333333333,3421,15744,51315,35571
6511,0.0,0.0,0.3333333333333333,3421,15748,51315,35567
6526,0.0,0.0,0.3333333333333333,3421,15752,51315,35563
6631,1.0,0.0,0.3333333333333333,3422,15756,51330,35574
6721,0.0,0.0,0.3333333333333333,3422,15760,51330,35570
6763,0.0,0.0,0.3333333333333333,3422,15764,51330,35566
6782,0.0,0.0,0.3333333333333333,3422,15768,51330,35562
6846,0.0,0.0,0.3333333333333333,3422,15772,51330,35558
6849,0.0,0.0,0.3333333333333333,3422,15776,51330,35554
6916,0.0,0.0,0.3333333333333333,3422,15780,51330,35550
7080,0.0,0.0,0.3333333333333333,3422,15784,51330,35546
7086,1.0,0.0,0.3333333333333333,3423,15788,51345,35557
7116,1.0,0.0,0.3333333333333333,3424,15792,51360,35568
7216,1.0,0.0,0.3333333333333333,3425,15796,51375,35579
7368,1.0,0.0,0.3333333333333333,3426,15800,51390,35590
7374,0.0,0.0,0.3333333333333333,3426,15804,51390,35586
7495,0.0,0.0,0.3333333333333333,3426,15808,51390,35582
7553,1.0,0.0,0.3333333333333333,3427,15812,51405,35593
7830,0.0,0.0,0.3333333333333333,3427,15816,51405,35589
7855,0.0,0.0,0.3333333333333333,3427,15820,51405,35585
7882,1.0,0.0,0.3333333333333333,3428,15824,51420,35596
7991,1.0,0.0,0.3333333333333333,3429,15828,51435,35607
7993,0.0,0.0,0.3333333333333333,3429,15832,51435,35603
8023,0.0,0.0,0.3333333333333333,3429,15836,51435,35599
8044,1.0,0.0,0.3333333333333333,3430,15840,51450,35610
8062,0.0,0.0,0.3333333333333333,3430,15844,51450,35606
8122,1.0,0.0,0.3333333333333333,3431,15848,51465,35617
8202,1.0,0.0,0.3333333333333333,3432,15852,51480,35628
8223,1.0,0.0,0.3333333333333333,3433,15856,51495,35639
8259,1.0,0.0,0.3333333333333333,3434,15860,51510,35650
8262,1.0,0.0,0.3333333333333333,3435,15864,51525,35661
8301,0.0,0.0,0.3333333333333333,3435,15868,51525,35657
8302,0.0,0.0,0.3333333333333333,3435,15872,51525,35653
8307,0.0,0.0,0.3333333333333333,3435,15876,51525,35649
8358,1.0,0.0,0.3333333333333333,3436,15880,51540,35660
8402,0.0,0.0,0.3333333333333333,3436,15884,51540,35656
8467,0.0,0.0,0.3333333333333333,3436,15888,51540,35652
8530,1.0,0.0,0.3333333333333333,3437,15892,51555,35663
8580,1.0,0.0,0.3333333333333333,3438,15896,51570,35674
8590,1.0,0.0,0.3333333333333333,3439,15900,51585,35685
8617,0.0,0.0,0.3333333333333333,3439,15904,51585,35681
8756,0.0,0.0,0.3333333333333333,3439,15908,51585,35677
8764,0.0,0.0,0.3333333333333333,3439,15912,51585,35673
8775,0.0,0.0,0.3333333333333333,3439,15916,51585,35669
8831,1.0,0.0,0.3333333333333333,3440,15920,51600,35680
8838,0.0,0.0,0.3333333333333333,3440,15924,51600,35676
8987,0.0,0.0,0.3333333333333333,3440,15928,51600,35672
9108,0.0,0.0,0.3333333333333333,3440,15932,51600,35668
9135,0.0,0.0,0.3333333333333333,3440,15936,51600,35664
9150,0.0,0.0,0.3333333333333333,3440,15940,51600,35660
9469,0.0,0.0,0.3333333333333333,3440,15944,51600,35656
9525,0.0,0.0,0.3333333333333333,3440,15948,51600,35652
9540,1.0,0.0,0.3333333333333333,3441,15952,51615,35663
9578,0.0,0.0,0.3333333333333333,3441,15956,51615,35659
9589,0.0,0.0,0.3333333333333333,3441,15960,51615,35655
9650,1.0,0.0,0.3333333333333333,3442,15964,51630,35666
9702,0.0,0.0,0.3333333333333333,3442,15968,51630,35662
9762,1.0,0.0,0.3333333333333333,3443,15972,51645,35673
9784,0.0,0.0,0.3333333333333333,3443,15976,51645,35669
9799,1.0,0.0,0.3333333333333333,3444,15980,51660,35680
9907,1.0,0.0,0.3333333333333333,3445,15984,51675,35691
9930,0.0,0.0,0.3333333333333333,3445,15988,51675,35687
9950,1.0,0.0,0.3333333333333333,3446,15992,51690,35698
9982,1.0,0.0,0.3333333333333333,3447,15996,51705,35709
9984,1.0,0.0,0.3333333333333333,3448,16000,51720,35720
10189,1.0,0.0,0.3333333333333333,3449,16004,51735,35731
10207,1.0,0.0,0.3333333333333333,3450,16008,51750,35742
10230,0.0,0.0,0.3333333333333333,3450,16012,51750,35738
10293,1.0,0.0,0.3333333333333333,3451,16016,51765,35749
10376,0.0,0.0,0.3333333333333333,3451,16020,51765,35745
10388,0.0,0.0,0.3333333333333333,3451,16024,51765,35741
10417,1.0,0.0,0.3333333333333333,3452,16028,51780,35752
10461,0.0,0.0,0.3333333333333333,3452,16032,51780,35748
10478,0.0,0.0,0.3333333333333333,3452,16036,51780,35744
10493,0.0,0.0,0.3333333333333333,3452,16040,51780,35740
10547,1.0,0.0,0.3333333333333333,3453,16044,51795,35751
10574,1.0,0.0,0.3333333333333333,3454,16048,51810,35762
10607,0.0,0.0,0.3333333333333333,3454,16052,51810,35758
10672,0.0,0.0,0.3333333333333333,3454,16056,51810,35754
10800,1.0,0.0,0.3333333333333333,3455,16060,51825,35765
10815,0.0,0.0,0.3333333333333333,3455,16064,51825,35761
10841,1.0,0.0,0.3333333333333333,3456,16068,51840,35772
10850,0.0,0.0,0.3333333333333333,3456,16072,51840,35768
10878,0.0,0.0,0.3333333333333333,3456,16076,51840,35764
10881,1.0,0.0,0.3333333333333333,3457,16080,51855,35775
11016,1.0,0.0,0.3333333333333333,3458,16084,51870,35786
11065,1.0,0.0,0.3333333333333333,3459,16088,51885,35797
11105,0.0,0.0,0.3333333333333333,3459,16092,51885,35793
11200,0.0,0.0,0.3333333333333333,3459,16096,51885,35789
11203,1.0,0.0,0.3333333333333333,3460,16100,51900,35800
11249,0.0,0.0,0.3333333333333333,3460,16104,51900,35796
11277,1.0,0.0,0.3333333333333333,3461,16108,51915,35807
11284,0.0,0.0,0.3333333333333333,3461,16112,51915,35803
11372,0.0,0.0,0.3333333333333333,3461,16116,51915,35799
11409,0.0,0.0,0.3333333333333333,3461,16120,51915,35795
11469,0.0,0.0,0.3333333333333333,3461,16124,51915,35791
11479,0.0,0.0,0.3333333333333333,3461,16128,51915,35787
11482,1.0,0.0,0.3333333333333333,3462,16132,51930,35798
11485,0.0,0.0,0.3333333333333333,3462,16136,51930,35794
11500,1.0,0.0,0.3333333333333333,3463,16140,51945,35805
11526,1.0,0.0,0.3333333333333333,3464,16144,51960,35816
11553,1.0,0.0,0.3333333333333333,3465,16148,51975,35827
11594,0.0,0.0,0.3333333333333333,3465,16152,51975,35823
11598,0.0,0.0,0.3333333333333333,3465,16156,51975,35819
11626,1.0,0.0,0.3333333333333333,3466,16160,51990,35830
11627,0.0,0.0,0.3333333333333333,3466,16164,51990,35826
11735,0.0,0.0,0.3333333333333333,3466,16168,51990,35822
11756,1.0,0.0,0.3333333333333333,3467,16172,52005,35833
11776,0.0,0.0,0.3333333333333333,3467,16176,52005,35829
11847,0.0,0.0,0.3333333333333333,3467,16180,52005,35825
11861,0.0,0.0,0.3333333333333333,3467,16184,52005,35821
11896,0.0,0.0,0.3333333333333333,3467,16188,52005,35817
11938,0.0,0.0,0.3333333333333333,3467,16192,52005,35813
11963,1.0,0.0,0.3333333333333333,3468,16196,52020,35824
11979,0.0,0.0,0.3333333333333333,3468,16200,52020,35820
11983,0.0,0.0,0.3333333333333333,3468,16204,52020,35816
11988,1.0,0.0,0.3333333333333333,3469,16208,52035,35827
11990,1.0,0.0,0.3333333333333333,3470,16212,52050,35838
12021,0.0,0.0,0.3333333333333333,3470,16216,52050,35834
12075,0.0,0.0,0.3333333333333333,3470,16220,52050,35830
12097,0.0,0.0,0.3333333333333333,3470,16224,52050,35826
12153,0.0,0.0,0.3333333333333333,3470,16228,52050,35822
12170,0.0,0.0,0.3333333333333333,3470,16232,52050,35818
12229,1.0,0.0,0.3333333333333333,3471,16236,52065,35829
12392,1.0,0.0,0.3333333333333333,3472,16240,52080,35840
12444,1.0,0.0,0.3333333333333333,3473,16244,52095,35851
12514,0.0,0.0,0.3333333333333333,3473,16248,52095,35847
12518,0.0,0.0,0.3333333333333333,3473,16252,52095,35843
12535,0.0,0.0,0.3333333333333333,3473,16256,52095,35839
12540,1.0,0.0,0.3333333333333333,3474,16260,52110,35850
12545,0.0,0.0,0.3333333333333333,3474,16264,52110,35846
12608,0.0,0.0,0.3333333333333333,3474,16268,52110,35842
12615,0.0,0.0,0.3333333333333333,3474,16272,52110,35838
12620,0.0,0.0,0.3333333333333333,3474,16276,52110,35834
12623,0.0,0.0,0.3333333333333333,3474,16280,52110,35830
12654,0.0,0.0,0.3333333333333333,3474,16284,52110,35826
12664,0.0,0.0,0.3333333333333333,3474,16288,52110,35822
12684,0.0,0.0,0.3333333333333333,3474,16292,52110,35818
12686,0.0,0.0,0.3333333333333333,3474,16296,52110,35814
12711,0.0,0.0,0.3333333333333333,3474,16300,52110,35810
12712,1.0,0.0,0.3333333333333333,3475,16304,52125,35821
12761,0.0,0.0,0.3333333333333333,3475,16308,52125,35817
12767,0.0,0.0,0.3333333333333333,3475,16312,52125,35813
12779,1.0,0.0,0.3333333333333333,3476,16316,52140,35824
12800,1.0,0.0,0.3333333333333333,3477,16320,52155,35835
12869,0.0,0.0,0.3333333333333333,3477,16324,52155,35831
12876,0.0,0.0,0.3333333333333333,3477,16328,52155,35827
12921,0.0,0.0,0.3333333333333333,3477,16332,52155,35823
12969,1.0,0.0,0.3333333333333333,3478,16336,52170,35834
12984,0.0,0.0,0.3333333333333333,3478,16340,52170,35830
13002,1.0,0.0,0.3333333333333333,3479,16344,52185,35841
13045,0.0,0.0,0.3333333333333333,3479,16348,52185,35837
13059,0.0,0.0,0.3333333333333333,3479,16352,52185,35833
13077,0.0,0.0,0.3333333333333333,3479,16356,52185,35829
13112,1.0,0.0,0.3333333333333333,3480,16360,52200,35840
13129,1.0,0.0,0.3333333333333333,3481,16364,52215,35851
13177,1.0,0.0,0.3333333333333333,3482,16368,52230,35862
13231,0.0,0.0,0.3333333333333333,3482,16372,52230,35858
13245,0.0,0.0,0.3333333333333333,3482,16376,52230,35854
13268,0.0,0.0,0.3333333333333333,3482,16380,52230,35850
13400,1.0,0.0,0.3333333333333333,3483,16384,52245,35861
13403,0.0,0.0,0.3333333333333333,3483,16388,52245,35857
13407,1.0,0.0,0.3333333333333333,3484,16392,52260,35868
13506,0.0,0.0,0.3333333333333333,3484,16396,52260,35864
13615,0.0,0.0,0.3333333333333333,3484,16400,52260,35860
13618,0.0,0.0,0.3333333333333333,3484,16404,52260,35856
13727,0.0,0.0,0.3333333333333333,3484,16408,52260,35852
13774,0.0,0.0,0.3333333333333333,3484,16412,52260,35848
13776,0.0,0.0,0.3333333333333333,3484,16416,52260,35844
13781,0.0,0.0,0.3333333333333333,3484,16420,52260,35840
13852,0.0,0.0,0.3333333333333333,3484,16424,52260,35836
13907,0.0,0.0,0.3333333333333333,3484,16428,52260,35832
14109,0.0,0.0,0.3333333333333333,3484,16432,52260,35828
14139,0.0,0.0,0.3333333333333333,3484,16436,52260,35824
14158,0.0,0.0,0.3333333333333333,3484,16440,52260,35820
14159,0.0,0.0,0.3333333333333333,3484,16444,52260,35816
14219,1.0,0.0,0.3333333333333333,3485,16448,52275,35827
14221,0.0,0.0,0.3333333333333333,3485,16452,52275,35823
14280,0.0,0.0,0.3333333333333333,3485,16456,52275,35819
14308,1.0,0.0,0.3333333333333333,3486,16460,52290,35830
14319,1.0,0.0,0.3333333333333333,3487,16464,52305,35841
14328,0.0,0.0,0.3333333333333333,3487,16468,52305,35837
14359,0.0,0.0,0.3333333333333333,3487,16472,52305,35833
14528,0.0,0.0,0.3333333333333333,3487,16476,52305,35829
14532,0.0,0.0,0.3333333333333333,3487,16480,52305,35825
14544,0.0,0.0,0.3333333333333333,3487,16484,52305,35821
14677,0.0,0.0,0.3333333333333333,3487,16488,52305,35817
14701,0.0,0.0,0.3333333333333333,3487,16492,52305,35813
14753,0.0,0.0,0.3333333333333333,3487,16496,52305,35809
14755,0.0,0.0,0.3333333333333333,3487,16500,52305,35805
14894,0.0,0.0,0.3333333333333333,3487,16504,52305,35801
14913,0.0,0.0,0.3333333333333333,3487,16508,52305,35797
14919,1.0,0.0,0.3333333333333333,3488,16512,52320,35808
14945,0.0,0.0,0.3333333333333333,3488,16516,52320,35804
14981,1.0,0.0,0.3333333333333333,3489,16520,52335,35815
14994,1.0,0.0,0.3333333333333333,3490,16524,52350,35826
15037,0.0,0.0,0.3333333333333333,3490,16528,52350,35822
15058,1.0,0.0,0.3333333333333333,3491,16532,52365,35833
15090,1.0,0.0,0.3333333333333333,3492,16536,52380,35844
15104,0.0,0.0,0.3333333333333333,3492,16540,52380,35840
15144,0.0,0.0,0.3333333333333333,3492,16544,52380,35836
15162,0.0,0.0,0.3333333333333333,3492,16548,52380,35832
15176,0.0,0.0,0.3333333333333333,3492,16552,52380,35828
15204,0.0,0.0,0.3333333333333333,3492,16556,52380,35824
15233,0.0,0.0,0.3333333333333333,3492,16560,52380,35820
15235,1.0,0.0,0.3333333333333333,3493,16564,52395,35831
15298,0.0,0.0,0.3333333333333333,3493,16568,52395,35827
15333,0.0,0.0,0.3333333333333333,3493,16572,52395,35823
15381,0.0,0.0,0.3333333333333333,3493,16576,52395,35819
15421,0.0,0.0,0.3333333333333333,3493,16580,52395,35815
15462,0.0,0.0,0.3333333333333333,3493,16584,52395,35811
15571,1.0,0.0,0.3333333333333333,3494,16588,52410,35822
15651,1.0,0.0,0.3333333333333333,3495,16592,52425,35833
15734,0.0,0.0,0.3333333333333333,3495,16596,52425,35829
15798,0.0,0.0,0.3333333333333333,3495,16600,52425,35825
15839,1.0,0.0,0.3333333333333333,3496,16604,52440,35836
15844,0.0,0.0,0.3333333333333333,3496,16608,52440,35832
15875,0.0,0.0,0.3333333333333333,3496,16612,52440,35828
15908,0.0,0.0,0.3333333333333333,3496,16616,52440,35824
16055,0.0,0.0,0.3333333333333333,3496,16620,52440,35820
16056,0.0,0.0,0.3333333333333333,3496,16624,52440,35816
16085,1.0,0.0,0.3333333333333333,3497,16628,52455,35827
16092,0.0,0.0,0.3333333333333333,3497,16632,52455,35823
16102,0.0,0.0,0.3333333333333333,3497,16636,52455,35819
16107,0.0,0.0,0.3333333333333333,3497,16640,52455,35815
16111,0.0,0.0,0.3333333333333333,3497,16644,52455,35811
16134,0.0,0.0,0.3333333333333333,3497,16648,52455,35807
16136,0.0,0.0,0.3333333333333333,3497,16652,52455,35803
16165,0.0,0.0,0.3333333333333333,3497,16656,52455,35799
16166,0.0,0.0,0.3333333333333333,3497,16660,52455,35795
16168,1.0,0.0,0.3333333333333333,3498,16664,52470,35806
16175,1.0,0.0,0.3333333333333333,3499,16668,52485,35817
16190,0.0,0.0,0.3333333333333333,3499,16672,52485,35813
16229,0.0,0.0,0.3333333333333333,3499,16676,52485,35809
16410,0.0,0.0,0.3333333333333333,3499,16680,52485,35805
16426,1.0,0.0,0.3333333333333333,3500,16684,52500,35816
16432,1.0,0.0,0.3333333333333333,3501,16688,52515,35827
16493,0.0,0.0,0.3333333333333333,3501,16692,52515,35823
16505,1.0,0.0,0.3333333333333333,3502,16696,52530,35834
16521,0.0,0.0,0.3333333333333333,3502,16700,52530,35830
16578,0.0,0.0,0.3333333333333333,3502,16704,52530,35826
16645,0.0,0.0,0.3333333333333333,3502,16708,52530,35822
16646,0.0,0.0,0.3333333333333333,3502,16712,52530,35818
16751,1.0,0.0,0.3333333333333333,3503,16716,52545,35829
16773,1.0,0.0,0.3333333333333333,3504,16720,52560,35840
16793,0.0,0.0,0.3333333333333333,3504,16724,52560,35836
16847,0.0,0.0,0.3333333333333333,3504,16728,52560,35832
16857,1.0,0.0,0.3333333333333333,3505,16732,52575,35843
16858,0.0,0.0,0.3333333333333333,3505,16736,52575,35839
16943,0.0,0.0,0.3333333333333333,3505,16740,52575,35835
16982,1.0,0.0,0.3333333333333333,3506,16744,52590,35846
17037,0.0,0.0,0.3333333333333333,3506,16748,52590,35842
17065,0.0,0.0,0.3333333333333333,3506,16752,52590,35838
17069,0.0,0.0,0.3333333333333333,3506,16756,52590,35834
17072,0.0,0.0,0.3333333333333333,3506,16760,52590,35830
17131,1.0,0.0,0.3333333333333333,3507,16764,52605,35841
17173,0.0,0.0,0.3333333333333333,3507,16768,52605,35837
17194,1.0,0.0,0.3333333333333333,3508,16772,52620,35848
17230,0.0,0.0,0.3333333333333333,3508,16776,52620,35844
17420,0.0,0.0,0.3333333333333333,3508,16780,52620,35840
17567,0.0,0.0,0.3333333333333333,3508,16784,52620,35836
17586,0.0,0.0,0.3333333333333333,3508,16788,52620,35832
17655,1.0,0.0,0.3333333333333333,3509,16792,52635,35843
17735,0.0,0.0,0.3333333333333333,3509,16796,52635,35839
17751,0.0,0.0,0.3333333333333333,3509,16800,52635,35835
17762,1.0,0.0,0.3333333333333333,3510,16804,52650,35846
17772,0.0,0.0,0.3333333333333333,3510,16808,52650,35842
17827,1.0,0.0,0.3333333333333333,3511,16812,52665,35853
17849,1.0,0.0,0.3333333333333333,3512,16816,52680,35864
17886,1.0,0.0,0.3333333333333333,3513,16820,52695,35875
17981,0.0,0.0,0.3333333333333333,3513,16824,52695,35871
17991,0.0,0.0,0.3333333333333333,3513,16828,52695,35867
18133,0.0,0.0,0.3333333333333333,3513,16832,52695,35863
18237,1.0,0.0,0.3333333333333333,3514,16836,52710,35874
18279,1.0,0.0,0.3333333333333333,3515,16840,52725,35885
18334,0.0,0.0,0.3333333333333333,3515,16844,52725,35881
18349,0.0,0.0,0.3333333333333333,3515,16848,52725,35877
18489,0.0,0.0,0.3333333333333333,3515,16852,52725,35873
18526,0.0,0.0,0.3333333333333333,3515,16856,52725,35869
18565,0.0,0.0,0.3333333333333333,3515,16860,52725,35865
18603,1.0,0.0,0.3333333333333333,3516,16864,52740,35876
18696,1.0,0.0,0.3333333333333333,3517,16868,52755,35887
18702,0.0,0.0,0.3333333333333333,3517,16872,52755,35883
18707,0.0,0.0,0.3333333333333333,3517,16876,52755,35879
18772,1.0,0.0,0.3333333333333333,3518,16880,52770,35890
18781,0.0,0.0,0.3333333333333333,3518,16884,52770,35886
18797,1.0,0.0,0.3333333333333333,3519,16888,52785,35897
18803,1.0,0.0,0.3333333333333333,3520,16892,52800,35908
18899,0.0,0.0,0.3333333333333333,3520,16896,52800,35904
18922,1.0,0.0,0.3333333333333333,3521,16900,52815,35915
18973,0.0,0.0,0.3333333333333333,3521,16904,52815,35911
18974,1.0,0.0,0.3333333333333333,3522,16908,52830,35922
18980,0.0,0.0,0.3333333333333333,3522,16912,52830,35918
19002,0.0,0.0,0.3333333333333333,3522,16916,52830,35914
19028,0.0,0.0,0.3333333333333333,3522,16920,52830,35910
19039,0.0,0.0,0.3333333333333333,3522,16924,52830,35906
19059,1.0,0.0,0.3333333333333333,3523,16928,52845,35917
19094,0.0,0.0,0.3333333333333333,3523,16932,52845,35913
19162,0.0,0.0,0.3333333333333333,3523,16936,52845,35909
19206,0.0,0.0,0.3333333333333333,3523,16940,52845,35905
19242,1.0,0.0,0.3333333333333333,3524,16944,52860,35916
19286,0.0,0.0,0.3333333333333333,3524,16948,52860,35912
19333,0.0,0.0,0.3333333333333333,3524,16952,52860,35908
19347,1.0,0.0,0.3333333333333333,3525,16956,52875,35919
19357,0.0,0.0,0.3333333333333333,3525,16960,52875,35915
19429,0.0,0.0,0.3333333333333333,3525,16964,52875,35911
19443,1.0,0.0,0.3333333333333333,3526,16968,52890,35922
19452,0.0,0.0,0.3333333333333333,3526,16972,52890,35918
19474,0.0,0.0,0.3333333333333333,3526,16976,52890,35914
19564,1.0,0.0,0.3333333333333333,3527,16980,52905,35925
19581,0.0,0.0,0.3333333333333333,3527,16984,52905,35921
19610,0.0,0.0,0.3333333333333333,3527,16988,52905,35917
19653,0.0,0.0,0.3333333333333333,3527,16992,52905,35913
19720,1.0,0.0,0.3333333333333333,3528,16996,52920,35924
19741,0.0,0.0,0.3333333333333333,3528,17000,52920,35920
19759,0.0,0.0,0.3333333333333333,3528,17004,52920,35916
19792,1.0,0.0,0.3333333333333333,3529,17008,52935,35927
19826,1.0,0.0,0.3333333333333333,3530,17012,52950,35938
19842,0.0,0.0,0.3333333333333333,3530,17016,52950,35934
19886,0.0,0.0,0.3333333333333333,3530,17020,52950,35930
19908,0.0,0.0,0.3333333333333333,3530,17024,52950,35926
19938,0.0,0.0,0.3333333333333333,3530,17028,52950,35922
19992,0.0,0.0,0.3333333333333333,3530,17032,52950,35918
20024,0.0,0.0,0.3333333333333333,3530,17036,52950,35914
20036,0.0,0.0,0.3333333333333333,3530,17040,52950,35910
20096,0.0,0.0,0.3333333333333333,3530,17044,52950,35906
20114,1.0,0.0,0.3333333333333333,3531,17048,52965,35917
20151,1.0,0.0,0.3333333333333333,3532,17052,52980,35928
20167,0.0,0.0,0.3333333333333333,3532,17056,52980,35924
20277,0.0,0.0,0.3333333333333333,3532,17060,52980,35920
20332,0.0,0.0,0.3333333333333333,3532,17064,52980,35916
20339,0.0,0.0,0.3333333333333333,3532,17068,52980,35912
20467,0.0,0.0,0.3333333333333333,3532,17072,52980,35908
20546,0.0,0.0,0.3333333333333333,3532,17076,52980,35904
20573,1.0,0.0,0.3333333333333333,3533,17080,52995,35915
20611,1.0,0.0,0.3333333333333333,3534,17084,53010,35926
20620,0.0,0.0,0.3333333333333333,3534,17088,53010,35922
20671,0.0,0.0,0.3333333333333333,3534,17092,53010,35918
20680,0.0,0.0,0.3333333333333333,3534,17096,53010,35914
20694,1.0,0.0,0.3333333333333333,3535,17100,53025,35925
20712,0.0,0.0,0.3333333333333333,3535,17104,53025,35921
20713,0.0,0.0,0.3333333333333333,3535,17108,53025,35917
20749,0.0,0.0,0.3333333333333333,3535,17112,53025,35913
20785,1.0,0.0,0.3333333333333333,3536,17116,53040,35924
20791,0.0,0.0,0.3333333333333333,3536,17120,53040,35920
20828,0.0,0.0,0.3333333333333333,3536,17124,53040,35916
20919,1.0,0.0,0.3333333333333333,3537,17128,53055,35927
20935,0.0,0.0,0.3333333333333333,3537,17132,53055,35923
20983,0.0,0.0,0.3333333333333333,3537,17136,53055,35919
21026,1.0,0.0,0.3333333333333333,3538,17140,53070,35930
21043,0.0,0.0,0.3333333333333333,3538,17144,53070,35926
21044,1.0,0.0,0.3333333333333333,3539,17148,53085,35937
21069,0.0,0.0,0.3333333333333333,3539,17152,53085,35933
21071,0.0,0.0,0.3333333333333333,3539,17156,53085,35929
21096,1.0,0.0,0.3333333333333333,3540,17160,53100,35940
21365,0.0,0.0,0.3333333333333333,3540,17164,53100,35936
21369,0.0,0.0,0.3333333333333333,3540,17168,53100,35932
21375,0.0,0.0,0.3333333333333333,3540,17172,53100,35928
21444,1.0,0.0,0.3333333333333333,3541,17176,53115,35939
21508,0.0,0.0,0.3333333333333333,3541,17180,53115,35935
21514,1.0,0.0,0.3333333333333333,3542,17184,53130,35946
21516,0.0,0.0,0.3333333333333333,3542,17188,53130,35942
21596,1.0,0.0,0.3333333333333333,3543,17192,53145,35953
21624,0.0,0.0,0.3333333333333333,3543,17196,53145,35949
21664,0.0,0.0,0.3333333333333333,3543,17200,53145,35945
21665,0.0,0.0,0.3333333333333333,3543,17204,53145,35941
21700,1.0,0.0,0.3333333333333333,3544,17208,53160,35952
70,1.0,0.0,0.25,3545,17212,53175,35963
118,0.0,0.0,0.25,3545,17216,53175,35959
130,0.0,0.0,0.25,3545,17220,53175,35955
326,1.0,0.0,0.25,3546,17224,53190,35966
353,1.0,0.0,0.25,3547,17228,53205,35977
382,1.0,0.0,0.25,3548,17232,53220,35988
469,0.0,0.0,0.25,3548,17236,53220,35984
491,0.0,0.0,0.25,3548,17240,53220,35980
632,0.0,0.0,0.25,3548,17244,53220,35976
639,0.0,0.0,0.25,3548,17248,53220,35972
698,1.0,0.0,0.25,3549,17252,53235,35983
746,0.0,0.0,0.25,3549,17256,53235,35979
1027,0.0,0.0,0.25,3549,17260,53235,35975
1047,1.0,0.0,0.25,3550,17264,53250,35986
1343,0.0,0.0,0.25,3550,17268,53250,35982
1360,0.0,0.0,0.25,3550,17272,53250,35978
1368,1.0,0.0,0.25,3551,17276,53265,35989
1450,0.0,0.0,0.25,3551,17280,53265,35985
1596,1.0,0.0,0.25,3552,17284,53280,35996
1618,0.0,0.0,0.25,3552,17288,53280,35992
1632,0.0,0.0,0.25,3552,17292,53280,35988
1669,0.0,0.0,0.25,3552,17296,53280,35984
1715,0.0,0.0,0.25,3552,17300,53280,35980
1905,0.0,0.0,0.25,3552,17304,53280,35976
1949,0.0,0.0,0.25,3552,17308,53280,35972
2068,1.0,0.0,0.25,3553,17312,53295,35983
2506,0.0,0.0,0.25,3553,17316,53295,35979
2767,0.0,0.0,0.25,3553,17320,53295,35975
3088,0.0,0.0,0.25,3553,17324,53295,35971
3160,0.0,0.0,0.25,3553,17328,53295,35967
3177,0.0,0.0,0.25,3553,17332,53295,35963
3699,0.0,0.0,0.25,3553,17336,53295,35959
3844,0.0,0.0,0.25,3553,17340,53295,35955
3974,0.0,0.0,0.25,3553,17344,53295,35951
4070,0.0,0.0,0.25,3553,17348,53295,35947
4321,0.0,0.0,0.25,3553,17352,53295,35943
4356,0.0,0.0,0.25,3553,17356,53295,35939
4416,0.0,0.0,0.25,3553,17360,53295,35935
4648,1.0,0.0,0.25,3554,17364,53310,35946
4690,0.0,0.0,0.25,3554,17368,53310,35942
4813,0.0,0.0,0.25,3554,17372,53310,35938
4934,0.0,0.0,0.25,3554,17376,53310,35934
5112,0.0,0.0,0.25,3554,17380,53310,35930
5341,0.0,0.0,0.25,3554,17384,53310,35926
5396,0.0,0.0,0.25,3554,17388,53310,35922
5602,0.0,0.0,0.25,3554,17392,53310,35918
5732,0.0,0.0,0.25,3554,17396,53310,35914
5940,0.0,0.0,0.25,3554,17400,53310,35910
5991,0.0,0.0,0.25,3554,17404,53310,35906
6061,0.0,0.0,0.25,3554,17408,53310,35902
6220,0.0,0.0,0.25,3554,17412,53310,35898
6384,1.0,0.0,0.25,3555,17416,53325,35909
6501,0.0,0.0,0.25,3555,17420,53325,35905
6749,1.0,0.0,0.25,3556,17424,53340,35916
6766,0.0,0.0,0.25,3556,17428,53340,35912
6924,0.0,0.0,0.25,3556,17432,53340,35908
7223,0.0,0.0,0.25,3556,17436,53340,35904
7390,1.0,0.0,0.25,3557,17440,53355,35915
7433,1.0,0.0,0.25,3558,17444,53370,35926
7547,1.0,0.0,0.25,3559,17448,53385,35937
7843,1.0,0.0,0.25,3560,17452,53400,35948
7891,0.0,0.0,0.25,3560,17456,53400,35944
7907,1.0,0.0,0.25,3561,17460,53415,35955
8057,0.0,0.0,0.25,3561,17464,53415,35951
8206,0.0,0.0,0.25,3561,17468,53415,35947
8253,0.0,0.0,0.25,3561,17472,53415,35943
8290,1.0,0.0,0.25,3562,17476,53430,35954
8309,0.0,0.0,0.25,3562,17480,53430,35950
8372,0.0,0.0,0.25,3562,17484,53430,35946
8405,0.0,0.0,0.25,3562,17488,53430,35942
8472,0.0,0.0,0.25,3562,17492,53430,35938
8588,0.0,0.0,0.25,3562,17496,53430,35934
8712,1.0,0.0,0.25,3563,17500,53445,35945
8905,0.0,0.0,0.25,3563,17504,53445,35941
9025,1.0,0.0,0.25,3564,17508,53460,35952
9126,0.0,0.0,0.25,3564,17512,53460,35948
9175,0.0,0.0,0.25,3564,17516,53460,35944
9236,0.0,0.0,0.25,3564,17520,53460,35940
9394,0.0,0.0,0.25,3564,17524,53460,35936
9482,1.0,0.0,0.25,3565,17528,53475,35947
9716,0.0,0.0,0.25,3565,17532,53475,35943
9758,0.0,0.0,0.25,3565,17536,53475,35939
9767,0.0,0.0,0.25,3565,17540,53475,35935
9831,0.0,0.0,0.25,3565,17544,53475,35931
10089,0.0,0.0,0.25,3565,17548,53475,35927
10410,1.0,0.0,0.25,3566,17552,53490,35938
10424,1.0,0.0,0.25,3567,17556,53505,35949
10615,0.0,0.0,0.25,3567,17560,53505,35945
10703,0.0,0.0,0.25,3567,17564,53505,35941
10819,1.0,0.0,0.25,3568,17568,53520,35952
11120,0.0,0.0,0.25,3568,17572,53520,35948
11221,1.0,0.0,0.25,3569,17576,53535,35959
11291,0.0,0.0,0.25,3569,17580,53535,35955
11383,0.0,0.0,0.25,3569,17584,53535,35951
11971,0.0,0.0,0.25,3569,17588,53535,35947
12094,0.0,0.0,0.25,3569,17592,53535,35943
12524,0.0,0.0,0.25,3569,17596,53535,35939
12527,0.0,0.0,0.25,3569,17600,53535,35935
12569,1.0,0.0,0.25,3570,17604,53550,35946
12600,1.0,0.0,0.25,3571,17608,53565,35957
12609,0.0,0.0,0.25,3571,17612,53565,35953
12621,0.0,0.0,0.25,3571,17616,53565,35949
12626,0.0,0.0,0.25,3571,17620,53565,35945
12648,0.0,0.0,0.25,3571,17624,53565,35941
12744,0.0,0.0,0.25,3571,17628,53565,35937
13041,0.0,0.0,0.25,3571,17632,53565,35933
13111,0.0,0.0,0.25,3571,17636,53565,35929
13159,1.0,0.0,0.25,3572,17640,53580,35940
13210,0.0,0.0,0.25,3572,17644,53580,35936
13221,0.0,0.0,0.25,3572,17648,53580,35932
13306,0.0,0.0,0.25,3572,17652,53580,35928
13307,0.0,0.0,0.25,3572,17656,53580,35924
13469,0.0,0.0,0.25,3572,17660,53580,35920
13547,0.0,0.0,0.25,3572,17664,53580,35916
13635,0.0,0.0,0.25,3572,17668,53580,35912
13945,0.0,0.0,0.25,3572,17672,53580,35908
14047,1.0,0.0,0.25,3573,17676,53595,35919
14133,0.0,0.0,0.25,3573,17680,53595,35915
14303,0.0,0.0,0.25,3573,17684,53595,35911
14373,0.0,0.0,0.25,3573,17688,53595,35907
14512,0.0,0.0,0.25,3573,17692,53595,35903
14518,0.0,0.0,0.25,3573,17696,53595,35899
14665,0.0,0.0,0.25,3573,17700,53595,35895
14778,0.0,0.0,0.25,3573,17704,53595,35891
14791,1.0,0.0,0.25,3574,17708,53610,35902
14867,0.0,0.0,0.25,3574,17712,53610,35898
15102,0.0,0.0,0.25,3574,17716,53610,35894
15219,0.0,0.0,0.25,3574,17720,53610,35890
15275,0.0,0.0,0.25,3574,17724,53610,35886
15299,0.0,0.0,0.25,3574,17728,53610,35882
15358,1.0,0.0,0.25,3575,17732,53625,35893
15611,1.0,0.0,0.25,3576,17736,53640,35904
15749,0.0,0.0,0.25,3576,17740,53640,35900
16015,1.0,0.0,0.25,3577,17744,53655,35911
16066,0.0,0.0,0.25,3577,17748,53655,35907
16125,0.0,0.0,0.25,3577,17752,53655,35903
16144,0.0,0.0,0.25,3577,17756,53655,35899
16415,0.0,0.0,0.25,3577,17760,53655,35895
16416,0.0,0.0,0.25,3577,17764,53655,35891
16485,1.0,0.0,0.25,3578,17768,53670,35902
16515,0.0,0.0,0.25,3578,17772,53670,35898
16732,0.0,0.0,0.25,3578,17776,53670,35894
16746,0.0,0.0,0.25,3578,17780,53670,35890
16750,1.0,0.0,0.25,3579,17784,53685,35901
17398,0.0,0.0,0.25,3579,17788,53685,35897
17462,0.0,0.0,0.25,3579,17792,53685,35893
17507,0.0,0.0,0.25,3579,17796,53685,35889
17524,0.0,0.0,0.25,3579,17800,53685,35885
17583,0.0,0.0,0.25,3579,17804,53685,35881
17590,0.0,0.0,0.25,3579,17808,53685,35877
17596,1.0,0.0,0.25,3580,17812,53700,35888
18108,0.0,0.0,0.25,3580,17816,53700,35884
18328,1.0,0.0,0.25,3581,17820,53715,35895
18442,0.0,0.0,0.25,3581,17824,53715,35891
18895,0.0,0.0,0.25,3581,17828,53715,35887
19253,0.0,0.0,0.25,3581,17832,53715,35883
19378,1.0,0.0,0.25,3582,17836,53730,35894
19607,1.0,0.0,0.25,3583,17840,53745,35905
19687,0.0,0.0,0.25,3583,17844,53745,35901
19845,0.0,0.0,0.25,3583,17848,53745,35897
19913,0.0,0.0,0.25,3583,17852,53745,35893
20170,0.0,0.0,0.25,3583,17856,53745,35889
20344,0.0,0.0,0.25,3583,17860,53745,35885
20364,0.0,0.0,0.25,3583,17864,53745,35881
20441,0.0,0.0,0.25,3583,17868,53745,35877
20514,1.0,0.0,0.25,3584,17872,53760,35888
20704,0.0,0.0,0.25,3584,17876,53760,35884
20768,0.0,0.0,0.25,3584,17880,53760,35880
21141,0.0,0.0,0.25,3584,17884,53760,35876
21167,1.0,0.0,0.25,3585,17888,53775,35887
21181,1.0,0.0,0.25,3586,17892,53790,35898
21205,1.0,0.0,0.25,3587,17896,53805,35909
21214,0.0,0.0,0.25,3587,17900,53805,35905
21547,1.0,0.0,0.25,3588,17904,53820,35916
21613,0.0,0.0,0.25,3588,17908,53820,35912
21706,0.0,0.0,0.25,3588,17912,53820,35908
53,1.0,0.0,0.2,3589,17916,53835,35919
277,0.0,0.0,0.2,3589,17920,53835,35915
300,1.0,0.0,0.2,3590,17924,53850,35926
520,1.0,0.0,0.2,3591,17928,53865,35937
555,0.0,0.0,0.2,3591,17932,53865,35933
661,0.0,0.0,0.2,3591,17936,53865,35929
663,0.0,0.0,0.2,3591,17940,53865,35925
718,0.0,0.0,0.2,3591,17944,53865,35921
882,0.0,0.0,0.2,3591,17948,53865,35917
900,0.0,0.0,0.2,3591,17952,53865,35913
1012,0.0,0.0,0.2,3591,17956,53865,35909
1081,0.0,0.0,0.2,3591,17960,53865,35905
1086,0.0,0.0,0.2,3591,17964,53865,35901
1233,0.0,0.0,0.2,3591,17968,53865,35897
1326,0.0,0.0,0.2,3591,17972,53865,35893
1532,0.0,0.0,0.2,3591,17976,53865,35889
1617,0.0,0.0,0.2,3591,17980,53865,35885
1664,0.0,0.0,0.2,3591,17984,53865,35881
1966,0.0,0.0,0.2,3591,17988,53865,35877
2216,0.0,0.0,0.2,3591,17992,53865,35873
2417,0.0,0.0,0.2,3591,17996,53865,35869
2528,0.0,0.0,0.2,3591,18000,53865,35865
2548,0.0,0.0,0.2,3591,18004,53865,35861
2962,0.0,0.0,0.2,3591,18008,53865,35857
2964,0.0,0.0,0.2,3591,18012,53865,35853
3079,0.0,0.0,0.2,3591,18016,53865,35849
3488,0.0,0.0,0.2,3591,18020,53865,35845
3500,0.0,0.0,0.2,3591,18024,53865,35841
3516,0.0,0.0,0.2,3591,18028,53865,35837
3532,0.0,0.0,0.2,3591,18032,53865,35833
3617,0.0,0.0,0.2,3591,18036,53865,35829
5531,1.0,0.0,0.2,3592,18040,53880,35840
5627,0.0,0.0,0.2,3592,18044,53880,35836
5985,0.0,0.0,0.2,3592,18048,53880,35832
6071,0.0,0.0,0.2,3592,18052,53880,35828
6166,0.0,0.0,0.2,3592,18056,53880,35824
6425,0.0,0.0,0.2,3592,18060,53880,35820
6888,0.0,0.0,0.2,3592,18064,53880,35816
7182,1.0,0.0,0.2,3593,18068,53895,35827
7663,1.0,0.0,0.2,3594,18072,53910,35838
7863,1.0,0.0,0.2,3595,18076,53925,35849
8050,0.0,0.0,0.2,3595,18080,53925,35845
8076,0.0,0.0,0.2,3595,18084,53925,35841
8272,0.0,0.0,0.2,3595,18088,53925,35837
8273,0.0,0.0,0.2,3595,18092,53925,35833
8747,1.0,0.0,0.2,3596,18096,53940,35844
8755,0.0,0.0,0.2,3596,18100,53940,35840
9114,0.0,0.0,0.2,3596,18104,53940,35836
9161,0.0,0.0,0.2,3596,18108,53940,35832
9268,0.0,0.0,0.2,3596,18112,53940,35828
9269,0.0,0.0,0.2,3596,18116,53940,35824
9270,0.0,0.0,0.2,3596,18120,53940,35820
9315,0.0,0.0,0.2,3596,18124,53940,35816
9353,0.0,0.0,0.2,3596,18128,53940,35812
10810,0.0,0.0,0.2,3596,18132,53940,35808
10906,0.0,0.0,0.2,3596,18136,53940,35804
10991,1.0,0.0,0.2,3597,18140,53955,35815
11394,0.0,0.0,0.2,3597,18144,53955,35811
11419,0.0,0.0,0.2,3597,18148,53955,35807
11709,0.0,0.0,0.2,3597,18152,53955,35803
11742,0.0,0.0,0.2,3597,18156,53955,35799
11887,1.0,0.0,0.2,3598,18160,53970,35810
11939,0.0,0.0,0.2,3598,18164,53970,35806
12099,0.0,0.0,0.2,3598,18168,53970,35802
12550,0.0,0.0,0.2,3598,18172,53970,35798
12875,0.0,0.0,0.2,3598,18176,53970,35794
13031,0.0,0.0,0.2,3598,18180,53970,35790
13162,0.0,0.0,0.2,3598,18184,53970,35786
13260,0.0,0.0,0.2,3598,18188,53970,35782
13573,0.0,0.0,0.2,3598,18192,53970,35778
13636,1.0,0.0,0.2,3599,18196,53985,35789
13810,1.0,0.0,0.2,3600,18200,54000,35800
13818,1.0,0.0,0.2,3601,18204,54015,35811
14224,0.0,0.0,0.2,3601,18208,54015,35807
14464,0.0,0.0,0.2,3601,18212,54015,35803
14502,1.0,0.0,0.2,3602,18216,54030,35814
14504,0.0,0.0,0.2,3602,18220,54030,35810
14551,0.0,0.0,0.2,3602,18224,54030,35806
14681,1.0,0.0,0.2,3603,18228,54045,35817
15002,0.0,0.0,0.2,3603,18232,54045,35813
15054,0.0,0.0,0.2,3603,18236,54045,35809
15092,1.0,0.0,0.2,3604,18240,54060,35820
15346,1.0,0.0,0.2,3605,18244,54075,35831
15930,0.0,0.0,0.2,3605,18248,54075,35827
16019,0.0,0.0,0.2,3605,18252,54075,35823
16081,0.0,0.0,0.2,3605,18256,54075,35819
16431,0.0,0.0,0.2,3605,18260,54075,35815
16469,0.0,0.0,0.2,3605,18264,54075,35811
16595,0.0,0.0,0.2,3605,18268,54075,35807
16616,1.0,0.0,0.2,3606,18272,54090,35818
17004,0.0,0.0,0.2,3606,18276,54090,35814
17182,0.0,0.0,0.2,3606,18280,54090,35810
17228,0.0,0.0,0.2,3606,18284,54090,35806
17335,0.0,0.0,0.2,3606,18288,54090,35802
17457,0.0,0.0,0.2,3606,18292,54090,35798
17489,0.0,0.0,0.2,3606,18296,54090,35794
18216,0.0,0.0,0.2,3606,18300,54090,35790
18263,0.0,0.0,0.2,3606,18304,54090,35786
18363,0.0,0.0,0.2,3606,18308,54090,35782
18708,0.0,0.0,0.2,3606,18312,54090,35778
18761,0.0,0.0,0.2,3606,18316,54090,35774
18778,1.0,0.0,0.2,3607,18320,54105,35785
18873,0.0,0.0,0.2,3607,18324,54105,35781
19102,0.0,0.0,0.2,3607,18328,54105,35777
19312,0.0,0.0,0.2,3607,18332,54105,35773
19314,0.0,0.0,0.2,3607,18336,54105,35769
19573,1.0,0.0,0.2,3608,18340,54120,35780
20177,1.0,0.0,0.2,3609,18344,54135,35791
20433,0.0,0.0,0.2,3609,18348,54135,35787
20499,0.0,0.0,0.2,3609,18352,54135,35783
21241,0.0,0.0,0.2,3609,18356,54135,35779
21536,0.0,0.0,0.2,3609,18360,54135,35775
21660,1.0,0.0,0.2,3610,18364,54150,35786
21705,1.0,0.0,0.2,3611,18368,54165,35797
21739,0.0,0.0,0.2,3611,18372,54165,35793
1,0.0,0.0,0.0,3611,18376,54165,35789
3,0.0,0.0,0.0,3611,18380,54165,35785
4,0.0,0.0,0.0,3611,18384,54165,35781
5,0.0,0.0,0.0,3611,18388,54165,35777
6,0.0,0.0,0.0,3611,18392,54165,35773
7,0.0,0.0,0.0,3611,18396,54165,35769
8,0.0,0.0,0.0,3611,18400,54165,35765
9,0.0,0.0,0.0,3611,18404,54165,35761
12,0.0,0.0,0.0,3611,18408,54165,35757
13,0.0,0.0,0.0,3611,18412,54165,35753
14,0.0,0.0,0.0,3611,18416,54165,35749
15,0.0,0.0,0.0,3611,18420,54165,35745
16,0.0,0.0,0.0,3611,18424,54165,35741
17,0.0,0.0,0.0,3611,18428,54165,35737
18,0.0,0.0,0.0,3611,18432,54165,35733
19,0.0,0.0,0.0,3611,18436,54165,35729
20,0.0,0.0,0.0,3611,18440,54165,35725
21,0.0,0.0,0.0,3611,18444,54165,35721
22,0.0,0.0,0.0,3611,18448,54165,35717
23,0.0,0.0,0.0,3611,18452,54165,35713
25,0.0,0.0,0.0,3611,18456,54165,35709
26,0.0,0.0,0.0,3611,18460,54165,35705
27,0.0,0.0,0.0,3611,18464,54165,35701
28,0.0,0.0,0.0,3611,18468,54165,35697
30,0.0,0.0,0.0,3611,18472,54165,35693
31,0.0,0.0,0.0,3611,18476,54165,35689
33,0.0,0.0,0.0,3611,18480,54165,35685
34,0.0,0.0,0.0,3611,18484,54165,35681
35,0.0,0.0,0.0,3611,18488,54165,35677
36,0.0,0.0,0.0,3611,18492,54165,35673
37,0.0,0.0,0.0,3611,18496,54165,35669
38,0.0,0.0,0.0,3611,18500,54165,35665
40,0.0,0.0,0.0,3611,18504,54165,35661
41,0.0,0.0,0.0,3611,18508,54165,35657
42,0.0,0.0,0.0,3611,18512,54165,35653
43,0.0,0.0,0.0,3611,18516,54165,35649
44,0.0,0.0,0.0,3611,18520,54165,35645
45,0.0,0.0,0.0,3611,18524,54165,35641
48,0.0,0.0,0.0,3611,18528,54165,35637
49,0.0,0.0,0.0,3611,18532,54165,35633
50,0.0,0.0,0.0,3611,18536,54165,35629
51,0.0,0.0,0.0,3611,18540,54165,35625
52,0.0,0.0,0.0,3611,18544,54165,35621
54,0.0,0.0,0.0,3611,18548,54165,35617
55,0.0,0.0,0.0,3611,18552,54165,35613
56,0.0,0.0,0.0,3611,18556,54165,35609
57,0.0,0.0,0.0,3611,18560,54165,35605
58,0.0,0.0,0.0,3611,18564,54165,35601
59,0.0,0.0,0.0,3611,18568,54165,35597
60,0.0,0.0,0.0,3611,18572,54165,35593
62,0.0,0.0,0.0,3611,18576,54165,35589
64,0.0,0.0,0.0,3611,18580,54165,35585
65,0.0,0.0,0.0,3611,18584,54165,35581
66,0.0,0.0,0.0,3611,18588,54165,35577
67,0.0,0.0,0.0,3611,18592,54165,35573
68,0.0,0.0,0.0,3611,18596,54165,35569
69,0.0,0.0,0.0,3611,18600,54165,35565
72,0.0,0.0,0.0,3611,18604,54165,35561
73,0.0,0.0,0.0,3611,18608,54165,35557
76,0.0,0.0,0.0,3611,18612,54165,35553
77,0.0,0.0,0.0,3611,18616,54165,35549
78,0.0,0.0,0.0,3611,18620,54165,35545
79,0.0,0.0,0.0,3611,18624,54165,35541
80,0.0,0.0,0.0,3611,18628,54165,35537
82,0.0,0.0,0.0,3611,18632,54165,35533
83,0.0,0.0,0.0,3611,18636,54165,35529
84,0.0,0.0,0.0,3611,18640,54165,35525
86,0.0,0.0,0.0,3611,18644,54165,35521
87,0.0,0.0,0.0,3611,18648,54165,35517
88,0.0,0.0,0.0,3611,18652,54165,35513
90,0.0,0.0,0.0,3611,18656,54165,35509
92,0.0,0.0,0.0,3611,18660,54165,35505
93,0.0,0.0,0.0,3611,18664,54165,35501
94,0.0,0.0,0.0,3611,18668,54165,35497
95,0.0,0.0,0.0,3611,18672,54165,35493
97,0.0,0.0,0.0,3611,18676,54165,35489
98,0.0,0.0,0.0,3611,18680,54165,35485
99,0.0,0.0,0.0,3611,18684,54165,35481
100,0.0,0.0,0.0,3611,18688,54165,35477
101,0.0,0.0,0.0,3611,18692,54165,35473
102,0.0,0.0,0.0,3611,18696,54165,35469
104,0.0,0.0,0.0,3611,18700,54165,35465
105,0.0,0.0,0.0,3611,18704,54165,35461
106,0.0,0.0,0.0,3611,18708,54165,35457
107,0.0,0.0,0.0,3611,18712,54165,35453
108,0.0,0.0,0.0,3611,18716,54165,35449
109,0.0,0.0,0.0,3611,18720,54165,35445
110,0.0,0.0,0.0,3611,18724,54165,35441
112,0.0,0.0,0.0,3611,18728,54165,35437
113,0.0,0.0,0.0,3611,18732,54165,35433
114,0.0,0.0,0.0,3611,18736,54165,35429
115,0.0,0.0,0.0,3611,18740,54165,35425
116,0.0,0.0,0.0,3611,18744,54165,35421
117,0.0,0.0,0.0,3611,18748,54165,35417
119,0.0,0.0,0.0,3611,18752,54165,35413
120,0.0,0.0,0.0,3611,18756,54165,35409
121,0.0,0.0,0.0,3611,18760,54165,35405
122,0.0,0.0,0.0,3611,18764,54165,35401
123,0.0,0.0,0.0,3611,18768,54165,35397
124,0.0,0.0,0.0,3611,18772,54165,35393
126,0.0,0.0,0.0,3611,18776,54165,35389
127,0.0,0.0,0.0,3611,18780,54165,35385
128,0.0,0.0,0.0,3611,18784,54165,35381
129,0.0,0.0,0.0,3611,18788,54165,35377
132,0.0,0.0,0.0,3611,18792,54165,35373
133,0.0,0.0,0.0,3611,18796,54165,35369
134,0.0,0.0,0.0,3611,18800,54165,35365
135,0.0,0.0,0.0,3611,18804,54165,35361
136,0.0,0.0,0.0,3611,18808,54165,35357
137,0.0,0.0,0.0,3611,18812,54165,35353
138,0.0,0.0,0.0,3611,18816,54165,35349
139,0.0,0.0,0.0,3611,18820,54165,35345
141,0.0,0.0,0.0,3611,18824,54165,35341
142,0.0,0.0,0.0,3611,18828,54165,35337
144,0.0,0.0,0.0,3611,18832,54165,35333
145,0.0,0.0,0.0,3611,18836,54165,35329
147,0.0,0.0,0.0,3611,18840,54165,35325
148,0.0,0.0,0.0,3611,18844,54165,35321
149,0.0,0.0,0.0,3611,18848,54165,35317
150,0.0,0.0,0.0,3611,18852,54165,35313
151,0.0,0.0,0.0,3611,18856,54165,35309
152,0.0,0.0,0.0,3611,18860,54165,35305
153,0.0,0.0,0.0,3611,18864,54165,35301
154,0.0,0.0,0.0,3611,18868,54165,35297
155,0.0,0.0,0.0,3611,18872,54165,35293
156,0.0,0.0,0.0,3611,18876,54165,35289
157,0.0,0.0,0.0,3611,18880,54165,35285
158,0.0,0.0,0.0,3611,18884,54165,35281
159,0.0,0.0,0.0,3611,18888,54165,35277
161,0.0,0.0,0.0,3611,18892,54165,35273
162,0.0,0.0,0.0,3611,18896,54165,35269
163,0.0,0.0,0.0,3611,18900,54165,35265
164,0.0,0.0,0.0,3611,18904,54165,35261
166,0.0,0.0,0.0,3611,18908,54165,35257
167,0.0,0.0,0.0,3611,18912,54165,35253
169,0.0,0.0,0.0,3611,18916,54165,35249
172,0.0,0.0,0.0,3611,18920,54165,35245
173,0.0,0.0,0.0,3611,18924,54165,35241
174,0.0,0.0,0.0,3611,18928,54165,35237
176,0.0,0.0,0.0,3611,18932,54165,35233
177,0.0,0.0,0.0,3611,18936,54165,35229
178,0.0,0.0,0.0,3611,18940,54165,35225
179,0.0,0.0,0.0,3611,18944,54165,35221
180,0.0,0.0,0.0,3611,18948,54165,35217
183,0.0,0.0,0.0,3611,18952,54165,35213
184,0.0,0.0,0.0,3611,18956,54165,35209
186,0.0,0.0,0.0,3611,18960,54165,35205
187,0.0,0.0,0.0,3611,18964,54165,35201
188,0.0,0.0,0.0,3611,18968,54165,35197
189,0.0,0.0,0.0,3611,18972,54165,35193
191,0.0,0.0,0.0,3611,18976,54165,35189
192,0.0,0.0,0.0,3611,18980,54165,35185
194,0.0,0.0,0.0,3611,18984,54165,35181
196,0.0,0.0,0.0,3611,18988,54165,35177
197,0.0,0.0,0.0,3611,18992,54165,35173
198,0.0,0.0,0.0,3611,18996,54165,35169
199,0.0,0.0,0.0,3611,19000,54165,35165
200,0.0,0.0,0.0,3611,19004,54165,35161
204,0.0,0.0,0.0,3611,19008,54165,35157
205,0.0,0.0,0.0,3611,19012,54165,35153
206,0.0,0.0,0.0,3611,19016,54165,35149
207,0.0,0.0,0.0,3611,19020,54165,35145
208,0.0,0.0,0.0,3611,19024,54165,35141
209,0.0,0.0,0.0,3611,19028,54165,35137
210,0.0,0.0,0.0,3611,19032,54165,35133
211,0.0,0.0,0.0,3611,19036,54165,35129
212,0.0,0.0,0.0,3611,19040,54165,35125
213,0.0,0.0,0.0,3611,19044,54165,35121
214,0.0,0.0,0.0,3611,19048,54165,35117
215,0.0,0.0,0.0,3611,19052,54165,35113
216,0.0,0.0,0.0,3611,19056,54165,35109
217,0.0,0.0,0.0,3611,19060,54165,35105
218,0.0,0.0,0.0,3611,19064,54165,35101
219,0.0,0.0,0.0,3611,19068,54165,35097
220,0.0,0.0,0.0,3611,19072,54165,35093
221,0.0,0.0,0.0,3611,19076,54165,35089
222,0.0,0.0,0.0,3611,19080,54165,35085
223,0.0,0.0,0.0,3611,19084,54165,35081
224,0.0,0.0,0.0,3611,19088,54165,35077
225,0.0,0.0,0.0,3611,19092,54165,35073
226,0.0,0.0,0.0,3611,19096,54165,35069
227,0.0,0.0,0.0,3611,19100,54165,35065
228,0.0,0.0,0.0,3611,19104,54165,35061
231,0.0,0.0,0.0,3611,19108,54165,35057
232,0.0,0.0,0.0,3611,19112,54165,35053
233,0.0,0.0,0.0,3611,19116,54165,35049
234,0.0,0.0,0.0,3611,19120,54165,35045
236,0.0,0.0,0.0,3611,19124,54165,35041
237,0.0,0.0,0.0,3611,19128,54165,35037
240,0.0,0.0,0.0,3611,19132,54165,35033
242,0.0,0.0,0.0,3611,19136,54165,35029
243,0.0,0.0,0.0,3611,19140,54165,35025
244,0.0,0.0,0.0,3611,19144,54165,35021
245,0.0,0.0,0.0,3611,19148,54165,35017
246,0.0,0.0,0.0,3611,19152,54165,35013
247,0.0,0.0,0.0,3611,19156,54165,35009
248,0.0,0.0,0.0,3611,19160,54165,35005
249,0.0,0.0,0.0,3611,19164,54165,35001
250,0.0,0.0,0.0,3611,19168,54165,34997
251,0.0,0.0,0.0,3611,19172,54165,34993
252,0.0,0.0,0.0,3611,19176,54165,34989
253,0.0,0.0,0.0,3611,19180,54165,34985
254,0.0,0.0,0.0,3611,19184,54165,34981
255,0.0,0.0,0.0,3611,19188,54165,34977
256,0.0,0.0,0.0,3611,19192,54165,34973
257,0.0,0.0,0.0,3611,19196,54165,34969
258,0.0,0.0,0.0,3611,19200,54165,34965
259,0.0,0.0,0.0,3611,19204,54165,34961
261,0.0,0.0,0.0,3611,19208,54165,34957
263,0.0,0.0,0.0,3611,19212,54165,34953
264,0.0,0.0,0.0,3611,19216,54165,34949
265,0.0,0.0,0.0,3611,19220,54165,34945
266,0.0,0.0,0.0,3611,19224,54165,34941
267,0.0,0.0,0.0,3611,19228,54165,34937
268,0.0,0.0,0.0,3611,19232,54165,34933
269,0.0,0.0,0.0,3611,19236,54165,34929
270,0.0,0.0,0.0,3611,19240,54165,34925
271,0.0,0.0,0.0,3611,19244,54165,34921
272,0.0,0.0,0.0,3611,19248,54165,34917
274,0.0,0.0,0.0,3611,19252,54165,34913
278,0.0,0.0,0.0,3611,19256,54165,34909
279,0.0,0.0,0.0,3611,19260,54165,34905
280,0.0,0.0,0.0,3611,19264,54165,34901
281,0.0,0.0,0.0,3611,19268,54165,34897
282,0.0,0.0,0.0,3611,19272,54165,34893
283,0.0,0.0,0.0,3611,19276,54165,34889
284,0.0,0.0,0.0,3611,19280,54165,34885
285,0.0,0.0,0.0,3611,19284,54165,34881
286,0.0,0.0,0.0,3611,19288,54165,34877
288,0.0,0.0,0.0,3611,19292,54165,34873
289,0.0,0.0,0.0,3611,19296,54165,34869
290,0.0,0.0,0.0,3611,19300,54165,34865
291,0.0,0.0,0.0,3611,19304,54165,34861
292,0.0,0.0,0.0,3611,19308,54165,34857
294,0.0,0.0,0.0,3611,19312,54165,34853
295,0.0,0.0,0.0,3611,19316,54165,34849
296,0.0,0.0,0.0,3611,19320,54165,34845
297,0.0,0.0,0.0,3611,19324,54165,34841
298,0.0,0.0,0.0,3611,19328,54165,34837
299,0.0,0.0,0.0,3611,19332,54165,34833
301,0.0,0.0,0.0,3611,19336,54165,34829
302,0.0,0.0,0.0,3611,19340,54165,34825
303,0.0,0.0,0.0,3611,19344,54165,34821
304,0.0,0.0,0.0,3611,19348,54165,34817
305,0.0,0.0,0.0,3611,19352,54165,34813
306,0.0,0.0,0.0,3611,19356,54165,34809
308,0.0,0.0,0.0,3611,19360,54165,34805
310,0.0,0.0,0.0,3611,19364,54165,34801
312,0.0,0.0,0.0,3611,19368,54165,34797
313,0.0,0.0,0.0,3611,19372,54165,34793
314,0.0,0.0,0.0,3611,19376,54165,34789
315,0.0,0.0,0.0,3611,19380,54165,34785
316,0.0,0.0,0.0,3611,19384,54165,34781
318,0.0,0.0,0.0,3611,19388,54165,34777
319,0.0,0.0,0.0,3611,19392,54165,34773
320,0.0,0.0,0.0,3611,19396,54165,34769
321,0.0,0.0,0.0,3611,19400,54165,34765
322,0.0,0.0,0.0,3611,19404,54165,34761
324,0.0,0.0,0.0,3611,19408,54165,34757
325,0.0,0.0,0.0,3611,19412,54165,34753
327,0.0,0.0,0.0,3611,19416,54165,34749
328,0.0,0.0,0.0,3611,19420,54165,34745
329,0.0,0.0,0.0,3611,19424,54165,34741
330,0.0,0.0,0.0,3611,19428,54165,34737
331,0.0,0.0,0.0,3611,19432,54165,34733
333,0.0,0.0,0.0,3611,19436,54165,34729
334,0.0,0.0,0.0,3611,19440,54165,34725
336,0.0,0.0,0.0,3611,19444,54165,34721
337,0.0,0.0,0.0,3611,19448,54165,34717
339,0.0,0.0,0.0,3611,19452,54165,34713
341,0.0,0.0,0.0,3611,19456,54165,34709
342,0.0,0.0,0.0,3611,19460,54165,34705
343,0.0,0.0,0.0,3611,19464,54165,34701
344,0.0,0.0,0.0,3611,19468,54165,34697
345,0.0,0.0,0.0,3611,19472,54165,34693
346,0.0,0.0,0.0,3611,19476,54165,34689
347,0.0,0.0,0.0,3611,19480,54165,34685
348,0.0,0.0,0.0,3611,19484,54165,34681
349,0.0,0.0,0.0,3611,19488,54165,34677
350,0.0,0.0,0.0,3611,19492,54165,34673
351,0.0,0.0,0.0,3611,19496,54165,34669
352,0.0,0.0,0.0,3611,19500,54165,34665
354,0.0,0.0,0.0,3611,19504,54165,34661
355,0.0,0.0,0.0,3611,19508,54165,34657
356,0.0,0.0,0.0,3611,19512,54165,34653
357,0.0,0.0,0.0,3611,19516,54165,34649
358,0.0,0.0,0.0,3611,19520,54165,34645
359,0.0,0.0,0.0,3611,19524,54165,34641
360,0.0,0.0,0.0,3611,19528,54165,34637
362,0.0,0.0,0.0,3611,19532,54165,34633
363,0.0,0.0,0.0,3611,19536,54165,34629
364,0.0,0.0,0.0,3611,19540,54165,34625
365,0.0,0.0,0.0,3611,19544,54165,34621
366,0.0,0.0,0.0,3611,19548,54165,34617
367,0.0,0.0,0.0,3611,19552,54165,34613
368,0.0,0.0,0.0,3611,19556,54165,34609
369,0.0,0.0,0.0,3611,19560,54165,34605
370,0.0,0.0,0.0,3611,19564,54165,34601
371,0.0,0.0,0.0,3611,19568,54165,34597
372,0.0,0.0,0.0,3611,19572,54165,34593
373,0.0,0.0,0.0,3611,19576,54165,34589
374,0.0,0.0,0.0,3611,19580,54165,34585
375,0.0,0.0,0.0,3611,19584,54165,34581
376,0.0,0.0,0.0,3611,19588,54165,34577
377,0.0,0.0,0.0,3611,19592,54165,34573
378,0.0,0.0,0.0,3611,19596,54165,34569
379,0.0,0.0,0.0,3611,19600,54165,34565
380,0.0,0.0,0.0,3611,19604,54165,34561
381,0.0,0.0,0.0,3611,19608,54165,34557
383,0.0,0.0,0.0,3611,19612,54165,34553
384,0.0,0.0,0.0,3611,19616,54165,34549
385,0.0,0.0,0.0,3611,19620,54165,34545
386,0.0,0.0,0.0,3611,19624,54165,34541
387,0.0,0.0,0.0,3611,19628,54165,34537
388,0.0,0.0,0.0,3611,19632,54165,34533
389,0.0,0.0,0.0,3611,19636,54165,34529
391,0.0,0.0,0.0,3611,19640,54165,34525
392,0.0,0.0,0.0,3611,19644,54165,34521
393,0.0,0.0,0.0,3611,19648,54165,34517
394,0.0,0.0,0.0,3611,19652,54165,34513
396,0.0,0.0,0.0,3611,19656,54165,34509
397,0.0,0.0,0.0,3611,19660,54165,34505
398,0.0,0.0,0.0,3611,19664,54165,34501
399,0.0,0.0,0.0,3611,19668,54165,34497
400,0.0,0.0,0.0,3611,19672,54165,34493
401,0.0,0.0,0.0,3611,19676,54165,34489
402,0.0,0.0,0.0,3611,19680,54165,34485
403,0.0,0.0,0.0,3611,19684,54165,34481
404,0.0,0.0,0.0,3611,19688,54165,34477
405,0.0,0.0,0.0,3611,19692,54165,34473
407,0.0,0.0,0.0,3611,19696,54165,34469
409,0.0,0.0,0.0,3611,19700,54165,34465
410,0.0,0.0,0.0,3611,19704,54165,34461
411,0.0,0.0,0.0,3611,19708,54165,34457
412,0.0,0.0,0.0,3611,19712,54165,34453
413,0.0,0.0,0.0,3611,19716,54165,34449
415,0.0,0.0,0.0,3611,19720,54165,34445
416,0.0,0.0,0.0,3611,19724,54165,34441
417,0.0,0.0,0.0,3611,19728,54165,34437
418,0.0,0.0,0.0,3611,19732,54165,34433
419,0.0,0.0,0.0,3611,19736,54165,34429
420,0.0,0.0,0.0,3611,19740,54165,34425
421,0.0,0.0,0.0,3611,19744,54165,34421
422,0.0,0.0,0.0,3611,19748,54165,34417
423,0.0,0.0,0.0,3611,19752,54165,34413
424,0.0,0.0,0.0,3611,19756,54165,34409
428,0.0,0.0,0.0,3611,19760,54165,34405
429,0.0,0.0,0.0,3611,19764,54165,34401
431,0.0,0.0,0.0,3611,19768,54165,34397
432,0.0,0.0,0.0,3611,19772,54165,34393
433,0.0,0.0,0.0,3611,19776,54165,34389
436,0.0,0.0,0.0,3611,19780,54165,34385
437,0.0,0.0,0.0,3611,19784,54165,34381
439,0.0,0.0,0.0,3611,19788,54165,34377
440,0.0,0.0,0.0,3611,19792,54165,34373
441,0.0,0.0,0.0,3611,19796,54165,34369
442,0.0,0.0,0.0,3611,19800,54165,34365
444,0.0,0.0,0.0,3611,19804,54165,34361
445,0.0,0.0,0.0,3611,19808,54165,34357
447,0.0,0.0,0.0,3611,19812,54165,34353
448,0.0,0.0,0.0,3611,19816,54165,34349
450,0.0,0.0,0.0,3611,19820,54165,34345
451,0.0,0.0,0.0,3611,19824,54165,34341
452,0.0,0.0,0.0,3611,19828,54165,34337
453,0.0,0.0,0.0,3611,19832,54165,34333
455,0.0,0.0,0.0,3611,19836,54165,34329
456,0.0,0.0,0.0,3611,19840,54165,34325
459,0.0,0.0,0.0,3611,19844,54165,34321
460,0.0,0.0,0.0,3611,19848,54165,34317
461,0.0,0.0,0.0,3611,19852,54165,34313
462,0.0,0.0,0.0,3611,19856,54165,34309
463,0.0,0.0,0.0,3611,19860,54165,34305
464,0.0,0.0,0.0,3611,19864,54165,34301
466,0.0,0.0,0.0,3611,19868,54165,34297
467,0.0,0.0,0.0,3611,19872,54165,34293
470,0.0,0.0,0.0,3611,19876,54165,34289
472,0.0,0.0,0.0,3611,19880,54165,34285
473,0.0,0.0,0.0,3611,19884,54165,34281
474,0.0,0.0,0.0,3611,19888,54165,34277
475,0.0,0.0,0.0,3611,19892,54165,34273
476,0.0,0.0,0.0,3611,19896,54165,34269
477,0.0,0.0,0.0,3611,19900,54165,34265
478,0.0,0.0,0.0,3611,19904,54165,34261
479,0.0,0.0,0.0,3611,19908,54165,34257
480,0.0,0.0,0.0,3611,19912,54165,34253
481,0.0,0.0,0.0,3611,19916,54165,34249
482,0.0,0.0,0.0,3611,19920,54165,34245
483,0.0,0.0,0.0,3611,19924,54165,34241
484,0.0,0.0,0.0,3611,19928,54165,34237
485,0.0,0.0,0.0,3611,19932,54165,34233
487,0.0,0.0,0.0,3611,19936,54165,34229
488,0.0,0.0,0.0,3611,19940,54165,34225
489,0.0,0.0,0.0,3611,19944,54165,34221
490,0.0,0.0,0.0,3611,19948,54165,34217
492,0.0,0.0,0.0,3611,19952,54165,34213
493,0.0,0.0,0.0,3611,19956,54165,34209
495,0.0,0.0,0.0,3611,19960,54165,34205
496,0.0,0.0,0.0,3611,19964,54165,34201
497,0.0,0.0,0.0,3611,19968,54165,34197
498,0.0,0.0,0.0,3611,19972,54165,34193
501,0.0,0.0,0.0,3611,19976,54165,34189
502,0.0,0.0,0.0,3611,19980,54165,34185
504,0.0,0.0,0.0,3611,19984,54165,34181
505,0.0,0.0,0.0,3611,19988,54165,34177
506,0.0,0.0,0.0,3611,19992,54165,34173
507,0.0,0.0,0.0,3611,19996,54165,34169
508,0.0,0.0,0.0,3611,20000,54165,34165
509,0.0,0.0,0.0,3611,20004,54165,34161
510,0.0,0.0,0.0,3611,20008,54165,34157
512,0.0,0.0,0.0,3611,20012,54165,34153
513,0.0,0.0,0.0,3611,20016,54165,34149
514,0.0,0.0,0.0,3611,20020,54165,34145
515,0.0,0.0,0.0,3611,20024,54165,34141
516,0.0,0.0,0.0,3611,20028,54165,34137
517,0.0,0.0,0.0,3611,20032,54165,34133
518,0.0,0.0,0.0,3611,20036,54165,34129
519,0.0,0.0,0.0,3611,20040,54165,34125
521,0.0,0.0,0.0,3611,20044,54165,34121
523,0.0,0.0,0.0,3611,20048,54165,34117
524,0.0,0.0,0.0,3611,20052,54165,34113
525,0.0,0.0,0.0,3611,20056,54165,34109
526,0.0,0.0,0.0,3611,20060,54165,34105
527,0.0,0.0,0.0,3611,20064,54165,34101
528,0.0,0.0,0.0,3611,20068,54165,34097
529,0.0,0.0,0.0,3611,20072,54165,34093
530,0.0,0.0,0.0,3611,20076,54165,34089
531,0.0,0.0,0.0,3611,20080,54165,34085
532,0.0,0.0,0.0,3611,20084,54165,34081
533,0.0,0.0,0.0,3611,20088,54165,34077
534,0.0,0.0,0.0,3611,20092,54165,34073
535,0.0,0.0,0.0,3611,20096,54165,34069
536,0.0,0.0,0.0,3611,20100,54165,34065
537,0.0,0.0,0.0,3611,20104,54165,34061
539,0.0,0.0,0.0,3611,20108,54165,34057
540,0.0,0.0,0.0,3611,20112,54165,34053
541,0.0,0.0,0.0,3611,20116,54165,34049
542,0.0,0.0,0.0,3611,20120,54165,34045
544,0.0,0.0,0.0,3611,20124,54165,34041
545,0.0,0.0,0.0,3611,20128,54165,34037
546,0.0,0.0,0.0,3611,20132,54165,34033
547,0.0,0.0,0.0,3611,20136,54165,34029
548,0.0,0.0,0.0,3611,20140,54165,34025
549,0.0,0.0,0.0,3611,20144,54165,34021
551,0.0,0.0,0.0,3611,20148,54165,34017
552,0.0,0.0,0.0,3611,20152,54165,34013
554,0.0,0.0,0.0,3611,20156,54165,34009
556,0.0,0.0,0.0,3611,20160,54165,34005
557,0.0,0.0,0.0,3611,20164,54165,34001
558,0.0,0.0,0.0,3611,20168,54165,33997
559,0.0,0.0,0.0,3611,20172,54165,33993
560,0.0,0.0,0.0,3611,20176,54165,33989
561,0.0,0.0,0.0,3611,20180,54165,33985
562,0.0,0.0,0.0,3611,20184,54165,33981
563,0.0,0.0,0.0,3611,20188,54165,33977
564,0.0,0.0,0.0,3611,20192,54165,33973
565,0.0,0.0,0.0,3611,20196,54165,33969
566,0.0,0.0,0.0,3611,20200,54165,33965
567,0.0,0.0,0.0,3611,20204,54165,33961
568,0.0,0.0,0.0,3611,20208,54165,33957
569,0.0,0.0,0.0,3611,20212,54165,33953
570,0.0,0.0,0.0,3611,20216,54165,33949
571,0.0,0.0,0.0,3611,20220,54165,33945
572,0.0,0.0,0.0,3611,20224,54165,33941
573,0.0,0.0,0.0,3611,20228,54165,33937
574,0.0,0.0,0.0,3611,20232,54165,33933
575,0.0,0.0,0.0,3611,20236,54165,33929
576,0.0,0.0,0.0,3611,20240,54165,33925
577,0.0,0.0,0.0,3611,20244,54165,33921
579,0.0,0.0,0.0,3611,20248,54165,33917
581,0.0,0.0,0.0,3611,20252,54165,33913
582,0.0,0.0,0.0,3611,20256,54165,33909
583,0.0,0.0,0.0,3611,20260,54165,33905
584,0.0,0.0,0.0,3611,20264,54165,33901
585,0.0,0.0,0.0,3611,20268,54165,33897
586,0.0,0.0,0.0,3611,20272,54165,33893
587,0.0,0.0,0.0,3611,20276,54165,33889
588,0.0,0.0,0.0,3611,20280,54165,33885
589,0.0,0.0,0.0,3611,20284,54165,33881
590,0.0,0.0,0.0,3611,20288,54165,33877
591,0.0,0.0,0.0,3611,20292,54165,33873
592,0.0,0.0,0.0,3611,20296,54165,33869
593,0.0,0.0,0.0,3611,20300,54165,33865
595,0.0,0.0,0.0,3611,20304,54165,33861
596,0.0,0.0,0.0,3611,20308,54165,33857
597,0.0,0.0,0.0,3611,20312,54165,33853
598,0.0,0.0,0.0,3611,20316,54165,33849
599,0.0,0.0,0.0,3611,20320,54165,33845
600,0.0,0.0,0.0,3611,20324,54165,33841
602,0.0,0.0,0.0,3611,20328,54165,33837
603,0.0,0.0,0.0,3611,20332,54165,33833
604,0.0,0.0,0.0,3611,20336,54165,33829
605,0.0,0.0,0.0,3611,20340,54165,33825
606,0.0,0.0,0.0,3611,20344,54165,33821
608,0.0,0.0,0.0,3611,20348,54165,33817
609,0.0,0.0,0.0,3611,20352,54165,33813
612,0.0,0.0,0.0,3611,20356,54165,33809
613,0.0,0.0,0.0,3611,20360,54165,33805
614,0.0,0.0,0.0,3611,20364,54165,33801
615,0.0,0.0,0.0,3611,20368,54165,33797
616,0.0,0.0,0.0,3611,20372,54165,33793
618,0.0,0.0,0.0,3611,20376,54165,33789
619,0.0,0.0,0.0,3611,20380,54165,33785
620,0.0,0.0,0.0,3611,20384,54165,33781
621,0.0,0.0,0.0,3611,20388,54165,33777
622,0.0,0.0,0.0,3611,20392,54165,33773
623,0.0,0.0,0.0,3611,20396,54165,33769
624,0.0,0.0,0.0,3611,20400,54165,33765
625,0.0,0.0,0.0,3611,20404,54165,33761
626,0.0,0.0,0.0,3611,20408,54165,33757
627,0.0,0.0,0.0,3611,20412,54165,33753
628,0.0,0.0,0.0,3611,20416,54165,33749
629,0.0,0.0,0.0,3611,20420,54165,33745
630,0.0,0.0,0.0,3611,20424,54165,33741
633,0.0,0.0,0.0,3611,20428,54165,33737
634,0.0,0.0,0.0,3611,20432,54165,33733
635,0.0,0.0,0.0,3611,20436,54165,33729
636,0.0,0.0,0.0,3611,20440,54165,33725
637,0.0,0.0,0.0,3611,20444,54165,33721
638,0.0,0.0,0.0,3611,20448,54165,33717
640,0.0,0.0,0.0,3611,20452,54165,33713
641,0.0,0.0,0.0,3611,20456,54165,33709
642,0.0,0.0,0.0,3611,20460,54165,33705
643,0.0,0.0,0.0,3611,20464,54165,33701
644,0.0,0.0,0.0,3611,20468,54165,33697
645,0.0,0.0,0.0,3611,20472,54165,33693
646,0.0,0.0,0.0,3611,20476,54165,33689
647,0.0,0.0,0.0,3611,20480,54165,33685
648,0.0,0.0,0.0,3611,20484,54165,33681
649,0.0,0.0,0.0,3611,20488,54165,33677
650,0.0,0.0,0.0,3611,20492,54165,33673
651,0.0,0.0,0.0,3611,20496,54165,33669
652,0.0,0.0,0.0,3611,20500,54165,33665
653,0.0,0.0,0.0,3611,20504,54165,33661
654,0.0,0.0,0.0,3611,20508,54165,33657
655,0.0,0.0,0.0,3611,20512,54165,33653
657,0.0,0.0,0.0,3611,20516,54165,33649
658,0.0,0.0,0.0,3611,20520,54165,33645
659,0.0,0.0,0.0,3611,20524,54165,33641
660,0.0,0.0,0.0,3611,20528,54165,33637
664,0.0,0.0,0.0,3611,20532,54165,33633
665,0.0,0.0,0.0,3611,20536,54165,33629
666,0.0,0.0,0.0,3611,20540,54165,33625
667,0.0,0.0,0.0,3611,20544,54165,33621
670,0.0,0.0,0.0,3611,20548,54165,33617
671,0.0,0.0,0.0,3611,20552,54165,33613
672,0.0,0.0,0.0,3611,20556,54165,33609
673,0.0,0.0,0.0,3611,20560,54165,33605
674,0.0,0.0,0.0,3611,20564,54165,33601
675,0.0,0.0,0.0,3611,20568,54165,33597
676,0.0,0.0,0.0,3611,20572,54165,33593
678,0.0,0.0,0.0,3611,20576,54165,33589
680,0.0,0.0,0.0,3611,20580,54165,33585
681,0.0,0.0,0.0,3611,20584,54165,33581
682,0.0,0.0,0.0,3611,20588,54165,33577
683,0.0,0.0,0.0,3611,20592,54165,33573
684,0.0,0.0,0.0,3611,20596,54165,33569
685,0.0,0.0,0.0,3611,20600,54165,33565
686,0.0,0.0,0.0,3611,20604,54165,33561
687,0.0,0.0,0.0,3611,20608,54165,33557
688,0.0,0.0,0.0,3611,20612,54165,33553
689,0.0,0.0,0.0,3611,20616,54165,33549
690,0.0,0.0,0.0,3611,20620,54165,33545
691,0.0,0.0,0.0,3611,20624,54165,33541
692,0.0,0.0,0.0,3611,20628,54165,33537
693,0.0,0.0,0.0,3611,20632,54165,33533
694,0.0,0.0,0.0,3611,20636,54165,33529
696,0.0,0.0,0.0,3611,20640,54165,33525
697,0.0,0.0,0.0,3611,20644,54165,33521
700,0.0,0.0,0.0,3611,20648,54165,33517
701,0.0,0.0,0.0,3611,20652,54165,33513
702,0.0,0.0,0.0,3611,20656,54165,33509
703,0.0,0.0,0.0,3611,20660,54165,33505
704,0.0,0.0,0.0,3611,20664,54165,33501
705,0.0,0.0,0.0,3611,20668,54165,33497
706,0.0,0.0,0.0,3611,20672,54165,33493
707,0.0,0.0,0.0,3611,20676,54165,33489
708,0.0,0.0,0.0,3611,20680,54165,33485
709,0.0,0.0,0.0,3611,20684,54165,33481
710,0.0,0.0,0.0,3611,20688,54165,33477
711,0.0,0.0,0.0,3611,20692,54165,33473
712,0.0,0.0,0.0,3611,20696,54165,33469
713,0.0,0.0,0.0,3611,20700,54165,33465
714,0.0,0.0,0.0,3611,20704,54165,33461
715,0.0,0.0,0.0,3611,20708,54165,33457
716,0.0,0.0,0.0,3611,20712,54165,33453
717,0.0,0.0,0.0,3611,20716,54165,33449
720,0.0,0.0,0.0,3611,20720,54165,33445
721,0.0,0.0,0.0,3611,20724,54165,33441
722,0.0,0.0,0.0,3611,20728,54165,33437
723,0.0,0.0,0.0,3611,20732,54165,33433
724,0.0,0.0,0.0,3611,20736,54165,33429
725,0.0,0.0,0.0,3611,20740,54165,33425
729,0.0,0.0,0.0,3611,20744,54165,33421
730,0.0,0.0,0.0,3611,20748,54165,33417
732,0.0,0.0,0.0,3611,20752,54165,33413
733,0.0,0.0,0.0,3611,20756,54165,33409
736,0.0,0.0,0.0,3611,20760,54165,33405
737,0.0,0.0,0.0,3611,20764,54165,33401
738,0.0,0.0,0.0,3611,20768,54165,33397
739,0.0,0.0,0.0,3611,20772,54165,33393
740,0.0,0.0,0.0,3611,20776,54165,33389
741,0.0,0.0,0.0,3611,20780,54165,33385
743,0.0,0.0,0.0,3611,20784,54165,33381
745,0.0,0.0,0.0,3611,20788,54165,33377
747,0.0,0.0,0.0,3611,20792,54165,33373
749,0.0,0.0,0.0,3611,20796,54165,33369
750,0.0,0.0,0.0,3611,20800,54165,33365
751,0.0,0.0,0.0,3611,20804,54165,33361
752,0.0,0.0,0.0,3611,20808,54165,33357
754,0.0,0.0,0.0,3611,20812,54165,33353
756,0.0,0.0,0.0,3611,20816,54165,33349
757,0.0,0.0,0.0,3611,20820,54165,33345
758,0.0,0.0,0.0,3611,20824,54165,33341
760,0.0,0.0,0.0,3611,20828,54165,33337
761,0.0,0.0,0.0,3611,20832,54165,33333
762,0.0,0.0,0.0,3611,20836,54165,33329
763,0.0,0.0,0.0,3611,20840,54165,33325
764,0.0,0.0,0.0,3611,20844,54165,33321
766,0.0,0.0,0.0,3611,20848,54165,33317
767,0.0,0.0,0.0,3611,20852,54165,33313
768,0.0,0.0,0.0,3611,20856,54165,33309
769,0.0,0.0,0.0,3611,20860,54165,33305
771,0.0,0.0,0.0,3611,20864,54165,33301
772,0.0,0.0,0.0,3611,20868,54165,33297
773,0.0,0.0,0.0,3611,20872,54165,33293
774,0.0,0.0,0.0,3611,20876,54165,33289
776,0.0,0.0,0.0,3611,20880,54165,33285
777,0.0,0.0,0.0,3611,20884,54165,33281
778,0.0,0.0,0.0,3611,20888,54165,33277
779,0.0,0.0,0.0,3611,20892,54165,33273
780,0.0,0.0,0.0,3611,20896,54165,33269
781,0.0,0.0,0.0,3611,20900,54165,33265
782,0.0,0.0,0.0,3611,20904,54165,33261
783,0.0,0.0,0.0,3611,20908,54165,33257
784,0.0,0.0,0.0,3611,20912,54165,33253
785,0.0,0.0,0.0,3611,20916,54165,33249
786,0.0,0.0,0.0,3611,20920,54165,33245
787,0.0,0.0,0.0,3611,20924,54165,33241
788,0.0,0.0,0.0,3611,20928,54165,33237
789,0.0,0.0,0.0,3611,20932,54165,33233
790,0.0,0.0,0.0,3611,20936,54165,33229
791,0.0,0.0,0.0,3611,20940,54165,33225
792,0.0,0.0,0.0,3611,20944,54165,33221
793,0.0,0.0,0.0,3611,20948,54165,33217
794,0.0,0.0,0.0,3611,20952,54165,33213
796,0.0,0.0,0.0,3611,20956,54165,33209
797,0.0,0.0,0.0,3611,20960,54165,33205
798,0.0,0.0,0.0,3611,20964,54165,33201
799,0.0,0.0,0.0,3611,20968,54165,33197
800,0.0,0.0,0.0,3611,20972,54165,33193
801,0.0,0.0,0.0,3611,20976,54165,33189
802,0.0,0.0,0.0,3611,20980,54165,33185
803,0.0,0.0,0.0,3611,20984,54165,33181
804,0.0,0.0,0.0,3611,20988,54165,33177
805,0.0,0.0,0.0,3611,20992,54165,33173
806,0.0,0.0,0.0,3611,20996,54165,33169
809,0.0,0.0,0.0,3611,21000,54165,33165
810,0.0,0.0,0.0,3611,21004,54165,33161
812,0.0,0.0,0.0,3611,21008,54165,33157
813,0.0,0.0,0.0,3611,21012,54165,33153
814,0.0,0.0,0.0,3611,21016,54165,33149
815,0.0,0.0,0.0,3611,21020,54165,33145
816,0.0,0.0,0.0,3611,21024,54165,33141
819,0.0,0.0,0.0,3611,21028,54165,33137
821,0.0,0.0,0.0,3611,21032,54165,33133
822,0.0,0.0,0.0,3611,21036,54165,33129
823,0.0,0.0,0.0,3611,21040,54165,33125
824,0.0,0.0,0.0,3611,21044,54165,33121
825,0.0,0.0,0.0,3611,21048,54165,33117
828,0.0,0.0,0.0,3611,21052,54165,33113
829,0.0,0.0,0.0,3611,21056,54165,33109
830,0.0,0.0,0.0,3611,21060,54165,33105
831,0.0,0.0,0.0,3611,21064,54165,33101
832,0.0,0.0,0.0,3611,21068,54165,33097
833,0.0,0.0,0.0,3611,21072,54165,33093
834,0.0,0.0,0.0,3611,21076,54165,33089
835,0.0,0.0,0.0,3611,21080,54165,33085
836,0.0,0.0,0.0,3611,21084,54165,33081
837,0.0,0.0,0.0,3611,21088,54165,33077
838,0.0,0.0,0.0,3611,21092,54165,33073
839,0.0,0.0,0.0,3611,21096,54165,33069
840,0.0,0.0,0.0,3611,21100,54165,33065
841,0.0,0.0,0.0,3611,21104,54165,33061
842,0.0,0.0,0.0,3611,21108,54165,33057
843,0.0,0.0,0.0,3611,21112,54165,33053
845,0.0,0.0,0.0,3611,21116,54165,33049
846,0.0,0.0,0.0,3611,21120,54165,33045
847,0.0,0.0,0.0,3611,21124,54165,33041
848,0.0,0.0,0.0,3611,21128,54165,33037
849,0.0,0.0,0.0,3611,21132,54165,33033
850,0.0,0.0,0.0,3611,21136,54165,33029
854,0.0,0.0,0.0,3611,21140,54165,33025
855,0.0,0.0,0.0,3611,21144,54165,33021
856,0.0,0.0,0.0,3611,21148,54165,33017
858,0.0,0.0,0.0,3611,21152,54165,33013
859,0.0,0.0,0.0,3611,21156,54165,33009
860,0.0,0.0,0.0,3611,21160,54165,33005
861,0.0,0.0,0.0,3611,21164,54165,33001
862,0.0,0.0,0.0,3611,21168,54165,32997
864,0.0,0.0,0.0,3611,21172,54165,32993
865,0.0,0.0,0.0,3611,21176,54165,32989
866,0.0,0.0,0.0,3611,21180,54165,32985
867,0.0,0.0,0.0,3611,21184,54165,32981
868,0.0,0.0,0.0,3611,21188,54165,32977
869,0.0,0.0,0.0,3611,21192,54165,32973
870,0.0,0.0,0.0,3611,21196,54165,32969
871,0.0,0.0,0.0,3611,21200,54165,32965
872,0.0,0.0,0.0,3611,21204,54165,32961
873,0.0,0.0,0.0,3611,21208,54165,32957
874,0.0,0.0,0.0,3611,21212,54165,32953
877,0.0,0.0,0.0,3611,21216,54165,32949
878,0.0,0.0,0.0,3611,21220,54165,32945
879,0.0,0.0,0.0,3611,21224,54165,32941
880,0.0,0.0,0.0,3611,21228,54165,32937
883,0.0,0.0,0.0,3611,21232,54165,32933
884,0.0,0.0,0.0,3611,21236,54165,32929
885,0.0,0.0,0.0,3611,21240,54165,32925
886,0.0,0.0,0.0,3611,21244,54165,32921
887,0.0,0.0,0.0,3611,21248,54165,32917
888,0.0,0.0,0.0,3611,21252,54165,32913
890,0.0,0.0,0.0,3611,21256,54165,32909
891,0.0,0.0,0.0,3611,21260,54165,32905
892,0.0,0.0,0.0,3611,21264,54165,32901
893,0.0,0.0,0.0,3611,21268,54165,32897
894,0.0,0.0,0.0,3611,21272,54165,32893
895,0.0,0.0,0.0,3611,21276,54165,32889
896,0.0,0.0,0.0,3611,21280,54165,32885
897,0.0,0.0,0.0,3611,21284,54165,32881
899,0.0,0.0,0.0,3611,21288,54165,32877
902,0.0,0.0,0.0,3611,21292,54165,32873
903,0.0,0.0,0.0,3611,21296,54165,32869
904,0.0,0.0,0.0,3611,21300,54165,32865
905,0.0,0.0,0.0,3611,21304,54165,32861
906,0.0,0.0,0.0,3611,21308,54165,32857
907,0.0,0.0,0.0,3611,21312,54165,32853
908,0.0,0.0,0.0,3611,21316,54165,32849
910,0.0,0.0,0.0,3611,21320,54165,32845
911,0.0,0.0,0.0,3611,21324,54165,32841
912,0.0,0.0,0.0,3611,21328,54165,32837
913,0.0,0.0,0.0,3611,21332,54165,32833
916,0.0,0.0,0.0,3611,21336,54165,32829
917,0.0,0.0,0.0,3611,21340,54165,32825
918,0.0,0.0,0.0,3611,21344,54165,32821
919,0.0,0.0,0.0,3611,21348,54165,32817
920,0.0,0.0,0.0,3611,21352,54165,32813
922,0.0,0.0,0.0,3611,21356,54165,32809
925,0.0,0.0,0.0,3611,21360,54165,32805
926,0.0,0.0,0.0,3611,21364,54165,32801
927,0.0,0.0,0.0,3611,21368,54165,32797
928,0.0,0.0,0.0,3611,21372,54165,32793
929,0.0,0.0,0.0,3611,21376,54165,32789
931,0.0,0.0,0.0,3611,21380,54165,32785
932,0.0,0.0,0.0,3611,21384,54165,32781
933,0.0,0.0,0.0,3611,21388,54165,32777
934,0.0,0.0,0.0,3611,21392,54165,32773
935,0.0,0.0,0.0,3611,21396,54165,32769
936,0.0,0.0,0.0,3611,21400,54165,32765
937,0.0,0.0,0.0,3611,21404,54165,32761
939,0.0,0.0,0.0,3611,21408,54165,32757
940,0.0,0.0,0.0,3611,21412,54165,32753
942,0.0,0.0,0.0,3611,21416,54165,32749
943,0.0,0.0,0.0,3611,21420,54165,32745
944,0.0,0.0,0.0,3611,21424,54165,32741
945,0.0,0.0,0.0,3611,21428,54165,32737
946,0.0,0.0,0.0,3611,21432,54165,32733
947,0.0,0.0,0.0,3611,21436,54165,32729
948,0.0,0.0,0.0,3611,21440,54165,32725
949,0.0,0.0,0.0,3611,21444,54165,32721
950,0.0,0.0,0.0,3611,21448,54165,32717
952,0.0,0.0,0.0,3611,21452,54165,32713
953,0.0,0.0,0.0,3611,21456,54165,32709
954,0.0,0.0,0.0,3611,21460,54165,32705
956,0.0,0.0,0.0,3611,21464,54165,32701
957,0.0,0.0,0.0,3611,21468,54165,32697
959,0.0,0.0,0.0,3611,21472,54165,32693
960,0.0,0.0,0.0,3611,21476,54165,32689
961,0.0,0.0,0.0,3611,21480,54165,32685
962,0.0,0.0,0.0,3611,21484,54165,32681
963,0.0,0.0,0.0,3611,21488,54165,32677
964,0.0,0.0,0.0,3611,21492,54165,32673
965,0.0,0.0,0.0,3611,21496,54165,32669
966,0.0,0.0,0.0,3611,21500,54165,32665
967,0.0,0.0,0.0,3611,21504,54165,32661
968,0.0,0.0,0.0,3611,21508,54165,32657
969,0.0,0.0,0.0,3611,21512,54165,32653
970,0.0,0.0,0.0,3611,21516,54165,32649
971,0.0,0.0,0.0,3611,21520,54165,32645
972,0.0,0.0,0.0,3611,21524,54165,32641
974,0.0,0.0,0.0,3611,21528,54165,32637
976,0.0,0.0,0.0,3611,21532,54165,32633
979,0.0,0.0,0.0,3611,21536,54165,32629
982,0.0,0.0,0.0,3611,21540,54165,32625
983,0.0,0.0,0.0,3611,21544,54165,32621
984,0.0,0.0,0.0,3611,21548,54165,32617
985,0.0,0.0,0.0,3611,21552,54165,32613
986,0.0,0.0,0.0,3611,21556,54165,32609
987,0.0,0.0,0.0,3611,21560,54165,32605
988,0.0,0.0,0.0,3611,21564,54165,32601
989,0.0,0.0,0.0,3611,21568,54165,32597
990,0.0,0.0,0.0,3611,21572,54165,32593
991,0.0,0.0,0.0,3611,21576,54165,32589
992,0.0,0.0,0.0,3611,21580,54165,32585
994,0.0,0.0,0.0,3611,21584,54165,32581
995,0.0,0.0,0.0,3611,21588,54165,32577
996,0.0,0.0,0.0,3611,21592,54165,32573
997,0.0,0.0,0.0,3611,21596,54165,32569
998,0.0,0.0,0.0,3611,21600,54165,32565
1000,0.0,0.0,0.0,3611,21604,54165,32561
1001,0.0,0.0,0.0,3611,21608,54165,32557
1002,0.0,0.0,0.0,3611,21612,54165,32553
1003,0.0,0.0,0.0,3611,21616,54165,32549
1004,0.0,0.0,0.0,3611,21620,54165,32545
1007,0.0,0.0,0.0,3611,21624,54165,32541
1008,0.0,0.0,0.0,3611,21628,54165,32537
1009,0.0,0.0,0.0,3611,21632,54165,32533
1011,0.0,0.0,0.0,3611,21636,54165,32529
1013,0.0,0.0,0.0,3611,21640,54165,32525
1015,0.0,0.0,0.0,3611,21644,54165,32521
1016,0.0,0.0,0.0,3611,21648,54165,32517
1017,0.0,0.0,0.0,3611,21652,54165,32513
1018,0.0,0.0,0.0,3611,21656,54165,32509
1019,0.0,0.0,0.0,3611,21660,54165,32505
1023,0.0,0.0,0.0,3611,21664,54165,32501
1024,0.0,0.0,0.0,3611,21668,54165,32497
1025,0.0,0.0,0.0,3611,21672,54165,32493
1026,0.0,0.0,0.0,3611,21676,54165,32489
1030,0.0,0.0,0.0,3611,21680,54165,32485
1032,0.0,0.0,0.0,3611,21684,54165,32481
1033,0.0,0.0,0.0,3611,21688,54165,32477
1035,0.0,0.0,0.0,3611,21692,54165,32473
1036,0.0,0.0,0.0,3611,21696,54165,32469
1037,0.0,0.0,0.0,3611,21700,54165,32465
1038,0.0,0.0,0.0,3611,21704,54165,32461
1039,0.0,0.0,0.0,3611,21708,54165,32457
1040,0.0,0.0,0.0,3611,21712,54165,32453
1041,0.0,0.0,0.0,3611,21716,54165,32449
1042,0.0,0.0,0.0,3611,21720,54165,32445
1043,0.0,0.0,0.0,3611,21724,54165,32441
1044,0.0,0.0,0.0,3611,21728,54165,32437
1049,0.0,0.0,0.0,3611,21732,54165,32433
1050,0.0,0.0,0.0,3611,21736,54165,32429
1052,0.0,0.0,0.0,3611,21740,54165,32425
1053,0.0,0.0,0.0,3611,21744,54165,32421
1054,0.0,0.0,0.0,3611,21748,54165,32417
1055,0.0,0.0,0.0,3611,21752,54165,32413
1056,0.0,0.0,0.0,3611,21756,54165,32409
1057,0.0,0.0,0.0,3611,21760,54165,32405
1058,0.0,0.0,0.0,3611,21764,54165,32401
1060,0.0,0.0,0.0,3611,21768,54165,32397
1061,0.0,0.0,0.0,3611,21772,54165,32393
1062,0.0,0.0,0.0,3611,21776,54165,32389
1063,0.0,0.0,0.0,3611,21780,54165,32385
1065,0.0,0.0,0.0,3611,21784,54165,32381
1066,0.0,0.0,0.0,3611,21788,54165,32377
1067,0.0,0.0,0.0,3611,21792,54165,32373
1068,0.0,0.0,0.0,3611,21796,54165,32369
1069,0.0,0.0,0.0,3611,21800,54165,32365
1070,0.0,0.0,0.0,3611,21804,54165,32361
1072,0.0,0.0,0.0,3611,21808,54165,32357
1075,0.0,0.0,0.0,3611,21812,54165,32353
1077,0.0,0.0,0.0,3611,21816,54165,32349
1078,0.0,0.0,0.0,3611,21820,54165,32345
1079,0.0,0.0,0.0,3611,21824,54165,32341
1083,0.0,0.0,0.0,3611,21828,54165,32337
1084,0.0,0.0,0.0,3611,21832,54165,32333
1085,0.0,0.0,0.0,3611,21836,54165,32329
1087,0.0,0.0,0.0,3611,21840,54165,32325
1088,0.0,0.0,0.0,3611,21844,54165,32321
1089,0.0,0.0,0.0,3611,21848,54165,32317
1091,0.0,0.0,0.0,3611,21852,54165,32313
1094,0.0,0.0,0.0,3611,21856,54165,32309
1095,0.0,0.0,0.0,3611,21860,54165,32305
1096,0.0,0.0,0.0,3611,21864,54165,32301
1097,0.0,0.0,0.0,3611,21868,54165,32297
1099,0.0,0.0,0.0,3611,21872,54165,32293
1102,0.0,0.0,0.0,3611,21876,54165,32289
1103,0.0,0.0,0.0,3611,21880,54165,32285
1104,0.0,0.0,0.0,3611,21884,54165,32281
1105,0.0,0.0,0.0,3611,21888,54165,32277
1106,0.0,0.0,0.0,3611,21892,54165,32273
1107,0.0,0.0,0.0,3611,21896,54165,32269
1108,0.0,0.0,0.0,3611,21900,54165,32265
1109,0.0,0.0,0.0,3611,21904,54165,32261
1110,0.0,0.0,0.0,3611,21908,54165,32257
1111,0.0,0.0,0.0,3611,21912,54165,32253
1112,0.0,0.0,0.0,3611,21916,54165,32249
1113,0.0,0.0,0.0,3611,21920,54165,32245
1115,0.0,0.0,0.0,3611,21924,54165,32241
1116,0.0,0.0,0.0,3611,21928,54165,32237
1117,0.0,0.0,0.0,3611,21932,54165,32233
1118,0.0,0.0,0.0,3611,21936,54165,32229
1119,0.0,0.0,0.0,3611,21940,54165,32225
1120,0.0,0.0,0.0,3611,21944,54165,32221
1122,0.0,0.0,0.0,3611,21948,54165,32217
1123,0.0,0.0,0.0,3611,21952,54165,32213
1125,0.0,0.0,0.0,3611,21956,54165,32209
1126,0.0,0.0,0.0,3611,21960,54165,32205
1127,0.0,0.0,0.0,3611,21964,54165,32201
1128,0.0,0.0,0.0,3611,21968,54165,32197
1129,0.0,0.0,0.0,3611,21972,54165,32193
1130,0.0,0.0,0.0,3611,21976,54165,32189
1131,0.0,0.0,0.0,3611,21980,54165,32185
1132,0.0,0.0,0.0,3611,21984,54165,32181
1133,0.0,0.0,0.0,3611,21988,54165,32177
1134,0.0,0.0,0.0,3611,21992,54165,32173
1135,0.0,0.0,0.0,3611,21996,54165,32169
1136,0.0,0.0,0.0,3611,22000,54165,32165
1137,0.0,0.0,0.0,3611,22004,54165,32161
1138,0.0,0.0,0.0,3611,22008,54165,32157
1140,0.0,0.0,0.0,3611,22012,54165,32153
1141,0.0,0.0,0.0,3611,22016,54165,32149
1143,0.0,0.0,0.0,3611,22020,54165,32145
1144,0.0,0.0,0.0,3611,22024,54165,32141
1145,0.0,0.0,0.0,3611,22028,54165,32137
1146,0.0,0.0,0.0,3611,22032,54165,32133
1147,0.0,0.0,0.0,3611,22036,54165,32129
1148,0.0,0.0,0.0,3611,22040,54165,32125
1149,0.0,0.0,0.0,3611,22044,54165,32121
1150,0.0,0.0,0.0,3611,22048,54165,32117
1152,0.0,0.0,0.0,3611,22052,54165,32113
1153,0.0,0.0,0.0,3611,22056,54165,32109
1154,0.0,0.0,0.0,3611,22060,54165,32105
1155,0.0,0.0,0.0,3611,22064,54165,32101
1156,0.0,0.0,0.0,3611,22068,54165,32097
1157,0.0,0.0,0.0,3611,22072,54165,32093
1159,0.0,0.0,0.0,3611,22076,54165,32089
1160,0.0,0.0,0.0,3611,22080,54165,32085
1161,0.0,0.0,0.0,3611,22084,54165,32081
1162,0.0,0.0,0.0,3611,22088,54165,32077
1163,0.0,0.0,0.0,3611,22092,54165,32073
1164,0.0,0.0,0.0,3611,22096,54165,32069
1165,0.0,0.0,0.0,3611,22100,54165,32065
1166,0.0,0.0,0.0,3611,22104,54165,32061
1167,0.0,0.0,0.0,3611,22108,54165,32057
1168,0.0,0.0,0.0,3611,22112,54165,32053
1169,0.0,0.0,0.0,3611,22116,54165,32049
1172,0.0,0.0,0.0,3611,22120,54165,32045
1173,0.0,0.0,0.0,3611,22124,54165,32041
1174,0.0,0.0,0.0,3611,22128,54165,32037
1175,0.0,0.0,0.0,3611,22132,54165,32033
1176,0.0,0.0,0.0,3611,22136,54165,32029
1177,0.0,0.0,0.0,3611,22140,54165,32025
1178,0.0,0.0,0.0,3611,22144,54165,32021
1179,0.0,0.0,0.0,3611,22148,54165,32017
1180,0.0,0.0,0.0,3611,22152,54165,32013
1181,0.0,0.0,0.0,3611,22156,54165,32009
1182,0.0,0.0,0.0,3611,22160,54165,32005
1183,0.0,0.0,0.0,3611,22164,54165,32001
1184,0.0,0.0,0.0,3611,22168,54165,31997
1185,0.0,0.0,0.0,3611,22172,54165,31993
1186,0.0,0.0,0.0,3611,22176,54165,31989
1187,0.0,0.0,0.0,3611,22180,54165,31985
1188,0.0,0.0,0.0,3611,22184,54165,31981
1189,0.0,0.0,0.0,3611,22188,54165,31977
1190,0.0,0.0,0.0,3611,22192,54165,31973
1191,0.0,0.0,0.0,3611,22196,54165,31969
1192,0.0,0.0,0.0,3611,22200,54165,31965
1196,0.0,0.0,0.0,3611,22204,54165,31961
1197,0.0,0.0,0.0,3611,22208,54165,31957
1198,0.0,0.0,0.0,3611,22212,54165,31953
1199,0.0,0.0,0.0,3611,22216,54165,31949
1200,0.0,0.0,0.0,3611,22220,54165,31945
1202,0.0,0.0,0.0,3611,22224,54165,31941
1203,0.0,0.0,0.0,3611,22228,54165,31937
1204,0.0,0.0,0.0,3611,22232,54165,31933
1205,0.0,0.0,0.0,3611,22236,54165,31929
1207,0.0,0.0,0.0,3611,22240,54165,31925
1208,0.0,0.0,0.0,3611,22244,54165,31921
1209,0.0,0.0,0.0,3611,22248,54165,31917
1210,0.0,0.0,0.0,3611,22252,54165,31913
1211,0.0,0.0,0.0,3611,22256,54165,31909
1212,0.0,0.0,0.0,3611,22260,54165,31905
1213,0.0,0.0,0.0,3611,22264,54165,31901
1215,0.0,0.0,0.0,3611,22268,54165,31897
1216,0.0,0.0,0.0,3611,22272,54165,31893
1217,0.0,0.0,0.0,3611,22276,54165,31889
1218,0.0,0.0,0.0,3611,22280,54165,31885
1219,0.0,0.0,0.0,3611,22284,54165,31881
1220,0.0,0.0,0.0,3611,22288,54165,31877
1222,0.0,0.0,0.0,3611,22292,54165,31873
1223,0.0,0.0,0.0,3611,22296,54165,31869
1224,0.0,0.0,0.0,3611,22300,54165,31865
1225,0.0,0.0,0.0,3611,22304,54165,31861
1226,0.0,0.0,0.0,3611,22308,54165,31857
1227,0.0,0.0,0.0,3611,22312,54165,31853
1228,0.0,0.0,0.0,3611,22316,54165,31849
1230,0.0,0.0,0.0,3611,22320,54165,31845
1234,0.0,0.0,0.0,3611,22324,54165,31841
1235,0.0,0.0,0.0,3611,22328,54165,31837
1237,0.0,0.0,0.0,3611,22332,54165,31833
1239,0.0,0.0,0.0,3611,22336,54165,31829
1240,0.0,0.0,0.0,3611,22340,54165,31825
1241,0.0,0.0,0.0,3611,22344,54165,31821
1242,0.0,0.0,0.0,3611,22348,54165,31817
1243,0.0,0.0,0.0,3611,22352,54165,31813
1244,0.0,0.0,0.0,3611,22356,54165,31809
1245,0.0,0.0,0.0,3611,22360,54165,31805
1246,0.0,0.0,0.0,3611,22364,54165,31801
1247,0.0,0.0,0.0,3611,22368,54165,31797
1248,0.0,0.0,0.0,3611,22372,54165,31793
1249,0.0,0.0,0.0,3611,22376,54165,31789
1250,0.0,0.0,0.0,3611,22380,54165,31785
1251,0.0,0.0,0.0,3611,22384,54165,31781
1252,0.0,0.0,0.0,3611,22388,54165,31777
1253,0.0,0.0,0.0,3611,22392,54165,31773
1254,0.0,0.0,0.0,3611,22396,54165,31769
1255,0.0,0.0,0.0,3611,22400,54165,31765
1256,0.0,0.0,0.0,3611,22404,54165,31761
1257,0.0,0.0,0.0,3611,22408,54165,31757
1258,0.0,0.0,0.0,3611,22412,54165,31753
1260,0.0,0.0,0.0,3611,22416,54165,31749
1263,0.0,0.0,0.0,3611,22420,54165,31745
1264,0.0,0.0,0.0,3611,22424,54165,31741
1265,0.0,0.0,0.0,3611,22428,54165,31737
1267,0.0,0.0,0.0,3611,22432,54165,31733
1268,0.0,0.0,0.0,3611,22436,54165,31729
1269,0.0,0.0,0.0,3611,22440,54165,31725
1270,0.0,0.0,0.0,3611,22444,54165,31721
1272,0.0,0.0,0.0,3611,22448,54165,31717
1273,0.0,0.0,0.0,3611,22452,54165,31713
1275,0.0,0.0,0.0,3611,22456,54165,31709
1276,0.0,0.0,0.0,3611,22460,54165,31705
1277,0.0,0.0,0.0,3611,22464,54165,31701
1279,0.0,0.0,0.0,3611,22468,54165,31697
1281,0.0,0.0,0.0,3611,22472,54165,31693
1282,0.0,0.0,0.0,3611,22476,54165,31689
1284,0.0,0.0,0.0,3611,22480,54165,31685
1285,0.0,0.0,0.0,3611,22484,54165,31681
1288,0.0,0.0,0.0,3611,22488,54165,31677
1290,0.0,0.0,0.0,3611,22492,54165,31673
1291,0.0,0.0,0.0,3611,22496,54165,31669
1292,0.0,0.0,0.0,3611,22500,54165,31665
1293,0.0,0.0,0.0,3611,22504,54165,31661
1294,0.0,0.0,0.0,3611,22508,54165,31657
1295,0.0,0.0,0.0,3611,22512,54165,31653
1296,0.0,0.0,0.0,3611,22516,54165,31649
1297,0.0,0.0,0.0,3611,22520,54165,31645
1298,0.0,0.0,0.0,3611,22524,54165,31641
1299,0.0,0.0,0.0,3611,22528,54165,31637
1300,0.0,0.0,0.0,3611,22532,54165,31633
1301,0.0,0.0,0.0,3611,22536,54165,31629
1303,0.0,0.0,0.0,3611,22540,54165,31625
1304,0.0,0.0,0.0,3611,22544,54165,31621
1305,0.0,0.0,0.0,3611,22548,54165,31617
1306,0.0,0.0,0.0,3611,22552,54165,31613
1310,0.0,0.0,0.0,3611,22556,54165,31609
1311,0.0,0.0,0.0,3611,22560,54165,31605
1312,0.0,0.0,0.0,3611,22564,54165,31601
1313,0.0,0.0,0.0,3611,22568,54165,31597
1314,0.0,0.0,0.0,3611,22572,54165,31593
1315,0.0,0.0,0.0,3611,22576,54165,31589
1316,0.0,0.0,0.0,3611,22580,54165,31585
1317,0.0,0.0,0.0,3611,22584,54165,31581
1318,0.0,0.0,0.0,3611,22588,54165,31577
1320,0.0,0.0,0.0,3611,22592,54165,31573
1322,0.0,0.0,0.0,3611,22596,54165,31569
1323,0.0,0.0,0.0,3611,22600,54165,31565
1324,0.0,0.0,0.0,3611,22604,54165,31561
1325,0.0,0.0,0.0,3611,22608,54165,31557
1329,0.0,0.0,0.0,3611,22612,54165,31553
1331,0.0,0.0,0.0,3611,22616,54165,31549
1333,0.0,0.0,0.0,3611,22620,54165,31545
1334,0.0,0.0,0.0,3611,22624,54165,31541
1335,0.0,0.0,0.0,3611,22628,54165,31537
1337,0.0,0.0,0.0,3611,22632,54165,31533
1338,0.0,0.0,0.0,3611,22636,54165,31529
1339,0.0,0.0,0.0,3611,22640,54165,31525
1340,0.0,0.0,0.0,3611,22644,54165,31521
1341,0.0,0.0,0.0,3611,22648,54165,31517
1342,0.0,0.0,0.0,3611,22652,54165,31513
1344,0.0,0.0,0.0,3611,22656,54165,31509
1345,0.0,0.0,0.0,3611,22660,54165,31505
1346,0.0,0.0,0.0,3611,22664,54165,31501
1347,0.0,0.0,0.0,3611,22668,54165,31497
1351,0.0,0.0,0.0,3611,22672,54165,31493
1352,0.0,0.0,0.0,3611,22676,54165,31489
1353,0.0,0.0,0.0,3611,22680,54165,31485
1354,0.0,0.0,0.0,3611,22684,54165,31481
1355,0.0,0.0,0.0,3611,22688,54165,31477
1356,0.0,0.0,0.0,3611,22692,54165,31473
1357,0.0,0.0,0.0,3611,22696,54165,31469
1358,0.0,0.0,0.0,3611,22700,54165,31465
1359,0.0,0.0,0.0,3611,22704,54165,31461
1361,0.0,0.0,0.0,3611,22708,54165,31457
1362,0.0,0.0,0.0,3611,22712,54165,31453
1363,0.0,0.0,0.0,3611,22716,54165,31449
1364,0.0,0.0,0.0,3611,22720,54165,31445
1365,0.0,0.0,0.0,3611,22724,54165,31441
1367,0.0,0.0,0.0,3611,22728,54165,31437
1369,0.0,0.0,0.0,3611,22732,54165,31433
1370,0.0,0.0,0.0,3611,22736,54165,31429
1371,0.0,0.0,0.0,3611,22740,54165,31425
1372,0.0,0.0,0.0,3611,22744,54165,31421
1373,0.0,0.0,0.0,3611,22748,54165,31417
1374,0.0,0.0,0.0,3611,22752,54165,31413
1375,0.0,0.0,0.0,3611,22756,54165,31409
1376,0.0,0.0,0.0,3611,22760,54165,31405
1377,0.0,0.0,0.0,3611,22764,54165,31401
1378,0.0,0.0,0.0,3611,22768,54165,31397
1379,0.0,0.0,0.0,3611,22772,54165,31393
1380,0.0,0.0,0.0,3611,22776,54165,31389
1381,0.0,0.0,0.0,3611,22780,54165,31385
1382,0.0,0.0,0.0,3611,22784,54165,31381
1383,0.0,0.0,0.0,3611,22788,54165,31377
1384,0.0,0.0,0.0,3611,22792,54165,31373
1385,0.0,0.0,0.0,3611,22796,54165,31369
1386,0.0,0.0,0.0,3611,22800,54165,31365
1387,0.0,0.0,0.0,3611,22804,54165,31361
1388,0.0,0.0,0.0,3611,22808,54165,31357
1389,0.0,0.0,0.0,3611,22812,54165,31353
1390,0.0,0.0,0.0,3611,22816,54165,31349
1391,0.0,0.0,0.0,3611,22820,54165,31345
1392,0.0,0.0,0.0,3611,22824,54165,31341
1393,0.0,0.0,0.0,3611,22828,54165,31337
1395,0.0,0.0,0.0,3611,22832,54165,31333
1397,0.0,0.0,0.0,3611,22836,54165,31329
1398,0.0,0.0,0.0,3611,22840,54165,31325
1402,0.0,0.0,0.0,3611,22844,54165,31321
1403,0.0,0.0,0.0,3611,22848,54165,31317
1404,0.0,0.0,0.0,3611,22852,54165,31313
1405,0.0,0.0,0.0,3611,22856,54165,31309
1406,0.0,0.0,0.0,3611,22860,54165,31305
1407,0.0,0.0,0.0,3611,22864,54165,31301
1408,0.0,0.0,0.0,3611,22868,54165,31297
1409,0.0,0.0,0.0,3611,22872,54165,31293
1410,0.0,0.0,0.0,3611,22876,54165,31289
1411,0.0,0.0,0.0,3611,22880,54165,31285
1412,0.0,0.0,0.0,3611,22884,54165,31281
1413,0.0,0.0,0.0,3611,22888,54165,31277
1414,0.0,0.0,0.0,3611,22892,54165,31273
1415,0.0,0.0,0.0,3611,22896,54165,31269
1416,0.0,0.0,0.0,3611,22900,54165,31265
1418,0.0,0.0,0.0,3611,22904,54165,31261
1419,0.0,0.0,0.0,3611,22908,54165,31257
1420,0.0,0.0,0.0,3611,22912,54165,31253
1421,0.0,0.0,0.0,3611,22916,54165,31249
1422,0.0,0.0,0.0,3611,22920,54165,31245
1423,0.0,0.0,0.0,3611,22924,54165,31241
1424,0.0,0.0,0.0,3611,22928,54165,31237
1425,0.0,0.0,0.0,3611,22932,54165,31233
1428,0.0,0.0,0.0,3611,22936,54165,31229
1429,0.0,0.0,0.0,3611,22940,54165,31225
1431,0.0,0.0,0.0,3611,22944,54165,31221
1432,0.0,0.0,0.0,3611,22948,54165,31217
1433,0.0,0.0,0.0,3611,22952,54165,31213
1434,0.0,0.0,0.0,3611,22956,54165,31209
1435,0.0,0.0,0.0,3611,22960,54165,31205
1436,0.0,0.0,0.0,3611,22964,54165,31201
1437,0.0,0.0,0.0,3611,22968,54165,31197
1438,0.0,0.0,0.0,3611,22972,54165,31193
1441,0.0,0.0,0.0,3611,22976,54165,31189
1442,0.0,0.0,0.0,3611,22980,54165,31185
1443,0.0,0.0,0.0,3611,22984,54165,31181
1444,0.0,0.0,0.0,3611,22988,54165,31177
1445,0.0,0.0,0.0,3611,22992,54165,31173
1446,0.0,0.0,0.0,3611,22996,54165,31169
1448,0.0,0.0,0.0,3611,23000,54165,31165
1449,0.0,0.0,0.0,3611,23004,54165,31161
1451,0.0,0.0,0.0,3611,23008,54165,31157
1452,0.0,0.0,0.0,3611,23012,54165,31153
1453,0.0,0.0,0.0,3611,23016,54165,31149
1454,0.0,0.0,0.0,3611,23020,54165,31145
1455,0.0,0.0,0.0,3611,23024,54165,31141
1456,0.0,0.0,0.0,3611,23028,54165,31137
1457,0.0,0.0,0.0,3611,23032,54165,31133
1459,0.0,0.0,0.0,3611,23036,54165,31129
1460,0.0,0.0,0.0,3611,23040,54165,31125
1461,0.0,0.0,0.0,3611,23044,54165,31121
1462,0.0,0.0,0.0,3611,23048,54165,31117
1463,0.0,0.0,0.0,3611,23052,54165,31113
1464,0.0,0.0,0.0,3611,23056,54165,31109
1466,0.0,0.0,0.0,3611,23060,54165,31105
1467,0.0,0.0,0.0,3611,23064,54165,31101
1468,0.0,0.0,0.0,3611,23068,54165,31097
1470,0.0,0.0,0.0,3611,23072,54165,31093
1471,0.0,0.0,0.0,3611,23076,54165,31089
1472,0.0,0.0,0.0,3611,23080,54165,31085
1473,0.0,0.0,0.0,3611,23084,54165,31081
1474,0.0,0.0,0.0,3611,23088,54165,31077
1475,0.0,0.0,0.0,3611,23092,54165,31073
1476,0.0,0.0,0.0,3611,23096,54165,31069
1477,0.0,0.0,0.0,3611,23100,54165,31065
1479,0.0,0.0,0.0,3611,23104,54165,31061
1480,0.0,0.0,0.0,3611,23108,54165,31057
1481,0.0,0.0,0.0,3611,23112,54165,31053
1482,0.0,0.0,0.0,3611,23116,54165,31049
1485,0.0,0.0,0.0,3611,23120,54165,31045
1486,0.0,0.0,0.0,3611,23124,54165,31041
1487,0.0,0.0,0.0,3611,23128,54165,31037
1488,0.0,0.0,0.0,3611,23132,54165,31033
1490,0.0,0.0,0.0,3611,23136,54165,31029
1491,0.0,0.0,0.0,3611,23140,54165,31025
1492,0.0,0.0,0.0,3611,23144,54165,31021
1493,0.0,0.0,0.0,3611,23148,54165,31017
1494,0.0,0.0,0.0,3611,23152,54165,31013
1495,0.0,0.0,0.0,3611,23156,54165,31009
1496,0.0,0.0,0.0,3611,23160,54165,31005
1497,0.0,0.0,0.0,3611,23164,54165,31001
1498,0.0,0.0,0.0,3611,23168,54165,30997
1500,0.0,0.0,0.0,3611,23172,54165,30993
1501,0.0,0.0,0.0,3611,23176,54165,30989
1502,0.0,0.0,0.0,3611,23180,54165,30985
1505,0.0,0.0,0.0,3611,23184,54165,30981
1506,0.0,0.0,0.0,3611,23188,54165,30977
1507,0.0,0.0,0.0,3611,23192,54165,30973
1509,0.0,0.0,0.0,3611,23196,54165,30969
1511,0.0,0.0,0.0,3611,23200,54165,30965
1512,0.0,0.0,0.0,3611,23204,54165,30961
1513,0.0,0.0,0.0,3611,23208,54165,30957
1514,0.0,0.0,0.0,3611,23212,54165,30953
1516,0.0,0.0,0.0,3611,23216,54165,30949
1517,0.0,0.0,0.0,3611,23220,54165,30945
1518,0.0,0.0,0.0,3611,23224,54165,30941
1519,0.0,0.0,0.0,3611,23228,54165,30937
1522,0.0,0.0,0.0,3611,23232,54165,30933
1525,0.0,0.0,0.0,3611,23236,54165,30929
1526,0.0,0.0,0.0,3611,23240,54165,30925
1527,0.0,0.0,0.0,3611,23244,54165,30921
1528,0.0,0.0,0.0,3611,23248,54165,30917
1529,0.0,0.0,0.0,3611,23252,54165,30913
1530,0.0,0.0,0.0,3611,23256,54165,30909
1531,0.0,0.0,0.0,3611,23260,54165,30905
1533,0.0,0.0,0.0,3611,23264,54165,30901
1534,0.0,0.0,0.0,3611,23268,54165,30897
1535,0.0,0.0,0.0,3611,23272,54165,30893
1539,0.0,0.0,0.0,3611,23276,54165,30889
1542,0.0,0.0,0.0,3611,23280,54165,30885
1543,0.0,0.0,0.0,3611,23284,54165,30881
1544,0.0,0.0,0.0,3611,23288,54165,30877
1545,0.0,0.0,0.0,3611,23292,54165,30873
1546,0.0,0.0,0.0,3611,23296,54165,30869
1547,0.0,0.0,0.0,3611,23300,54165,30865
1548,0.0,0.0,0.0,3611,23304,54165,30861
1549,0.0,0.0,0.0,3611,23308,54165,30857
1550,0.0,0.0,0.0,3611,23312,54165,30853
1551,0.0,0.0,0.0,3611,23316,54165,30849
1552,0.0,0.0,0.0,3611,23320,54165,30845
1553,0.0,0.0,0.0,3611,23324,54165,30841
1554,0.0,0.0,0.0,3611,23328,54165,30837
1556,0.0,0.0,0.0,3611,23332,54165,30833
1557,0.0,0.0,0.0,3611,23336,54165,30829
1558,0.0,0.0,0.0,3611,23340,54165,30825
1559,0.0,0.0,0.0,3611,23344,54165,30821
1560,0.0,0.0,0.0,3611,23348,54165,30817
1561,0.0,0.0,0.0,3611,23352,54165,30813
1562,0.0,0.0,0.0,3611,23356,54165,30809
1563,0.0,0.0,0.0,3611,23360,54165,30805
1564,0.0,0.0,0.0,3611,23364,54165,30801
1565,0.0,0.0,0.0,3611,23368,54165,30797
1566,0.0,0.0,0.0,3611,23372,54165,30793
1567,0.0,0.0,0.0,3611,23376,54165,30789
1568,0.0,0.0,0.0,3611,23380,54165,30785
1569,0.0,0.0,0.0,3611,23384,54165,30781
1570,0.0,0.0,0.0,3611,23388,54165,30777
1571,0.0,0.0,0.0,3611,23392,54165,30773
1572,0.0,0.0,0.0,3611,23396,54165,30769
1573,0.0,0.0,0.0,3611,23400,54165,30765
1575,0.0,0.0,0.0,3611,23404,54165,30761
1576,0.0,0.0,0.0,3611,23408,54165,30757
1577,0.0,0.0,0.0,3611,23412,54165,30753
1579,0.0,0.0,0.0,3611,23416,54165,30749
1580,0.0,0.0,0.0,3611,23420,54165,30745
1581,0.0,0.0,0.0,3611,23424,54165,30741
1582,0.0,0.0,0.0,3611,23428,54165,30737
1585,0.0,0.0,0.0,3611,23432,54165,30733
1586,0.0,0.0,0.0,3611,23436,54165,30729
1587,0.0,0.0,0.0,3611,23440,54165,30725
1591,0.0,0.0,0.0,3611,23444,54165,30721
1592,0.0,0.0,0.0,3611,23448,54165,30717
1593,0.0,0.0,0.0,3611,23452,54165,30713
1594,0.0,0.0,0.0,3611,23456,54165,30709
1595,0.0,0.0,0.0,3611,23460,54165,30705
1597,0.0,0.0,0.0,3611,23464,54165,30701
1599,0.0,0.0,0.0,3611,23468,54165,30697
1600,0.0,0.0,0.0,3611,23472,54165,30693
1602,0.0,0.0,0.0,3611,23476,54165,30689
1603,0.0,0.0,0.0,3611,23480,54165,30685
1604,0.0,0.0,0.0,3611,23484,54165,30681
1605,0.0,0.0,0.0,3611,23488,54165,30677
1607,0.0,0.0,0.0,3611,23492,54165,30673
1609,0.0,0.0,0.0,3611,23496,54165,30669
1610,0.0,0.0,0.0,3611,23500,54165,30665
1611,0.0,0.0,0.0,3611,23504,54165,30661
1612,0.0,0.0,0.0,3611,23508,54165,30657
1613,0.0,0.0,0.0,3611,23512,54165,30653
1614,0.0,0.0,0.0,3611,23516,54165,30649
1615,0.0,0.0,0.0,3611,23520,54165,30645
1616,0.0,0.0,0.0,3611,23524,54165,30641
1619,0.0,0.0,0.0,3611,23528,54165,30637
1620,0.0,0.0,0.0,3611,23532,54165,30633
1621,0.0,0.0,0.0,3611,23536,54165,30629
1622,0.0,0.0,0.0,3611,23540,54165,30625
1623,0.0,0.0,0.0,3611,23544,54165,30621
1626,0.0,0.0,0.0,3611,23548,54165,30617
1627,0.0,0.0,0.0,3611,23552,54165,30613
1628,0.0,0.0,0.0,3611,23556,54165,30609
1629,0.0,0.0,0.0,3611,23560,54165,30605
1630,0.0,0.0,0.0,3611,23564,54165,30601
1633,0.0,0.0,0.0,3611,23568,54165,30597
1634,0.0,0.0,0.0,3611,23572,54165,30593
1638,0.0,0.0,0.0,3611,23576,54165,30589
1639,0.0,0.0,0.0,3611,23580,54165,30585
1640,0.0,0.0,0.0,3611,23584,54165,30581
1642,0.0,0.0,0.0,3611,23588,54165,30577
1643,0.0,0.0,0.0,3611,23592,54165,30573
1645,0.0,0.0,0.0,3611,23596,54165,30569
1646,0.0,0.0,0.0,3611,23600,54165,30565
1647,0.0,0.0,0.0,3611,23604,54165,30561
1648,0.0,0.0,0.0,3611,23608,54165,30557
1650,0.0,0.0,0.0,3611,23612,54165,30553
1651,0.0,0.0,0.0,3611,23616,54165,30549
1654,0.0,0.0,0.0,3611,23620,54165,30545
1655,0.0,0.0,0.0,3611,23624,54165,30541
1657,0.0,0.0,0.0,3611,23628,54165,30537
1658,0.0,0.0,0.0,3611,23632,54165,30533
1659,0.0,0.0,0.0,3611,23636,54165,30529
1661,0.0,0.0,0.0,3611,23640,54165,30525
1662,0.0,0.0,0.0,3611,23644,54165,30521
1663,0.0,0.0,0.0,3611,23648,54165,30517
1665,0.0,0.0,0.0,3611,23652,54165,30513
1666,0.0,0.0,0.0,3611,23656,54165,30509
1668,0.0,0.0,0.0,3611,23660,54165,30505
1670,0.0,0.0,0.0,3611,23664,54165,30501
1671,0.0,0.0,0.0,3611,23668,54165,30497
1672,0.0,0.0,0.0,3611,23672,54165,30493
1673,0.0,0.0,0.0,3611,23676,54165,30489
1675,0.0,0.0,0.0,3611,23680,54165,30485
1676,0.0,0.0,0.0,3611,23684,54165,30481
1677,0.0,0.0,0.0,3611,23688,54165,30477
1678,0.0,0.0,0.0,3611,23692,54165,30473
1679,0.0,0.0,0.0,3611,23696,54165,30469
1681,0.0,0.0,0.0,3611,23700,54165,30465
1683,0.0,0.0,0.0,3611,23704,54165,30461
1685,0.0,0.0,0.0,3611,23708,54165,30457
1686,0.0,0.0,0.0,3611,23712,54165,30453
1687,0.0,0.0,0.0,3611,23716,54165,30449
1688,0.0,0.0,0.0,3611,23720,54165,30445
1689,0.0,0.0,0.0,3611,23724,54165,30441
1690,0.0,0.0,0.0,3611,23728,54165,30437
1692,0.0,0.0,0.0,3611,23732,54165,30433
1693,0.0,0.0,0.0,3611,23736,54165,30429
1694,0.0,0.0,0.0,3611,23740,54165,30425
1695,0.0,0.0,0.0,3611,23744,54165,30421
1696,0.0,0.0,0.0,3611,23748,54165,30417
1697,0.0,0.0,0.0,3611,23752,54165,30413
1699,0.0,0.0,0.0,3611,23756,54165,30409
1700,0.0,0.0,0.0,3611,23760,54165,30405
1703,0.0,0.0,0.0,3611,23764,54165,30401
1705,0.0,0.0,0.0,3611,23768,54165,30397
1706,0.0,0.0,0.0,3611,23772,54165,30393
1707,0.0,0.0,0.0,3611,23776,54165,30389
1708,0.0,0.0,0.0,3611,23780,54165,30385
1709,0.0,0.0,0.0,3611,23784,54165,30381
1710,0.0,0.0,0.0,3611,23788,54165,30377
1711,0.0,0.0,0.0,3611,23792,54165,30373
1712,0.0,0.0,0.0,3611,23796,54165,30369
1713,0.0,0.0,0.0,3611,23800,54165,30365
1714,0.0,0.0,0.0,3611,23804,54165,30361
1716,0.0,0.0,0.0,3611,23808,54165,30357
1717,0.0,0.0,0.0,3611,23812,54165,30353
1718,0.0,0.0,0.0,3611,23816,54165,30349
1719,0.0,0.0,0.0,3611,23820,54165,30345
1720,0.0,0.0,0.0,3611,23824,54165,30341
1721,0.0,0.0,0.0,3611,23828,54165,30337
1722,0.0,0.0,0.0,3611,23832,54165,30333
1724,0.0,0.0,0.0,3611,23836,54165,30329
1725,0.0,0.0,0.0,3611,23840,54165,30325
1726,0.0,0.0,0.0,3611,23844,54165,30321
1727,0.0,0.0,0.0,3611,23848,54165,30317
1728,0.0,0.0,0.0,3611,23852,54165,30313
1730,0.0,0.0,0.0,3611,23856,54165,30309
1731,0.0,0.0,0.0,3611,23860,54165,30305
1732,0.0,0.0,0.0,3611,23864,54165,30301
1733,0.0,0.0,0.0,3611,23868,54165,30297
1735,0.0,0.0,0.0,3611,23872,54165,30293
1737,0.0,0.0,0.0,3611,23876,54165,30289
1739,0.0,0.0,0.0,3611,23880,54165,30285
1740,0.0,0.0,0.0,3611,23884,54165,30281
1741,0.0,0.0,0.0,3611,23888,54165,30277
1742,0.0,0.0,0.0,3611,23892,54165,30273
1743,0.0,0.0,0.0,3611,23896,54165,30269
1744,0.0,0.0,0.0,3611,23900,54165,30265
1745,0.0,0.0,0.0,3611,23904,54165,30261
1746,0.0,0.0,0.0,3611,23908,54165,30257
1747,0.0,0.0,0.0,3611,23912,54165,30253
1748,0.0,0.0,0.0,3611,23916,54165,30249
1749,0.0,0.0,0.0,3611,23920,54165,30245
1750,0.0,0.0,0.0,3611,23924,54165,30241
1751,0.0,0.0,0.0,3611,23928,54165,30237
1752,0.0,0.0,0.0,3611,23932,54165,30233
1753,0.0,0.0,0.0,3611,23936,54165,30229
1754,0.0,0.0,0.0,3611,23940,54165,30225
1755,0.0,0.0,0.0,3611,23944,54165,30221
1756,0.0,0.0,0.0,3611,23948,54165,30217
1758,0.0,0.0,0.0,3611,23952,54165,30213
1759,0.0,0.0,0.0,3611,23956,54165,30209
1760,0.0,0.0,0.0,3611,23960,54165,30205
1761,0.0,0.0,0.0,3611,23964,54165,30201
1762,0.0,0.0,0.0,3611,23968,54165,30197
1766,0.0,0.0,0.0,3611,23972,54165,30193
1769,0.0,0.0,0.0,3611,23976,54165,30189
1770,0.0,0.0,0.0,3611,23980,54165,30185
1771,0.0,0.0,0.0,3611,23984,54165,30181
1772,0.0,0.0,0.0,3611,23988,54165,30177
1773,0.0,0.0,0.0,3611,23992,54165,30173
1775,0.0,0.0,0.0,3611,23996,54165,30169
1776,0.0,0.0,0.0,3611,24000,54165,30165
1777,0.0,0.0,0.0,3611,24004,54165,30161
1778,0.0,0.0,0.0,3611,24008,54165,30157
1779,0.0,0.0,0.0,3611,24012,54165,30153
1780,0.0,0.0,0.0,3611,24016,54165,30149
1781,0.0,0.0,0.0,3611,24020,54165,30145
1783,0.0,0.0,0.0,3611,24024,54165,30141
1784,0.0,0.0,0.0,3611,24028,54165,30137
1785,0.0,0.0,0.0,3611,24032,54165,30133
1786,0.0,0.0,0.0,3611,24036,54165,30129
1788,0.0,0.0,0.0,3611,24040,54165,30125
1789,0.0,0.0,0.0,3611,24044,54165,30121
1792,0.0,0.0,0.0,3611,24048,54165,30117
1793,0.0,0.0,0.0,3611,24052,54165,30113
1794,0.0,0.0,0.0,3611,24056,54165,30109
1795,0.0,0.0,0.0,3611,24060,54165,30105
1796,0.0,0.0,0.0,3611,24064,54165,30101
1797,0.0,0.0,0.0,3611,24068,54165,30097
1801,0.0,0.0,0.0,3611,24072,54165,30093
1803,0.0,0.0,0.0,3611,24076,54165,30089
1804,0.0,0.0,0.0,3611,24080,54165,30085
1805,0.0,0.0,0.0,3611,24084,54165,30081
1806,0.0,0.0,0.0,3611,24088,54165,30077
1807,0.0,0.0,0.0,3611,24092,54165,30073
1808,0.0,0.0,0.0,3611,24096,54165,30069
1809,0.0,0.0,0.0,3611,24100,54165,30065
1810,0.0,0.0,0.0,3611,24104,54165,30061
1811,0.0,0.0,0.0,3611,24108,54165,30057
1812,0.0,0.0,0.0,3611,24112,54165,30053
1814,0.0,0.0,0.0,3611,24116,54165,30049
1815,0.0,0.0,0.0,3611,24120,54165,30045
1816,0.0,0.0,0.0,3611,24124,54165,30041
1817,0.0,0.0,0.0,3611,24128,54165,30037
1818,0.0,0.0,0.0,3611,24132,54165,30033
1819,0.0,0.0,0.0,3611,24136,54165,30029
1820,0.0,0.0,0.0,3611,24140,54165,30025
1821,0.0,0.0,0.0,3611,24144,54165,30021
1823,0.0,0.0,0.0,3611,24148,54165,30017
1824,0.0,0.0,0.0,3611,24152,54165,30013
1826,0.0,0.0,0.0,3611,24156,54165,30009
1827,0.0,0.0,0.0,3611,24160,54165,30005
1828,0.0,0.0,0.0,3611,24164,54165,30001
1830,0.0,0.0,0.0,3611,24168,54165,29997
1832,0.0,0.0,0.0,3611,24172,54165,29993
1833,0.0,0.0,0.0,3611,24176,54165,29989
1834,0.0,0.0,0.0,3611,24180,54165,29985
1836,0.0,0.0,0.0,3611,24184,54165,29981
1837,0.0,0.0,0.0,3611,24188,54165,29977
1838,0.0,0.0,0.0,3611,24192,54165,29973
1839,0.0,0.0,0.0,3611,24196,54165,29969
1840,0.0,0.0,0.0,3611,24200,54165,29965
1841,0.0,0.0,0.0,3611,24204,54165,29961
1842,0.0,0.0,0.0,3611,24208,54165,29957
1843,0.0,0.0,0.0,3611,24212,54165,29953
1844,0.0,0.0,0.0,3611,24216,54165,29949
1846,0.0,0.0,0.0,3611,24220,54165,29945
1847,0.0,0.0,0.0,3611,24224,54165,29941
1850,0.0,0.0,0.0,3611,24228,54165,29937
1851,0.0,0.0,0.0,3611,24232,54165,29933
1852,0.0,0.0,0.0,3611,24236,54165,29929
1853,0.0,0.0,0.0,3611,24240,54165,29925
1854,0.0,0.0,0.0,3611,24244,54165,29921
1855,0.0,0.0,0.0,3611,24248,54165,29917
1856,0.0,0.0,0.0,3611,24252,54165,29913
1857,0.0,0.0,0.0,3611,24256,54165,29909
1858,0.0,0.0,0.0,3611,24260,54165,29905
1859,0.0,0.0,0.0,3611,24264,54165,29901
1860,0.0,0.0,0.0,3611,24268,54165,29897
1861,0.0,0.0,0.0,3611,24272,54165,29893
1862,0.0,0.0,0.0,3611,24276,54165,29889
1863,0.0,0.0,0.0,3611,24280,54165,29885
1864,0.0,0.0,0.0,3611,24284,54165,29881
1865,0.0,0.0,0.0,3611,24288,54165,29877
1867,0.0,0.0,0.0,3611,24292,54165,29873
1868,0.0,0.0,0.0,3611,24296,54165,29869
1869,0.0,0.0,0.0,3611,24300,54165,29865
1871,0.0,0.0,0.0,3611,24304,54165,29861
1873,0.0,0.0,0.0,3611,24308,54165,29857
1874,0.0,0.0,0.0,3611,24312,54165,29853
1875,0.0,0.0,0.0,3611,24316,54165,29849
1876,0.0,0.0,0.0,3611,24320,54165,29845
1877,0.0,0.0,0.0,3611,24324,54165,29841
1878,0.0,0.0,0.0,3611,24328,54165,29837
1879,0.0,0.0,0.0,3611,24332,54165,29833
1881,0.0,0.0,0.0,3611,24336,54165,29829
1883,0.0,0.0,0.0,3611,24340,54165,29825
1885,0.0,0.0,0.0,3611,24344,54165,29821
1887,0.0,0.0,0.0,3611,24348,54165,29817
1888,0.0,0.0,0.0,3611,24352,54165,29813
1889,0.0,0.0,0.0,3611,24356,54165,29809
1890,0.0,0.0,0.0,3611,24360,54165,29805
1891,0.0,0.0,0.0,3611,24364,54165,29801
1894,0.0,0.0,0.0,3611,24368,54165,29797
1895,0.0,0.0,0.0,3611,24372,54165,29793
1896,0.0,0.0,0.0,3611,24376,54165,29789
1897,0.0,0.0,0.0,3611,24380,54165,29785
1898,0.0,0.0,0.0,3611,24384,54165,29781
1899,0.0,0.0,0.0,3611,24388,54165,29777
1901,0.0,0.0,0.0,3611,24392,54165,29773
1903,0.0,0.0,0.0,3611,24396,54165,29769
1904,0.0,0.0,0.0,3611,24400,54165,29765
1908,0.0,0.0,0.0,3611,24404,54165,29761
1910,0.0,0.0,0.0,3611,24408,54165,29757
1911,0.0,0.0,0.0,3611,24412,54165,29753
1912,0.0,0.0,0.0,3611,24416,54165,29749
1913,0.0,0.0,0.0,3611,24420,54165,29745
1915,0.0,0.0,0.0,3611,24424,54165,29741
1916,0.0,0.0,0.0,3611,24428,54165,29737
1917,0.0,0.0,0.0,3611,24432,54165,29733
1919,0.0,0.0,0.0,3611,24436,54165,29729
1920,0.0,0.0,0.0,3611,24440,54165,29725
1921,0.0,0.0,0.0,3611,24444,54165,29721
1922,0.0,0.0,0.0,3611,24448,54165,29717
1923,0.0,0.0,0.0,3611,24452,54165,29713
1925,0.0,0.0,0.0,3611,24456,54165,29709
1927,0.0,0.0,0.0,3611,24460,54165,29705
1929,0.0,0.0,0.0,3611,24464,54165,29701
1931,0.0,0.0,0.0,3611,24468,54165,29697
1933,0.0,0.0,0.0,3611,24472,54165,29693
1934,0.0,0.0,0.0,3611,24476,54165,29689
1935,0.0,0.0,0.0,3611,24480,54165,29685
1936,0.0,0.0,0.0,3611,24484,54165,29681
1937,0.0,0.0,0.0,3611,24488,54165,29677
1938,0.0,0.0,0.0,3611,24492,54165,29673
1939,0.0,0.0,0.0,3611,24496,54165,29669
1940,0.0,0.0,0.0,3611,24500,54165,29665
1941,0.0,0.0,0.0,3611,24504,54165,29661
1943,0.0,0.0,0.0,3611,24508,54165,29657
1945,0.0,0.0,0.0,3611,24512,54165,29653
1946,0.0,0.0,0.0,3611,24516,54165,29649
1947,0.0,0.0,0.0,3611,24520,54165,29645
1948,0.0,0.0,0.0,3611,24524,54165,29641
1950,0.0,0.0,0.0,3611,24528,54165,29637
1951,0.0,0.0,0.0,3611,24532,54165,29633
1954,0.0,0.0,0.0,3611,24536,54165,29629
1957,0.0,0.0,0.0,3611,24540,54165,29625
1958,0.0,0.0,0.0,3611,24544,54165,29621
1959,0.0,0.0,0.0,3611,24548,54165,29617
1960,0.0,0.0,0.0,3611,24552,54165,29613
1961,0.0,0.0,0.0,3611,24556,54165,29609
1963,0.0,0.0,0.0,3611,24560,54165,29605
1965,0.0,0.0,0.0,3611,24564,54165,29601
1967,0.0,0.0,0.0,3611,24568,54165,29597
1968,0.0,0.0,0.0,3611,24572,54165,29593
1969,0.0,0.0,0.0,3611,24576,54165,29589
1970,0.0,0.0,0.0,3611,24580,54165,29585
1971,0.0,0.0,0.0,3611,24584,54165,29581
1972,0.0,0.0,0.0,3611,24588,54165,29577
1974,0.0,0.0,0.0,3611,24592,54165,29573
1976,0.0,0.0,0.0,3611,24596,54165,29569
1979,0.0,0.0,0.0,3611,24600,54165,29565
1980,0.0,0.0,0.0,3611,24604,54165,29561
1981,0.0,0.0,0.0,3611,24608,54165,29557
1982,0.0,0.0,0.0,3611,24612,54165,29553
1983,0.0,0.0,0.0,3611,24616,54165,29549
1984,0.0,0.0,0.0,3611,24620,54165,29545
1986,0.0,0.0,0.0,3611,24624,54165,29541
1987,0.0,0.0,0.0,3611,24628,54165,29537
1990,0.0,0.0,0.0,3611,24632,54165,29533
1991,0.0,0.0,0.0,3611,24636,54165,29529
1992,0.0,0.0,0.0,3611,24640,54165,29525
1993,0.0,0.0,0.0,3611,24644,54165,29521
1994,0.0,0.0,0.0,3611,24648,54165,29517
1995,0.0,0.0,0.0,3611,24652,54165,29513
1996,0.0,0.0,0.0,3611,24656,54165,29509
1999,0.0,0.0,0.0,3611,24660,54165,29505
2000,0.0,0.0,0.0,3611,24664,54165,29501
2001,0.0,0.0,0.0,3611,24668,54165,29497
2002,0.0,0.0,0.0,3611,24672,54165,29493
2003,0.0,0.0,0.0,3611,24676,54165,29489
2004,0.0,0.0,0.0,3611,24680,54165,29485
2005,0.0,0.0,0.0,3611,24684,54165,29481
2006,0.0,0.0,0.0,3611,24688,54165,29477
2009,0.0,0.0,0.0,3611,24692,54165,29473
2010,0.0,0.0,0.0,3611,24696,54165,29469
2011,0.0,0.0,0.0,3611,24700,54165,29465
2013,0.0,0.0,0.0,3611,24704,54165,29461
2014,0.0,0.0,0.0,3611,24708,54165,29457
2015,0.0,0.0,0.0,3611,24712,54165,29453
2016,0.0,0.0,0.0,3611,24716,54165,29449
2017,0.0,0.0,0.0,3611,24720,54165,29445
2019,0.0,0.0,0.0,3611,24724,54165,29441
2020,0.0,0.0,0.0,3611,24728,54165,29437
2021,0.0,0.0,0.0,3611,24732,54165,29433
2022,0.0,0.0,0.0,3611,24736,54165,29429
2023,0.0,0.0,0.0,3611,24740,54165,29425
2024,0.0,0.0,0.0,3611,24744,54165,29421
2025,0.0,0.0,0.0,3611,24748,54165,29417
2027,0.0,0.0,0.0,3611,24752,54165,29413
2028,0.0,0.0,0.0,3611,24756,54165,29409
2029,0.0,0.0,0.0,3611,24760,54165,29405
2031,0.0,0.0,0.0,3611,24764,54165,29401
2032,0.0,0.0,0.0,3611,24768,54165,29397
2034,0.0,0.0,0.0,3611,24772,54165,29393
2036,0.0,0.0,0.0,3611,24776,54165,29389
2038,0.0,0.0,0.0,3611,24780,54165,29385
2039,0.0,0.0,0.0,3611,24784,54165,29381
2040,0.0,0.0,0.0,3611,24788,54165,29377
2041,0.0,0.0,0.0,3611,24792,54165,29373
2042,0.0,0.0,0.0,3611,24796,54165,29369
2043,0.0,0.0,0.0,3611,24800,54165,29365
2044,0.0,0.0,0.0,3611,24804,54165,29361
2045,0.0,0.0,0.0,3611,24808,54165,29357
2046,0.0,0.0,0.0,3611,24812,54165,29353
2047,0.0,0.0,0.0,3611,24816,54165,29349
2048,0.0,0.0,0.0,3611,24820,54165,29345
2049,0.0,0.0,0.0,3611,24824,54165,29341
2050,0.0,0.0,0.0,3611,24828,54165,29337
2051,0.0,0.0,0.0,3611,24832,54165,29333
2053,0.0,0.0,0.0,3611,24836,54165,29329
2054,0.0,0.0,0.0,3611,24840,54165,29325
2056,0.0,0.0,0.0,3611,24844,54165,29321
2057,0.0,0.0,0.0,3611,24848,54165,29317
2059,0.0,0.0,0.0,3611,24852,54165,29313
2060,0.0,0.0,0.0,3611,24856,54165,29309
2061,0.0,0.0,0.0,3611,24860,54165,29305
2062,0.0,0.0,0.0,3611,24864,54165,29301
2063,0.0,0.0,0.0,3611,24868,54165,29297
2064,0.0,0.0,0.0,3611,24872,54165,29293
2065,0.0,0.0,0.0,3611,24876,54165,29289
2066,0.0,0.0,0.0,3611,24880,54165,29285
2067,0.0,0.0,0.0,3611,24884,54165,29281
2070,0.0,0.0,0.0,3611,24888,54165,29277
2071,0.0,0.0,0.0,3611,24892,54165,29273
2072,0.0,0.0,0.0,3611,24896,54165,29269
2075,0.0,0.0,0.0,3611,24900,54165,29265
2076,0.0,0.0,0.0,3611,24904,54165,29261
2077,0.0,0.0,0.0,3611,24908,54165,29257
2078,0.0,0.0,0.0,3611,24912,54165,29253
2079,0.0,0.0,0.0,3611,24916,54165,29249
2080,0.0,0.0,0.0,3611,24920,54165,29245
2081,0.0,0.0,0.0,3611,24924,54165,29241
2082,0.0,0.0,0.0,3611,24928,54165,29237
2084,0.0,0.0,0.0,3611,24932,54165,29233
2085,0.0,0.0,0.0,3611,24936,54165,29229
2086,0.0,0.0,0.0,3611,24940,54165,29225
2087,0.0,0.0,0.0,3611,24944,54165,29221
2088,0.0,0.0,0.0,3611,24948,54165,29217
2089,0.0,0.0,0.0,3611,24952,54165,29213
2090,0.0,0.0,0.0,3611,24956,54165,29209
2092,0.0,0.0,0.0,3611,24960,54165,29205
2093,0.0,0.0,0.0,3611,24964,54165,29201
2094,0.0,0.0,0.0,3611,24968,54165,29197
2096,0.0,0.0,0.0,3611,24972,54165,29193
2097,0.0,0.0,0.0,3611,24976,54165,29189
2098,0.0,0.0,0.0,3611,24980,54165,29185
2099,0.0,0.0,0.0,3611,24984,54165,29181
2100,0.0,0.0,0.0,3611,24988,54165,29177
2101,0.0,0.0,0.0,3611,24992,54165,29173
2103,0.0,0.0,0.0,3611,24996,54165,29169
2104,0.0,0.0,0.0,3611,25000,54165,29165
2105,0.0,0.0,0.0,3611,25004,54165,29161
2106,0.0,0.0,0.0,3611,25008,54165,29157
2107,0.0,0.0,0.0,3611,25012,54165,29153
2109,0.0,0.0,0.0,3611,25016,54165,29149
2110,0.0,0.0,0.0,3611,25020,54165,29145
2111,0.0,0.0,0.0,3611,25024,54165,29141
2112,0.0,0.0,0.0,3611,25028,54165,29137
2113,0.0,0.0,0.0,3611,25032,54165,29133
2114,0.0,0.0,0.0,3611,25036,54165,29129
2115,0.0,0.0,0.0,3611,25040,54165,29125
2117,0.0,0.0,0.0,3611,25044,54165,29121
2118,0.0,0.0,0.0,3611,25048,54165,29117
2119,0.0,0.0,0.0,3611,25052,54165,29113
2120,0.0,0.0,0.0,3611,25056,54165,29109
2121,0.0,0.0,0.0,3611,25060,54165,29105
2122,0.0,0.0,0.0,3611,25064,54165,29101
2123,0.0,0.0,0.0,3611,25068,54165,29097
2124,0.0,0.0,0.0,3611,25072,54165,29093
2125,0.0,0.0,0.0,3611,25076,54165,29089
2126,0.0,0.0,0.0,3611,25080,54165,29085
2127,0.0,0.0,0.0,3611,25084,54165,29081
2128,0.0,0.0,0.0,3611,25088,54165,29077
2129,0.0,0.0,0.0,3611,25092,54165,29073
2131,0.0,0.0,0.0,3611,25096,54165,29069
2132,0.0,0.0,0.0,3611,25100,54165,29065
2133,0.0,0.0,0.0,3611,25104,54165,29061
2134,0.0,0.0,0.0,3611,25108,54165,29057
2135,0.0,0.0,0.0,3611,25112,54165,29053
2136,0.0,0.0,0.0,3611,25116,54165,29049
2137,0.0,0.0,0.0,3611,25120,54165,29045
2139,0.0,0.0,0.0,3611,25124,54165,29041
2140,0.0,0.0,0.0,3611,25128,54165,29037
2141,0.0,0.0,0.0,3611,25132,54165,29033
2142,0.0,0.0,0.0,3611,25136,54165,29029
2143,0.0,0.0,0.0,3611,25140,54165,29025
2144,0.0,0.0,0.0,3611,25144,54165,29021
2145,0.0,0.0,0.0,3611,25148,54165,29017
2146,0.0,0.0,0.0,3611,25152,54165,29013
2148,0.0,0.0,0.0,3611,25156,54165,29009
2149,0.0,0.0,0.0,3611,25160,54165,29005
2150,0.0,0.0,0.0,3611,25164,54165,29001
2151,0.0,0.0,0.0,3611,25168,54165,28997
2154,0.0,0.0,0.0,3611,25172,54165,28993
2155,0.0,0.0,0.0,3611,25176,54165,28989
2156,0.0,0.0,0.0,3611,25180,54165,28985
2157,0.0,0.0,0.0,3611,25184,54165,28981
2159,0.0,0.0,0.0,3611,25188,54165,28977
2161,0.0,0.0,0.0,3611,25192,54165,28973
2162,0.0,0.0,0.0,3611,25196,54165,28969
2163,0.0,0.0,0.0,3611,25200,54165,28965
2164,0.0,0.0,0.0,3611,25204,54165,28961
2165,0.0,0.0,0.0,3611,25208,54165,28957
2168,0.0,0.0,0.0,3611,25212,54165,28953
2169,0.0,0.0,0.0,3611,25216,54165,28949
2170,0.0,0.0,0.0,3611,25220,54165,28945
2172,0.0,0.0,0.0,3611,25224,54165,28941
2173,0.0,0.0,0.0,3611,25228,54165,28937
2174,0.0,0.0,0.0,3611,25232,54165,28933
2177,0.0,0.0,0.0,3611,25236,54165,28929
2180,0.0,0.0,0.0,3611,25240,54165,28925
2183,0.0,0.0,0.0,3611,25244,54165,28921
2184,0.0,0.0,0.0,3611,25248,54165,28917
2186,0.0,0.0,0.0,3611,25252,54165,28913
2187,0.0,0.0,0.0,3611,25256,54165,28909
2189,0.0,0.0,0.0,3611,25260,54165,28905
2190,0.0,0.0,0.0,3611,25264,54165,28901
2191,0.0,0.0,0.0,3611,25268,54165,28897
2192,0.0,0.0,0.0,3611,25272,54165,28893
2193,0.0,0.0,0.0,3611,25276,54165,28889
2194,0.0,0.0,0.0,3611,25280,54165,28885
2195,0.0,0.0,0.0,3611,25284,54165,28881
2196,0.0,0.0,0.0,3611,25288,54165,28877
2198,0.0,0.0,0.0,3611,25292,54165,28873
2199,0.0,0.0,0.0,3611,25296,54165,28869
2201,0.0,0.0,0.0,3611,25300,54165,28865
2202,0.0,0.0,0.0,3611,25304,54165,28861
2203,0.0,0.0,0.0,3611,25308,54165,28857
2205,0.0,0.0,0.0,3611,25312,54165,28853
2206,0.0,0.0,0.0,3611,25316,54165,28849
2207,0.0,0.0,0.0,3611,25320,54165,28845
2208,0.0,0.0,0.0,3611,25324,54165,28841
2211,0.0,0.0,0.0,3611,25328,54165,28837
2212,0.0,0.0,0.0,3611,25332,54165,28833
2213,0.0,0.0,0.0,3611,25336,54165,28829
2214,0.0,0.0,0.0,3611,25340,54165,28825
2217,0.0,0.0,0.0,3611,25344,54165,28821
2220,0.0,0.0,0.0,3611,25348,54165,28817
2221,0.0,0.0,0.0,3611,25352,54165,28813
2223,0.0,0.0,0.0,3611,25356,54165,28809
2224,0.0,0.0,0.0,3611,25360,54165,28805
2225,0.0,0.0,0.0,3611,25364,54165,28801
2227,0.0,0.0,0.0,3611,25368,54165,28797
2228,0.0,0.0,0.0,3611,25372,54165,28793
2230,0.0,0.0,0.0,3611,25376,54165,28789
2234,0.0,0.0,0.0,3611,25380,54165,28785
2236,0.0,0.0,0.0,3611,25384,54165,28781
2238,0.0,0.0,0.0,3611,25388,54165,28777
2239,0.0,0.0,0.0,3611,25392,54165,28773
2241,0.0,0.0,0.0,3611,25396,54165,28769
2242,0.0,0.0,0.0,3611,25400,54165,28765
2243,0.0,0.0,0.0,3611,25404,54165,28761
2244,0.0,0.0,0.0,3611,25408,54165,28757
2246,0.0,0.0,0.0,3611,25412,54165,28753
2248,0.0,0.0,0.0,3611,25416,54165,28749
2252,0.0,0.0,0.0,3611,25420,54165,28745
2253,0.0,0.0,0.0,3611,25424,54165,28741
2254,0.0,0.0,0.0,3611,25428,54165,28737
2256,0.0,0.0,0.0,3611,25432,54165,28733
2257,0.0,0.0,0.0,3611,25436,54165,28729
2259,0.0,0.0,0.0,3611,25440,54165,28725
2260,0.0,0.0,0.0,3611,25444,54165,28721
2262,0.0,0.0,0.0,3611,25448,54165,28717
2264,0.0,0.0,0.0,3611,25452,54165,28713
2265,0.0,0.0,0.0,3611,25456,54165,28709
2266,0.0,0.0,0.0,3611,25460,54165,28705
2267,0.0,0.0,0.0,3611,25464,54165,28701
2268,0.0,0.0,0.0,3611,25468,54165,28697
2270,0.0,0.0,0.0,3611,25472,54165,28693
2271,0.0,0.0,0.0,3611,25476,54165,28689
2272,0.0,0.0,0.0,3611,25480,54165,28685
2273,0.0,0.0,0.0,3611,25484,54165,28681
2274,0.0,0.0,0.0,3611,25488,54165,28677
2276,0.0,0.0,0.0,3611,25492,54165,28673
2278,0.0,0.0,0.0,3611,25496,54165,28669
2279,0.0,0.0,0.0,3611,25500,54165,28665
2280,0.0,0.0,0.0,3611,25504,54165,28661
2282,0.0,0.0,0.0,3611,25508,54165,28657
2283,0.0,0.0,0.0,3611,25512,54165,28653
2284,0.0,0.0,0.0,3611,25516,54165,28649
2285,0.0,0.0,0.0,3611,25520,54165,28645
2286,0.0,0.0,0.0,3611,25524,54165,28641
2287,0.0,0.0,0.0,3611,25528,54165,28637
2288,0.0,0.0,0.0,3611,25532,54165,28633
2289,0.0,0.0,0.0,3611,25536,54165,28629
2290,0.0,0.0,0.0,3611,25540,54165,28625
2291,0.0,0.0,0.0,3611,25544,54165,28621
2294,0.0,0.0,0.0,3611,25548,54165,28617
2295,0.0,0.0,0.0,3611,25552,54165,28613
2296,0.0,0.0,0.0,3611,25556,54165,28609
2297,0.0,0.0,0.0,3611,25560,54165,28605
2298,0.0,0.0,0.0,3611,25564,54165,28601
2299,0.0,0.0,0.0,3611,25568,54165,28597
2300,0.0,0.0,0.0,3611,25572,54165,28593
2301,0.0,0.0,0.0,3611,25576,54165,28589
2302,0.0,0.0,0.0,3611,25580,54165,28585
2303,0.0,0.0,0.0,3611,25584,54165,28581
2304,0.0,0.0,0.0,3611,25588,54165,28577
2306,0.0,0.0,0.0,3611,25592,54165,28573
2307,0.0,0.0,0.0,3611,25596,54165,28569
2308,0.0,0.0,0.0,3611,25600,54165,28565
2309,0.0,0.0,0.0,3611,25604,54165,28561
2310,0.0,0.0,0.0,3611,25608,54165,28557
2312,0.0,0.0,0.0,3611,25612,54165,28553
2314,0.0,0.0,0.0,3611,25616,54165,28549
2315,0.0,0.0,0.0,3611,25620,54165,28545
2316,0.0,0.0,0.0,3611,25624,54165,28541
2317,0.0,0.0,0.0,3611,25628,54165,28537
2318,0.0,0.0,0.0,3611,25632,54165,28533
2319,0.0,0.0,0.0,3611,25636,54165,28529
2320,0.0,0.0,0.0,3611,25640,54165,28525
2321,0.0,0.0,0.0,3611,25644,54165,28521
2322,0.0,0.0,0.0,3611,25648,54165,28517
2323,0.0,0.0,0.0,3611,25652,54165,28513
2324,0.0,0.0,0.0,3611,25656,54165,28509
2325,0.0,0.0,0.0,3611,25660,54165,28505
2326,0.0,0.0,0.0,3611,25664,54165,28501
2328,0.0,0.0,0.0,3611,25668,54165,28497
2329,0.0,0.0,0.0,3611,25672,54165,28493
2331,0.0,0.0,0.0,3611,25676,54165,28489
2335,0.0,0.0,0.0,3611,25680,54165,28485
2337,0.0,0.0,0.0,3611,25684,54165,28481
2339,0.0,0.0,0.0,3611,25688,54165,28477
2340,0.0,0.0,0.0,3611,25692,54165,28473
2341,0.0,0.0,0.0,3611,25696,54165,28469
2342,0.0,0.0,0.0,3611,25700,54165,28465
2343,0.0,0.0,0.0,3611,25704,54165,28461
2344,0.0,0.0,0.0,3611,25708,54165,28457
2345,0.0,0.0,0.0,3611,25712,54165,28453
2346,0.0,0.0,0.0,3611,25716,54165,28449
2347,0.0,0.0,0.0,3611,25720,54165,28445
2348,0.0,0.0,0.0,3611,25724,54165,28441
2349,0.0,0.0,0.0,3611,25728,54165,28437
2350,0.0,0.0,0.0,3611,25732,54165,28433
2351,0.0,0.0,0.0,3611,25736,54165,28429
2352,0.0,0.0,0.0,3611,25740,54165,28425
2353,0.0,0.0,0.0,3611,25744,54165,28421
2356,0.0,0.0,0.0,3611,25748,54165,28417
2357,0.0,0.0,0.0,3611,25752,54165,28413
2358,0.0,0.0,0.0,3611,25756,54165,28409
2360,0.0,0.0,0.0,3611,25760,54165,28405
2363,0.0,0.0,0.0,3611,25764,54165,28401
2364,0.0,0.0,0.0,3611,25768,54165,28397
2365,0.0,0.0,0.0,3611,25772,54165,28393
2366,0.0,0.0,0.0,3611,25776,54165,28389
2367,0.0,0.0,0.0,3611,25780,54165,28385
2368,0.0,0.0,0.0,3611,25784,54165,28381
2369,0.0,0.0,0.0,3611,25788,54165,28377
2370,0.0,0.0,0.0,3611,25792,54165,28373
2371,0.0,0.0,0.0,3611,25796,54165,28369
2372,0.0,0.0,0.0,3611,25800,54165,28365
2373,0.0,0.0,0.0,3611,25804,54165,28361
2374,0.0,0.0,0.0,3611,25808,54165,28357
2375,0.0,0.0,0.0,3611,25812,54165,28353
2377,0.0,0.0,0.0,3611,25816,54165,28349
2378,0.0,0.0,0.0,3611,25820,54165,28345
2379,0.0,0.0,0.0,3611,25824,54165,28341
2380,0.0,0.0,0.0,3611,25828,54165,28337
2381,0.0,0.0,0.0,3611,25832,54165,28333
2382,0.0,0.0,0.0,3611,25836,54165,28329
2383,0.0,0.0,0.0,3611,25840,54165,28325
2384,0.0,0.0,0.0,3611,25844,54165,28321
2385,0.0,0.0,0.0,3611,25848,54165,28317
2386,0.0,0.0,0.0,3611,25852,54165,28313
2387,0.0,0.0,0.0,3611,25856,54165,28309
2388,0.0,0.0,0.0,3611,25860,54165,28305
2389,0.0,0.0,0.0,3611,25864,54165,28301
2390,0.0,0.0,0.0,3611,25868,54165,28297
2391,0.0,0.0,0.0,3611,25872,54165,28293
2394,0.0,0.0,0.0,3611,25876,54165,28289
2395,0.0,0.0,0.0,3611,25880,54165,28285
2396,0.0,0.0,0.0,3611,25884,54165,28281
2397,0.0,0.0,0.0,3611,25888,54165,28277
2398,0.0,0.0,0.0,3611,25892,54165,28273
2399,0.0,0.0,0.0,3611,25896,54165,28269
2400,0.0,0.0,0.0,3611,25900,54165,28265
2401,0.0,0.0,0.0,3611,25904,54165,28261
2402,0.0,0.0,0.0,3611,25908,54165,28257
2403,0.0,0.0,0.0,3611,25912,54165,28253
2404,0.0,0.0,0.0,3611,25916,54165,28249
2405,0.0,0.0,0.0,3611,25920,54165,28245
2407,0.0,0.0,0.0,3611,25924,54165,28241
2408,0.0,0.0,0.0,3611,25928,54165,28237
2409,0.0,0.0,0.0,3611,25932,54165,28233
2410,0.0,0.0,0.0,3611,25936,54165,28229
2411,0.0,0.0,0.0,3611,25940,54165,28225
2413,0.0,0.0,0.0,3611,25944,54165,28221
2414,0.0,0.0,0.0,3611,25948,54165,28217
2415,0.0,0.0,0.0,3611,25952,54165,28213
2416,0.0,0.0,0.0,3611,25956,54165,28209
2419,0.0,0.0,0.0,3611,25960,54165,28205
2420,0.0,0.0,0.0,3611,25964,54165,28201
2422,0.0,0.0,0.0,3611,25968,54165,28197
2424,0.0,0.0,0.0,3611,25972,54165,28193
2425,0.0,0.0,0.0,3611,25976,54165,28189
2426,0.0,0.0,0.0,3611,25980,54165,28185
2428,0.0,0.0,0.0,3611,25984,54165,28181
2429,0.0,0.0,0.0,3611,25988,54165,28177
2430,0.0,0.0,0.0,3611,25992,54165,28173
2431,0.0,0.0,0.0,3611,25996,54165,28169
2432,0.0,0.0,0.0,3611,26000,54165,28165
2434,0.0,0.0,0.0,3611,26004,54165,28161
2436,0.0,0.0,0.0,3611,26008,54165,28157
2437,0.0,0.0,0.0,3611,26012,54165,28153
2438,0.0,0.0,0.0,3611,26016,54165,28149
2439,0.0,0.0,0.0,3611,26020,54165,28145
2440,0.0,0.0,0.0,3611,26024,54165,28141
2442,0.0,0.0,0.0,3611,26028,54165,28137
2443,0.0,0.0,0.0,3611,26032,54165,28133
2445,0.0,0.0,0.0,3611,26036,54165,28129
2446,0.0,0.0,0.0,3611,26040,54165,28125
2447,0.0,0.0,0.0,3611,26044,54165,28121
2448,0.0,0.0,0.0,3611,26048,54165,28117
2450,0.0,0.0,0.0,3611,26052,54165,28113
2452,0.0,0.0,0.0,3611,26056,54165,28109
2453,0.0,0.0,0.0,3611,26060,54165,28105
2454,0.0,0.0,0.0,3611,26064,54165,28101
2455,0.0,0.0,0.0,3611,26068,54165,28097
2456,0.0,0.0,0.0,3611,26072,54165,28093
2457,0.0,0.0,0.0,3611,26076,54165,28089
2458,0.0,0.0,0.0,3611,26080,54165,28085
2459,0.0,0.0,0.0,3611,26084,54165,28081
2460,0.0,0.0,0.0,3611,26088,54165,28077
2462,0.0,0.0,0.0,3611,26092,54165,28073
2463,0.0,0.0,0.0,3611,26096,54165,28069
2464,0.0,0.0,0.0,3611,26100,54165,28065
2465,0.0,0.0,0.0,3611,26104,54165,28061
2466,0.0,0.0,0.0,3611,26108,54165,28057
2467,0.0,0.0,0.0,3611,26112,54165,28053
2468,0.0,0.0,0.0,3611,26116,54165,28049
2469,0.0,0.0,0.0,3611,26120,54165,28045
2470,0.0,0.0,0.0,3611,26124,54165,28041
2471,0.0,0.0,0.0,3611,26128,54165,28037
2472,0.0,0.0,0.0,3611,26132,54165,28033
2473,0.0,0.0,0.0,3611,26136,54165,28029
2474,0.0,0.0,0.0,3611,26140,54165,28025
2475,0.0,0.0,0.0,3611,26144,54165,28021
2476,0.0,0.0,0.0,3611,26148,54165,28017
2477,0.0,0.0,0.0,3611,26152,54165,28013
2479,0.0,0.0,0.0,3611,26156,54165,28009
2480,0.0,0.0,0.0,3611,26160,54165,28005
2481,0.0,0.0,0.0,3611,26164,54165,28001
2482,0.0,0.0,0.0,3611,26168,54165,27997
2483,0.0,0.0,0.0,3611,26172,54165,27993
2484,0.0,0.0,0.0,3611,26176,54165,27989
2486,0.0,0.0,0.0,3611,26180,54165,27985
2488,0.0,0.0,0.0,3611,26184,54165,27981
2490,0.0,0.0,0.0,3611,26188,54165,27977
2491,0.0,0.0,0.0,3611,26192,54165,27973
2492,0.0,0.0,0.0,3611,26196,54165,27969
2493,0.0,0.0,0.0,3611,26200,54165,27965
2495,0.0,0.0,0.0,3611,26204,54165,27961
2496,0.0,0.0,0.0,3611,26208,54165,27957
2498,0.0,0.0,0.0,3611,26212,54165,27953
2499,0.0,0.0,0.0,3611,26216,54165,27949
2500,0.0,0.0,0.0,3611,26220,54165,27945
2501,0.0,0.0,0.0,3611,26224,54165,27941
2503,0.0,0.0,0.0,3611,26228,54165,27937
2504,0.0,0.0,0.0,3611,26232,54165,27933
2505,0.0,0.0,0.0,3611,26236,54165,27929
2507,0.0,0.0,0.0,3611,26240,54165,27925
2508,0.0,0.0,0.0,3611,26244,54165,27921
2509,0.0,0.0,0.0,3611,26248,54165,27917
2510,0.0,0.0,0.0,3611,26252,54165,27913
2512,0.0,0.0,0.0,3611,26256,54165,27909
2514,0.0,0.0,0.0,3611,26260,54165,27905
2515,0.0,0.0,0.0,3611,26264,54165,27901
2518,0.0,0.0,0.0,3611,26268,54165,27897
2519,0.0,0.0,0.0,3611,26272,54165,27893
2521,0.0,0.0,0.0,3611,26276,54165,27889
2522,0.0,0.0,0.0,3611,26280,54165,27885
2526,0.0,0.0,0.0,3611,26284,54165,27881
2527,0.0,0.0,0.0,3611,26288,54165,27877
2532,0.0,0.0,0.0,3611,26292,54165,27873
2533,0.0,0.0,0.0,3611,26296,54165,27869
2534,0.0,0.0,0.0,3611,26300,54165,27865
2535,0.0,0.0,0.0,3611,26304,54165,27861
2536,0.0,0.0,0.0,3611,26308,54165,27857
2538,0.0,0.0,0.0,3611,26312,54165,27853
2539,0.0,0.0,0.0,3611,26316,54165,27849
2540,0.0,0.0,0.0,3611,26320,54165,27845
2541,0.0,0.0,0.0,3611,26324,54165,27841
2542,0.0,0.0,0.0,3611,26328,54165,27837
2545,0.0,0.0,0.0,3611,26332,54165,27833
2549,0.0,0.0,0.0,3611,26336,54165,27829
2550,0.0,0.0,0.0,3611,26340,54165,27825
2553,0.0,0.0,0.0,3611,26344,54165,27821
2554,0.0,0.0,0.0,3611,26348,54165,27817
2555,0.0,0.0,0.0,3611,26352,54165,27813
2556,0.0,0.0,0.0,3611,26356,54165,27809
2557,0.0,0.0,0.0,3611,26360,54165,27805
2558,0.0,0.0,0.0,3611,26364,54165,27801
2559,0.0,0.0,0.0,3611,26368,54165,27797
2560,0.0,0.0,0.0,3611,26372,54165,27793
2561,0.0,0.0,0.0,3611,26376,54165,27789
2562,0.0,0.0,0.0,3611,26380,54165,27785
2563,0.0,0.0,0.0,3611,26384,54165,27781
2564,0.0,0.0,0.0,3611,26388,54165,27777
2566,0.0,0.0,0.0,3611,26392,54165,27773
2567,0.0,0.0,0.0,3611,26396,54165,27769
2568,0.0,0.0,0.0,3611,26400,54165,27765
2569,0.0,0.0,0.0,3611,26404,54165,27761
2570,0.0,0.0,0.0,3611,26408,54165,27757
2571,0.0,0.0,0.0,3611,26412,54165,27753
2572,0.0,0.0,0.0,3611,26416,54165,27749
2573,0.0,0.0,0.0,3611,26420,54165,27745
2574,0.0,0.0,0.0,3611,26424,54165,27741
2576,0.0,0.0,0.0,3611,26428,54165,27737
2578,0.0,0.0,0.0,3611,26432,54165,27733
2579,0.0,0.0,0.0,3611,26436,54165,27729
2580,0.0,0.0,0.0,3611,26440,54165,27725
2581,0.0,0.0,0.0,3611,26444,54165,27721
2582,0.0,0.0,0.0,3611,26448,54165,27717
2583,0.0,0.0,0.0,3611,26452,54165,27713
2586,0.0,0.0,0.0,3611,26456,54165,27709
2588,0.0,0.0,0.0,3611,26460,54165,27705
2589,0.0,0.0,0.0,3611,26464,54165,27701
2590,0.0,0.0,0.0,3611,26468,54165,27697
2591,0.0,0.0,0.0,3611,26472,54165,27693
2593,0.0,0.0,0.0,3611,26476,54165,27689
2594,0.0,0.0,0.0,3611,26480,54165,27685
2595,0.0,0.0,0.0,3611,26484,54165,27681
2596,0.0,0.0,0.0,3611,26488,54165,27677
2597,0.0,0.0,0.0,3611,26492,54165,27673
2598,0.0,0.0,0.0,3611,26496,54165,27669
2599,0.0,0.0,0.0,3611,26500,54165,27665
2600,0.0,0.0,0.0,3611,26504,54165,27661
2601,0.0,0.0,0.0,3611,26508,54165,27657
2602,0.0,0.0,0.0,3611,26512,54165,27653
2603,0.0,0.0,0.0,3611,26516,54165,27649
2604,0.0,0.0,0.0,3611,26520,54165,27645
2605,0.0,0.0,0.0,3611,26524,54165,27641
2606,0.0,0.0,0.0,3611,26528,54165,27637
2607,0.0,0.0,0.0,3611,26532,54165,27633
2608,0.0,0.0,0.0,3611,26536,54165,27629
2609,0.0,0.0,0.0,3611,26540,54165,27625
2610,0.0,0.0,0.0,3611,26544,54165,27621
2612,0.0,0.0,0.0,3611,26548,54165,27617
2614,0.0,0.0,0.0,3611,26552,54165,27613
2615,0.0,0.0,0.0,3611,26556,54165,27609
2616,0.0,0.0,0.0,3611,26560,54165,27605
2617,0.0,0.0,0.0,3611,26564,54165,27601
2618,0.0,0.0,0.0,3611,26568,54165,27597
2619,0.0,0.0,0.0,3611,26572,54165,27593
2620,0.0,0.0,0.0,3611,26576,54165,27589
2621,0.0,0.0,0.0,3611,26580,54165,27585
2623,0.0,0.0,0.0,3611,26584,54165,27581
2624,0.0,0.0,0.0,3611,26588,54165,27577
2625,0.0,0.0,0.0,3611,26592,54165,27573
2626,0.0,0.0,0.0,3611,26596,54165,27569
2627,0.0,0.0,0.0,3611,26600,54165,27565
2628,0.0,0.0,0.0,3611,26604,54165,27561
2631,0.0,0.0,0.0,3611,26608,54165,27557
2632,0.0,0.0,0.0,3611,26612,54165,27553
2633,0.0,0.0,0.0,3611,26616,54165,27549
2634,0.0,0.0,0.0,3611,26620,54165,27545
2635,0.0,0.0,0.0,3611,26624,54165,27541
2636,0.0,0.0,0.0,3611,26628,54165,27537
2637,0.0,0.0,0.0,3611,26632,54165,27533
2638,0.0,0.0,0.0,3611,26636,54165,27529
2639,0.0,0.0,0.0,3611,26640,54165,27525
2641,0.0,0.0,0.0,3611,26644,54165,27521
2642,0.0,0.0,0.0,3611,26648,54165,27517
2643,0.0,0.0,0.0,3611,26652,54165,27513
2645,0.0,0.0,0.0,3611,26656,54165,27509
2646,0.0,0.0,0.0,3611,26660,54165,27505
2647,0.0,0.0,0.0,3611,26664,54165,27501
2649,0.0,0.0,0.0,3611,26668,54165,27497
2650,0.0,0.0,0.0,3611,26672,54165,27493
2651,0.0,0.0,0.0,3611,26676,54165,27489
2652,0.0,0.0,0.0,3611,26680,54165,27485
2653,0.0,0.0,0.0,3611,26684,54165,27481
2654,0.0,0.0,0.0,3611,26688,54165,27477
2655,0.0,0.0,0.0,3611,26692,54165,27473
2660,0.0,0.0,0.0,3611,26696,54165,27469
2661,0.0,0.0,0.0,3611,26700,54165,27465
2662,0.0,0.0,0.0,3611,26704,54165,27461
2663,0.0,0.0,0.0,3611,26708,54165,27457
2664,0.0,0.0,0.0,3611,26712,54165,27453
2665,0.0,0.0,0.0,3611,26716,54165,27449
2666,0.0,0.0,0.0,3611,26720,54165,27445
2669,0.0,0.0,0.0,3611,26724,54165,27441
2670,0.0,0.0,0.0,3611,26728,54165,27437
2671,0.0,0.0,0.0,3611,26732,54165,27433
2672,0.0,0.0,0.0,3611,26736,54165,27429
2673,0.0,0.0,0.0,3611,26740,54165,27425
2674,0.0,0.0,0.0,3611,26744,54165,27421
2675,0.0,0.0,0.0,3611,26748,54165,27417
2676,0.0,0.0,0.0,3611,26752,54165,27413
2677,0.0,0.0,0.0,3611,26756,54165,27409
2680,0.0,0.0,0.0,3611,26760,54165,27405
2681,0.0,0.0,0.0,3611,26764,54165,27401
2683,0.0,0.0,0.0,3611,26768,54165,27397
2685,0.0,0.0,0.0,3611,26772,54165,27393
2687,0.0,0.0,0.0,3611,26776,54165,27389
2688,0.0,0.0,0.0,3611,26780,54165,27385
2689,0.0,0.0,0.0,3611,26784,54165,27381
2690,0.0,0.0,0.0,3611,26788,54165,27377
2691,0.0,0.0,0.0,3611,26792,54165,27373
2692,0.0,0.0,0.0,3611,26796,54165,27369
2693,0.0,0.0,0.0,3611,26800,54165,27365
2694,0.0,0.0,0.0,3611,26804,54165,27361
2695,0.0,0.0,0.0,3611,26808,54165,27357
2696,0.0,0.0,0.0,3611,26812,54165,27353
2697,0.0,0.0,0.0,3611,26816,54165,27349
2698,0.0,0.0,0.0,3611,26820,54165,27345
2699,0.0,0.0,0.0,3611,26824,54165,27341
2700,0.0,0.0,0.0,3611,26828,54165,27337
2701,0.0,0.0,0.0,3611,26832,54165,27333
2703,0.0,0.0,0.0,3611,26836,54165,27329
2704,0.0,0.0,0.0,3611,26840,54165,27325
2705,0.0,0.0,0.0,3611,26844,54165,27321
2706,0.0,0.0,0.0,3611,26848,54165,27317
2707,0.0,0.0,0.0,3611,26852,54165,27313
2708,0.0,0.0,0.0,3611,26856,54165,27309
2709,0.0,0.0,0.0,3611,26860,54165,27305
2710,0.0,0.0,0.0,3611,26864,54165,27301
2711,0.0,0.0,0.0,3611,26868,54165,27297
2713,0.0,0.0,0.0,3611,26872,54165,27293
2714,0.0,0.0,0.0,3611,26876,54165,27289
2715,0.0,0.0,0.0,3611,26880,54165,27285
2716,0.0,0.0,0.0,3611,26884,54165,27281
2717,0.0,0.0,0.0,3611,26888,54165,27277
2719,0.0,0.0,0.0,3611,26892,54165,27273
2720,0.0,0.0,0.0,3611,26896,54165,27269
2723,0.0,0.0,0.0,3611,26900,54165,27265
2724,0.0,0.0,0.0,3611,26904,54165,27261
2725,0.0,0.0,0.0,3611,26908,54165,27257
2726,0.0,0.0,0.0,3611,26912,54165,27253
2727,0.0,0.0,0.0,3611,26916,54165,27249
2728,0.0,0.0,0.0,3611,26920,54165,27245
2729,0.0,0.0,0.0,3611,26924,54165,27241
2730,0.0,0.0,0.0,3611,26928,54165,27237
2731,0.0,0.0,0.0,3611,26932,54165,27233
2732,0.0,0.0,0.0,3611,26936,54165,27229
2733,0.0,0.0,0.0,3611,26940,54165,27225
2734,0.0,0.0,0.0,3611,26944,54165,27221
2735,0.0,0.0,0.0,3611,26948,54165,27217
2736,0.0,0.0,0.0,3611,26952,54165,27213
2737,0.0,0.0,0.0,3611,26956,54165,27209
2738,0.0,0.0,0.0,3611,26960,54165,27205
2739,0.0,0.0,0.0,3611,26964,54165,27201
2741,0.0,0.0,0.0,3611,26968,54165,27197
2742,0.0,0.0,0.0,3611,26972,54165,27193
2743,0.0,0.0,0.0,3611,26976,54165,27189
2744,0.0,0.0,0.0,3611,26980,54165,27185
2745,0.0,0.0,0.0,3611,26984,54165,27181
2747,0.0,0.0,0.0,3611,26988,54165,27177
2748,0.0,0.0,0.0,3611,26992,54165,27173
2749,0.0,0.0,0.0,3611,26996,54165,27169
2750,0.0,0.0,0.0,3611,27000,54165,27165
2754,0.0,0.0,0.0,3611,27004,54165,27161
2755,0.0,0.0,0.0,3611,27008,54165,27157
2756,0.0,0.0,0.0,3611,27012,54165,27153
2757,0.0,0.0,0.0,3611,27016,54165,27149
2758,0.0,0.0,0.0,3611,27020,54165,27145
2759,0.0,0.0,0.0,3611,27024,54165,27141
2761,0.0,0.0,0.0,3611,27028,54165,27137
2762,0.0,0.0,0.0,3611,27032,54165,27133
2763,0.0,0.0,0.0,3611,27036,54165,27129
2764,0.0,0.0,0.0,3611,27040,54165,27125
2765,0.0,0.0,0.0,3611,27044,54165,27121
2766,0.0,0.0,0.0,3611,27048,54165,27117
2768,0.0,0.0,0.0,3611,27052,54165,27113
2771,0.0,0.0,0.0,3611,27056,54165,27109
2772,0.0,0.0,0.0,3611,27060,54165,27105
2773,0.0,0.0,0.0,3611,27064,54165,27101
2774,0.0,0.0,0.0,3611,27068,54165,27097
2775,0.0,0.0,0.0,3611,27072,54165,27093
2776,0.0,0.0,0.0,3611,27076,54165,27089
2777,0.0,0.0,0.0,3611,27080,54165,27085
2778,0.0,0.0,0.0,3611,27084,54165,27081
2779,0.0,0.0,0.0,3611,27088,54165,27077
2780,0.0,0.0,0.0,3611,27092,54165,27073
2781,0.0,0.0,0.0,3611,27096,54165,27069
2782,0.0,0.0,0.0,3611,27100,54165,27065
2783,0.0,0.0,0.0,3611,27104,54165,27061
2784,0.0,0.0,0.0,3611,27108,54165,27057
2785,0.0,0.0,0.0,3611,27112,54165,27053
2786,0.0,0.0,0.0,3611,27116,54165,27049
2787,0.0,0.0,0.0,3611,27120,54165,27045
2788,0.0,0.0,0.0,3611,27124,54165,27041
2790,0.0,0.0,0.0,3611,27128,54165,27037
2791,0.0,0.0,0.0,3611,27132,54165,27033
2792,0.0,0.0,0.0,3611,27136,54165,27029
2793,0.0,0.0,0.0,3611,27140,54165,27025
2794,0.0,0.0,0.0,3611,27144,54165,27021
2796,0.0,0.0,0.0,3611,27148,54165,27017
2797,0.0,0.0,0.0,3611,27152,54165,27013
2798,0.0,0.0,0.0,3611,27156,54165,27009
2799,0.0,0.0,0.0,3611,27160,54165,27005
2801,0.0,0.0,0.0,3611,27164,54165,27001
2802,0.0,0.0,0.0,3611,27168,54165,26997
2804,0.0,0.0,0.0,3611,27172,54165,26993
2805,0.0,0.0,0.0,3611,27176,54165,26989
2806,0.0,0.0,0.0,3611,27180,54165,26985
2807,0.0,0.0,0.0,3611,27184,54165,26981
2808,0.0,0.0,0.0,3611,27188,54165,26977
2809,0.0,0.0,0.0,3611,27192,54165,26973
2810,0.0,0.0,0.0,3611,27196,54165,26969
2811,0.0,0.0,0.0,3611,27200,54165,26965
2814,0.0,0.0,0.0,3611,27204,54165,26961
2815,0.0,0.0,0.0,3611,27208,54165,26957
2816,0.0,0.0,0.0,3611,27212,54165,26953
2817,0.0,0.0,0.0,3611,27216,54165,26949
2819,0.0,0.0,0.0,3611,27220,54165,26945
2820,0.0,0.0,0.0,3611,27224,54165,26941
2821,0.0,0.0,0.0,3611,27228,54165,26937
2822,0.0,0.0,0.0,3611,27232,54165,26933
2826,0.0,0.0,0.0,3611,27236,54165,26929
2827,0.0,0.0,0.0,3611,27240,54165,26925
2828,0.0,0.0,0.0,3611,27244,54165,26921
2830,0.0,0.0,0.0,3611,27248,54165,26917
2831,0.0,0.0,0.0,3611,27252,54165,26913
2832,0.0,0.0,0.0,3611,27256,54165,26909
2833,0.0,0.0,0.0,3611,27260,54165,26905
2834,0.0,0.0,0.0,3611,27264,54165,26901
2835,0.0,0.0,0.0,3611,27268,54165,26897
2836,0.0,0.0,0.0,3611,27272,54165,26893
2838,0.0,0.0,0.0,3611,27276,54165,26889
2839,0.0,0.0,0.0,3611,27280,54165,26885
2840,0.0,0.0,0.0,3611,27284,54165,26881
2841,0.0,0.0,0.0,3611,27288,54165,26877
2842,0.0,0.0,0.0,3611,27292,54165,26873
2843,0.0,0.0,0.0,3611,27296,54165,26869
2844,0.0,0.0,0.0,3611,27300,54165,26865
2845,0.0,0.0,0.0,3611,27304,54165,26861
2846,0.0,0.0,0.0,3611,27308,54165,26857
2847,0.0,0.0,0.0,3611,27312,54165,26853
2848,0.0,0.0,0.0,3611,27316,54165,26849
2849,0.0,0.0,0.0,3611,27320,54165,26845
2850,0.0,0.0,0.0,3611,27324,54165,26841
2851,0.0,0.0,0.0,3611,27328,54165,26837
2853,0.0,0.0,0.0,3611,27332,54165,26833
2855,0.0,0.0,0.0,3611,27336,54165,26829
2856,0.0,0.0,0.0,3611,27340,54165,26825
2858,0.0,0.0,0.0,3611,27344,54165,26821
2860,0.0,0.0,0.0,3611,27348,54165,26817
2861,0.0,0.0,0.0,3611,27352,54165,26813
2863,0.0,0.0,0.0,3611,27356,54165,26809
2864,0.0,0.0,0.0,3611,27360,54165,26805
2865,0.0,0.0,0.0,3611,27364,54165,26801
2866,0.0,0.0,0.0,3611,27368,54165,26797
2867,0.0,0.0,0.0,3611,27372,54165,26793
2868,0.0,0.0,0.0,3611,27376,54165,26789
2869,0.0,0.0,0.0,3611,27380,54165,26785
2870,0.0,0.0,0.0,3611,27384,54165,26781
2871,0.0,0.0,0.0,3611,27388,54165,26777
2873,0.0,0.0,0.0,3611,27392,54165,26773
2874,0.0,0.0,0.0,3611,27396,54165,26769
2875,0.0,0.0,0.0,3611,27400,54165,26765
2876,0.0,0.0,0.0,3611,27404,54165,26761
2877,0.0,0.0,0.0,3611,27408,54165,26757
2879,0.0,0.0,0.0,3611,27412,54165,26753
2880,0.0,0.0,0.0,3611,27416,54165,26749
2882,0.0,0.0,0.0,3611,27420,54165,26745
2883,0.0,0.0,0.0,3611,27424,54165,26741
2884,0.0,0.0,0.0,3611,27428,54165,26737
2885,0.0,0.0,0.0,3611,27432,54165,26733
2886,0.0,0.0,0.0,3611,27436,54165,26729
2887,0.0,0.0,0.0,3611,27440,54165,26725
2888,0.0,0.0,0.0,3611,27444,54165,26721
2889,0.0,0.0,0.0,3611,27448,54165,26717
2890,0.0,0.0,0.0,3611,27452,54165,26713
2891,0.0,0.0,0.0,3611,27456,54165,26709
2892,0.0,0.0,0.0,3611,27460,54165,26705
2893,0.0,0.0,0.0,3611,27464,54165,26701
2894,0.0,0.0,0.0,3611,27468,54165,26697
2895,0.0,0.0,0.0,3611,27472,54165,26693
2896,0.0,0.0,0.0,3611,27476,54165,26689
2897,0.0,0.0,0.0,3611,27480,54165,26685
2898,0.0,0.0,0.0,3611,27484,54165,26681
2899,0.0,0.0,0.0,3611,27488,54165,26677
2901,0.0,0.0,0.0,3611,27492,54165,26673
2902,0.0,0.0,0.0,3611,27496,54165,26669
2903,0.0,0.0,0.0,3611,27500,54165,26665
2904,0.0,0.0,0.0,3611,27504,54165,26661
2905,0.0,0.0,0.0,3611,27508,54165,26657
2906,0.0,0.0,0.0,3611,27512,54165,26653
2907,0.0,0.0,0.0,3611,27516,54165,26649
2908,0.0,0.0,0.0,3611,27520,54165,26645
2909,0.0,0.0,0.0,3611,27524,54165,26641
2910,0.0,0.0,0.0,3611,27528,54165,26637
2911,0.0,0.0,0.0,3611,27532,54165,26633
2912,0.0,0.0,0.0,3611,27536,54165,26629
2913,0.0,0.0,0.0,3611,27540,54165,26625
2914,0.0,0.0,0.0,3611,27544,54165,26621
2915,0.0,0.0,0.0,3611,27548,54165,26617
2916,0.0,0.0,0.0,3611,27552,54165,26613
2917,0.0,0.0,0.0,3611,27556,54165,26609
2918,0.0,0.0,0.0,3611,27560,54165,26605
2919,0.0,0.0,0.0,3611,27564,54165,26601
2920,0.0,0.0,0.0,3611,27568,54165,26597
2921,0.0,0.0,0.0,3611,27572,54165,26593
2922,0.0,0.0,0.0,3611,27576,54165,26589
2923,0.0,0.0,0.0,3611,27580,54165,26585
2924,0.0,0.0,0.0,3611,27584,54165,26581
2927,0.0,0.0,0.0,3611,27588,54165,26577
2928,0.0,0.0,0.0,3611,27592,54165,26573
2929,0.0,0.0,0.0,3611,27596,54165,26569
2931,0.0,0.0,0.0,3611,27600,54165,26565
2932,0.0,0.0,0.0,3611,27604,54165,26561
2933,0.0,0.0,0.0,3611,27608,54165,26557
2935,0.0,0.0,0.0,3611,27612,54165,26553
2936,0.0,0.0,0.0,3611,27616,54165,26549
2937,0.0,0.0,0.0,3611,27620,54165,26545
2938,0.0,0.0,0.0,3611,27624,54165,26541
2939,0.0,0.0,0.0,3611,27628,54165,26537
2940,0.0,0.0,0.0,3611,27632,54165,26533
2942,0.0,0.0,0.0,3611,27636,54165,26529
2943,0.0,0.0,0.0,3611,27640,54165,26525
2944,0.0,0.0,0.0,3611,27644,54165,26521
2945,0.0,0.0,0.0,3611,27648,54165,26517
2947,0.0,0.0,0.0,3611,27652,54165,26513
2948,0.0,0.0,0.0,3611,27656,54165,26509
2950,0.0,0.0,0.0,3611,27660,54165,26505
2951,0.0,0.0,0.0,3611,27664,54165,26501
2952,0.0,0.0,0.0,3611,27668,54165,26497
2954,0.0,0.0,0.0,3611,27672,54165,26493
2955,0.0,0.0,0.0,3611,27676,54165,26489
2956,0.0,0.0,0.0,3611,27680,54165,26485
2957,0.0,0.0,0.0,3611,27684,54165,26481
2958,0.0,0.0,0.0,3611,27688,54165,26477
2959,0.0,0.0,0.0,3611,27692,54165,26473
2960,0.0,0.0,0.0,3611,27696,54165,26469
2961,0.0,0.0,0.0,3611,27700,54165,26465
2963,0.0,0.0,0.0,3611,27704,54165,26461
2965,0.0,0.0,0.0,3611,27708,54165,26457
2967,0.0,0.0,0.0,3611,27712,54165,26453
2969,0.0,0.0,0.0,3611,27716,54165,26449
2971,0.0,0.0,0.0,3611,27720,54165,26445
2972,0.0,0.0,0.0,3611,27724,54165,26441
2973,0.0,0.0,0.0,3611,27728,54165,26437
2974,0.0,0.0,0.0,3611,27732,54165,26433
2975,0.0,0.0,0.0,3611,27736,54165,26429
2976,0.0,0.0,0.0,3611,27740,54165,26425
2979,0.0,0.0,0.0,3611,27744,54165,26421
2980,0.0,0.0,0.0,3611,27748,54165,26417
2981,0.0,0.0,0.0,3611,27752,54165,26413
2982,0.0,0.0,0.0,3611,27756,54165,26409
2983,0.0,0.0,0.0,3611,27760,54165,26405
2984,0.0,0.0,0.0,3611,27764,54165,26401
2985,0.0,0.0,0.0,3611,27768,54165,26397
2986,0.0,0.0,0.0,3611,27772,54165,26393
2989,0.0,0.0,0.0,3611,27776,54165,26389
2990,0.0,0.0,0.0,3611,27780,54165,26385
2991,0.0,0.0,0.0,3611,27784,54165,26381
2992,0.0,0.0,0.0,3611,27788,54165,26377
2993,0.0,0.0,0.0,3611,27792,54165,26373
2994,0.0,0.0,0.0,3611,27796,54165,26369
2995,0.0,0.0,0.0,3611,27800,54165,26365
2996,0.0,0.0,0.0,3611,27804,54165,26361
2997,0.0,0.0,0.0,3611,27808,54165,26357
2998,0.0,0.0,0.0,3611,27812,54165,26353
2999,0.0,0.0,0.0,3611,27816,54165,26349
3000,0.0,0.0,0.0,3611,27820,54165,26345
3001,0.0,0.0,0.0,3611,27824,54165,26341
3002,0.0,0.0,0.0,3611,27828,54165,26337
3003,0.0,0.0,0.0,3611,27832,54165,26333
3005,0.0,0.0,0.0,3611,27836,54165,26329
3006,0.0,0.0,0.0,3611,27840,54165,26325
3008,0.0,0.0,0.0,3611,27844,54165,26321
3009,0.0,0.0,0.0,3611,27848,54165,26317
3010,0.0,0.0,0.0,3611,27852,54165,26313
3011,0.0,0.0,0.0,3611,27856,54165,26309
3014,0.0,0.0,0.0,3611,27860,54165,26305
3015,0.0,0.0,0.0,3611,27864,54165,26301
3016,0.0,0.0,0.0,3611,27868,54165,26297
3018,0.0,0.0,0.0,3611,27872,54165,26293
3019,0.0,0.0,0.0,3611,27876,54165,26289
3020,0.0,0.0,0.0,3611,27880,54165,26285
3021,0.0,0.0,0.0,3611,27884,54165,26281
3022,0.0,0.0,0.0,3611,27888,54165,26277
3023,0.0,0.0,0.0,3611,27892,54165,26273
3025,0.0,0.0,0.0,3611,27896,54165,26269
3028,0.0,0.0,0.0,3611,27900,54165,26265
3030,0.0,0.0,0.0,3611,27904,54165,26261
3032,0.0,0.0,0.0,3611,27908,54165,26257
3033,0.0,0.0,0.0,3611,27912,54165,26253
3034,0.0,0.0,0.0,3611,27916,54165,26249
3035,0.0,0.0,0.0,3611,27920,54165,26245
3036,0.0,0.0,0.0,3611,27924,54165,26241
3037,0.0,0.0,0.0,3611,27928,54165,26237
3039,0.0,0.0,0.0,3611,27932,54165,26233
3040,0.0,0.0,0.0,3611,27936,54165,26229
3041,0.0,0.0,0.0,3611,27940,54165,26225
3042,0.0,0.0,0.0,3611,27944,54165,26221
3044,0.0,0.0,0.0,3611,27948,54165,26217
3045,0.0,0.0,0.0,3611,27952,54165,26213
3046,0.0,0.0,0.0,3611,27956,54165,26209
3047,0.0,0.0,0.0,3611,27960,54165,26205
3048,0.0,0.0,0.0,3611,27964,54165,26201
3049,0.0,0.0,0.0,3611,27968,54165,26197
3050,0.0,0.0,0.0,3611,27972,54165,26193
3051,0.0,0.0,0.0,3611,27976,54165,26189
3052,0.0,0.0,0.0,3611,27980,54165,26185
3053,0.0,0.0,0.0,3611,27984,54165,26181
3056,0.0,0.0,0.0,3611,27988,54165,26177
3057,0.0,0.0,0.0,3611,27992,54165,26173
3058,0.0,0.0,0.0,3611,27996,54165,26169
3059,0.0,0.0,0.0,3611,28000,54165,26165
3060,0.0,0.0,0.0,3611,28004,54165,26161
3061,0.0,0.0,0.0,3611,28008,54165,26157
3062,0.0,0.0,0.0,3611,28012,54165,26153
3064,0.0,0.0,0.0,3611,28016,54165,26149
3066,0.0,0.0,0.0,3611,28020,54165,26145
3067,0.0,0.0,0.0,3611,28024,54165,26141
3068,0.0,0.0,0.0,3611,28028,54165,26137
3069,0.0,0.0,0.0,3611,28032,54165,26133
3070,0.0,0.0,0.0,3611,28036,54165,26129
3071,0.0,0.0,0.0,3611,28040,54165,26125
3072,0.0,0.0,0.0,3611,28044,54165,26121
3073,0.0,0.0,0.0,3611,28048,54165,26117
3074,0.0,0.0,0.0,3611,28052,54165,26113
3075,0.0,0.0,0.0,3611,28056,54165,26109
3076,0.0,0.0,0.0,3611,28060,54165,26105
3077,0.0,0.0,0.0,3611,28064,54165,26101
3078,0.0,0.0,0.0,3611,28068,54165,26097
3081,0.0,0.0,0.0,3611,28072,54165,26093
3082,0.0,0.0,0.0,3611,28076,54165,26089
3083,0.0,0.0,0.0,3611,28080,54165,26085
3084,0.0,0.0,0.0,3611,28084,54165,26081
3085,0.0,0.0,0.0,3611,28088,54165,26077
3086,0.0,0.0,0.0,3611,28092,54165,26073
3087,0.0,0.0,0.0,3611,28096,54165,26069
3089,0.0,0.0,0.0,3611,28100,54165,26065
3090,0.0,0.0,0.0,3611,28104,54165,26061
3091,0.0,0.0,0.0,3611,28108,54165,26057
3092,0.0,0.0,0.0,3611,28112,54165,26053
3093,0.0,0.0,0.0,3611,28116,54165,26049
3094,0.0,0.0,0.0,3611,28120,54165,26045
3095,0.0,0.0,0.0,3611,28124,54165,26041
3096,0.0,0.0,0.0,3611,28128,54165,26037
3097,0.0,0.0,0.0,3611,28132,54165,26033
3098,0.0,0.0,0.0,3611,28136,54165,26029
3100,0.0,0.0,0.0,3611,28140,54165,26025
3101,0.0,0.0,0.0,3611,28144,54165,26021
3102,0.0,0.0,0.0,3611,28148,54165,26017
3103,0.0,0.0,0.0,3611,28152,54165,26013
3104,0.0,0.0,0.0,3611,28156,54165,26009
3105,0.0,0.0,0.0,3611,28160,54165,26005
3106,0.0,0.0,0.0,3611,28164,54165,26001
3107,0.0,0.0,0.0,3611,28168,54165,25997
3108,0.0,0.0,0.0,3611,28172,54165,25993
3109,0.0,0.0,0.0,3611,28176,54165,25989
3110,0.0,0.0,0.0,3611,28180,54165,25985
3111,0.0,0.0,0.0,3611,28184,54165,25981
3112,0.0,0.0,0.0,3611,28188,54165,25977
3113,0.0,0.0,0.0,3611,28192,54165,25973
3114,0.0,0.0,0.0,3611,28196,54165,25969
3115,0.0,0.0,0.0,3611,28200,54165,25965
3116,0.0,0.0,0.0,3611,28204,54165,25961
3117,0.0,0.0,0.0,3611,28208,54165,25957
3118,0.0,0.0,0.0,3611,28212,54165,25953
3119,0.0,0.0,0.0,3611,28216,54165,25949
3120,0.0,0.0,0.0,3611,28220,54165,25945
3121,0.0,0.0,0.0,3611,28224,54165,25941
3122,0.0,0.0,0.0,3611,28228,54165,25937
3123,0.0,0.0,0.0,3611,28232,54165,25933
3124,0.0,0.0,0.0,3611,28236,54165,25929
3126,0.0,0.0,0.0,3611,28240,54165,25925
3127,0.0,0.0,0.0,3611,28244,54165,25921
3128,0.0,0.0,0.0,3611,28248,54165,25917
3129,0.0,0.0,0.0,3611,28252,54165,25913
3130,0.0,0.0,0.0,3611,28256,54165,25909
3131,0.0,0.0,0.0,3611,28260,54165,25905
3132,0.0,0.0,0.0,3611,28264,54165,25901
3133,0.0,0.0,0.0,3611,28268,54165,25897
3134,0.0,0.0,0.0,3611,28272,54165,25893
3135,0.0,0.0,0.0,3611,28276,54165,25889
3136,0.0,0.0,0.0,3611,28280,54165,25885
3137,0.0,0.0,0.0,3611,28284,54165,25881
3138,0.0,0.0,0.0,3611,28288,54165,25877
3140,0.0,0.0,0.0,3611,28292,54165,25873
3141,0.0,0.0,0.0,3611,28296,54165,25869
3142,0.0,0.0,0.0,3611,28300,54165,25865
3143,0.0,0.0,0.0,3611,28304,54165,25861
3144,0.0,0.0,0.0,3611,28308,54165,25857
3145,0.0,0.0,0.0,3611,28312,54165,25853
3146,0.0,0.0,0.0,3611,28316,54165,25849
3147,0.0,0.0,0.0,3611,28320,54165,25845
3148,0.0,0.0,0.0,3611,28324,54165,25841
3149,0.0,0.0,0.0,3611,28328,54165,25837
3150,0.0,0.0,0.0,3611,28332,54165,25833
3151,0.0,0.0,0.0,3611,28336,54165,25829
3152,0.0,0.0,0.0,3611,28340,54165,25825
3153,0.0,0.0,0.0,3611,28344,54165,25821
3155,0.0,0.0,0.0,3611,28348,54165,25817
3156,0.0,0.0,0.0,3611,28352,54165,25813
3158,0.0,0.0,0.0,3611,28356,54165,25809
3161,0.0,0.0,0.0,3611,28360,54165,25805
3162,0.0,0.0,0.0,3611,28364,54165,25801
3164,0.0,0.0,0.0,3611,28368,54165,25797
3166,0.0,0.0,0.0,3611,28372,54165,25793
3167,0.0,0.0,0.0,3611,28376,54165,25789
3168,0.0,0.0,0.0,3611,28380,54165,25785
3169,0.0,0.0,0.0,3611,28384,54165,25781
3170,0.0,0.0,0.0,3611,28388,54165,25777
3171,0.0,0.0,0.0,3611,28392,54165,25773
3172,0.0,0.0,0.0,3611,28396,54165,25769
3173,0.0,0.0,0.0,3611,28400,54165,25765
3174,0.0,0.0,0.0,3611,28404,54165,25761
3175,0.0,0.0,0.0,3611,28408,54165,25757
3179,0.0,0.0,0.0,3611,28412,54165,25753
3180,0.0,0.0,0.0,3611,28416,54165,25749
3181,0.0,0.0,0.0,3611,28420,54165,25745
3182,0.0,0.0,0.0,3611,28424,54165,25741
3183,0.0,0.0,0.0,3611,28428,54165,25737
3184,0.0,0.0,0.0,3611,28432,54165,25733
3185,0.0,0.0,0.0,3611,28436,54165,25729
3187,0.0,0.0,0.0,3611,28440,54165,25725
3188,0.0,0.0,0.0,3611,28444,54165,25721
3190,0.0,0.0,0.0,3611,28448,54165,25717
3191,0.0,0.0,0.0,3611,28452,54165,25713
3192,0.0,0.0,0.0,3611,28456,54165,25709
3193,0.0,0.0,0.0,3611,28460,54165,25705
3195,0.0,0.0,0.0,3611,28464,54165,25701
3196,0.0,0.0,0.0,3611,28468,54165,25697
3198,0.0,0.0,0.0,3611,28472,54165,25693
3200,0.0,0.0,0.0,3611,28476,54165,25689
3202,0.0,0.0,0.0,3611,28480,54165,25685
3203,0.0,0.0,0.0,3611,28484,54165,25681
3204,0.0,0.0,0.0,3611,28488,54165,25677
3205,0.0,0.0,0.0,3611,28492,54165,25673
3206,0.0,0.0,0.0,3611,28496,54165,25669
3207,0.0,0.0,0.0,3611,28500,54165,25665
3209,0.0,0.0,0.0,3611,28504,54165,25661
3210,0.0,0.0,0.0,3611,28508,54165,25657
3211,0.0,0.0,0.0,3611,28512,54165,25653
3212,0.0,0.0,0.0,3611,28516,54165,25649
3213,0.0,0.0,0.0,3611,28520,54165,25645
3214,0.0,0.0,0.0,3611,28524,54165,25641
3215,0.0,0.0,0.0,3611,28528,54165,25637
3216,0.0,0.0,0.0,3611,28532,54165,25633
3217,0.0,0.0,0.0,3611,28536,54165,25629
3218,0.0,0.0,0.0,3611,28540,54165,25625
3220,0.0,0.0,0.0,3611,28544,54165,25621
3221,0.0,0.0,0.0,3611,28548,54165,25617
3222,0.0,0.0,0.0,3611,28552,54165,25613
3223,0.0,0.0,0.0,3611,28556,54165,25609
3224,0.0,0.0,0.0,3611,28560,54165,25605
3225,0.0,0.0,0.0,3611,28564,54165,25601
3226,0.0,0.0,0.0,3611,28568,54165,25597
3228,0.0,0.0,0.0,3611,28572,54165,25593
3229,0.0,0.0,0.0,3611,28576,54165,25589
3230,0.0,0.0,0.0,3611,28580,54165,25585
3232,0.0,0.0,0.0,3611,28584,54165,25581
3234,0.0,0.0,0.0,3611,28588,54165,25577
3235,0.0,0.0,0.0,3611,28592,54165,25573
3236,0.0,0.0,0.0,3611,28596,54165,25569
3237,0.0,0.0,0.0,3611,28600,54165,25565
3238,0.0,0.0,0.0,3611,28604,54165,25561
3239,0.0,0.0,0.0,3611,28608,54165,25557
3240,0.0,0.0,0.0,3611,28612,54165,25553
3242,0.0,0.0,0.0,3611,28616,54165,25549
3244,0.0,0.0,0.0,3611,28620,54165,25545
3245,0.0,0.0,0.0,3611,28624,54165,25541
3247,0.0,0.0,0.0,3611,28628,54165,25537
3249,0.0,0.0,0.0,3611,28632,54165,25533
3250,0.0,0.0,0.0,3611,28636,54165,25529
3252,0.0,0.0,0.0,3611,28640,54165,25525
3253,0.0,0.0,0.0,3611,28644,54165,25521
3254,0.0,0.0,0.0,3611,28648,54165,25517
3255,0.0,0.0,0.0,3611,28652,54165,25513
3256,0.0,0.0,0.0,3611,28656,54165,25509
3257,0.0,0.0,0.0,3611,28660,54165,25505
3258,0.0,0.0,0.0,3611,28664,54165,25501
3259,0.0,0.0,0.0,3611,28668,54165,25497
3261,0.0,0.0,0.0,3611,28672,54165,25493
3262,0.0,0.0,0.0,3611,28676,54165,25489
3263,0.0,0.0,0.0,3611,28680,54165,25485
3264,0.0,0.0,0.0,3611,28684,54165,25481
3265,0.0,0.0,0.0,3611,28688,54165,25477
3266,0.0,0.0,0.0,3611,28692,54165,25473
3267,0.0,0.0,0.0,3611,28696,54165,25469
3268,0.0,0.0,0.0,3611,28700,54165,25465
3269,0.0,0.0,0.0,3611,28704,54165,25461
3270,0.0,0.0,0.0,3611,28708,54165,25457
3271,0.0,0.0,0.0,3611,28712,54165,25453
3273,0.0,0.0,0.0,3611,28716,54165,25449
3274,0.0,0.0,0.0,3611,28720,54165,25445
3275,0.0,0.0,0.0,3611,28724,54165,25441
3276,0.0,0.0,0.0,3611,28728,54165,25437
3277,0.0,0.0,0.0,3611,28732,54165,25433
3278,0.0,0.0,0.0,3611,28736,54165,25429
3279,0.0,0.0,0.0,3611,28740,54165,25425
3280,0.0,0.0,0.0,3611,28744,54165,25421
3281,0.0,0.0,0.0,3611,28748,54165,25417
3282,0.0,0.0,0.0,3611,28752,54165,25413
3283,0.0,0.0,0.0,3611,28756,54165,25409
3285,0.0,0.0,0.0,3611,28760,54165,25405
3286,0.0,0.0,0.0,3611,28764,54165,25401
3288,0.0,0.0,0.0,3611,28768,54165,25397
3289,0.0,0.0,0.0,3611,28772,54165,25393
3290,0.0,0.0,0.0,3611,28776,54165,25389
3291,0.0,0.0,0.0,3611,28780,54165,25385
3292,0.0,0.0,0.0,3611,28784,54165,25381
3294,0.0,0.0,0.0,3611,28788,54165,25377
3295,0.0,0.0,0.0,3611,28792,54165,25373
3298,0.0,0.0,0.0,3611,28796,54165,25369
3299,0.0,0.0,0.0,3611,28800,54165,25365
3300,0.0,0.0,0.0,3611,28804,54165,25361
3301,0.0,0.0,0.0,3611,28808,54165,25357
3302,0.0,0.0,0.0,3611,28812,54165,25353
3305,0.0,0.0,0.0,3611,28816,54165,25349
3306,0.0,0.0,0.0,3611,28820,54165,25345
3307,0.0,0.0,0.0,3611,28824,54165,25341
3308,0.0,0.0,0.0,3611,28828,54165,25337
3311,0.0,0.0,0.0,3611,28832,54165,25333
3312,0.0,0.0,0.0,3611,28836,54165,25329
3314,0.0,0.0,0.0,3611,28840,54165,25325
3315,0.0,0.0,0.0,3611,28844,54165,25321
3316,0.0,0.0,0.0,3611,28848,54165,25317
3317,0.0,0.0,0.0,3611,28852,54165,25313
3318,0.0,0.0,0.0,3611,28856,54165,25309
3321,0.0,0.0,0.0,3611,28860,54165,25305
3324,0.0,0.0,0.0,3611,28864,54165,25301
3325,0.0,0.0,0.0,3611,28868,54165,25297
3326,0.0,0.0,0.0,3611,28872,54165,25293
3327,0.0,0.0,0.0,3611,28876,54165,25289
3328,0.0,0.0,0.0,3611,28880,54165,25285
3329,0.0,0.0,0.0,3611,28884,54165,25281
3330,0.0,0.0,0.0,3611,28888,54165,25277
3331,0.0,0.0,0.0,3611,28892,54165,25273
3332,0.0,0.0,0.0,3611,28896,54165,25269
3333,0.0,0.0,0.0,3611,28900,54165,25265
3335,0.0,0.0,0.0,3611,28904,54165,25261
3336,0.0,0.0,0.0,3611,28908,54165,25257
3337,0.0,0.0,0.0,3611,28912,54165,25253
3338,0.0,0.0,0.0,3611,28916,54165,25249
3339,0.0,0.0,0.0,3611,28920,54165,25245
3340,0.0,0.0,0.0,3611,28924,54165,25241
3341,0.0,0.0,0.0,3611,28928,54165,25237
3342,0.0,0.0,0.0,3611,28932,54165,25233
3344,0.0,0.0,0.0,3611,28936,54165,25229
3345,0.0,0.0,0.0,3611,28940,54165,25225
3347,0.0,0.0,0.0,3611,28944,54165,25221
3348,0.0,0.0,0.0,3611,28948,54165,25217
3349,0.0,0.0,0.0,3611,28952,54165,25213
3352,0.0,0.0,0.0,3611,28956,54165,25209
3353,0.0,0.0,0.0,3611,28960,54165,25205
3354,0.0,0.0,0.0,3611,28964,54165,25201
3355,0.0,0.0,0.0,3611,28968,54165,25197
3357,0.0,0.0,0.0,3611,28972,54165,25193
3358,0.0,0.0,0.0,3611,28976,54165,25189
3359,0.0,0.0,0.0,3611,28980,54165,25185
3360,0.0,0.0,0.0,3611,28984,54165,25181
3361,0.0,0.0,0.0,3611,28988,54165,25177
3364,0.0,0.0,0.0,3611,28992,54165,25173
3365,0.0,0.0,0.0,3611,28996,54165,25169
3366,0.0,0.0,0.0,3611,29000,54165,25165
3368,0.0,0.0,0.0,3611,29004,54165,25161
3369,0.0,0.0,0.0,3611,29008,54165,25157
3370,0.0,0.0,0.0,3611,29012,54165,25153
3371,0.0,0.0,0.0,3611,29016,54165,25149
3372,0.0,0.0,0.0,3611,29020,54165,25145
3373,0.0,0.0,0.0,3611,29024,54165,25141
3374,0.0,0.0,0.0,3611,29028,54165,25137
3375,0.0,0.0,0.0,3611,29032,54165,25133
3376,0.0,0.0,0.0,3611,29036,54165,25129
3377,0.0,0.0,0.0,3611,29040,54165,25125
3378,0.0,0.0,0.0,3611,29044,54165,25121
3380,0.0,0.0,0.0,3611,29048,54165,25117
3381,0.0,0.0,0.0,3611,29052,54165,25113
3382,0.0,0.0,0.0,3611,29056,54165,25109
3384,0.0,0.0,0.0,3611,29060,54165,25105
3385,0.0,0.0,0.0,3611,29064,54165,25101
3386,0.0,0.0,0.0,3611,29068,54165,25097
3387,0.0,0.0,0.0,3611,29072,54165,25093
3388,0.0,0.0,0.0,3611,29076,54165,25089
3389,0.0,0.0,0.0,3611,29080,54165,25085
3390,0.0,0.0,0.0,3611,29084,54165,25081
3391,0.0,0.0,0.0,3611,29088,54165,25077
3392,0.0,0.0,0.0,3611,29092,54165,25073
3393,0.0,0.0,0.0,3611,29096,54165,25069
3394,0.0,0.0,0.0,3611,29100,54165,25065
3396,0.0,0.0,0.0,3611,29104,54165,25061
3397,0.0,0.0,0.0,3611,29108,54165,25057
3398,0.0,0.0,0.0,3611,29112,54165,25053
3399,0.0,0.0,0.0,3611,29116,54165,25049
3400,0.0,0.0,0.0,3611,29120,54165,25045
3401,0.0,0.0,0.0,3611,29124,54165,25041
3402,0.0,0.0,0.0,3611,29128,54165,25037
3403,0.0,0.0,0.0,3611,29132,54165,25033
3404,0.0,0.0,0.0,3611,29136,54165,25029
3405,0.0,0.0,0.0,3611,29140,54165,25025
3406,0.0,0.0,0.0,3611,29144,54165,25021
3407,0.0,0.0,0.0,3611,29148,54165,25017
3408,0.0,0.0,0.0,3611,29152,54165,25013
3409,0.0,0.0,0.0,3611,29156,54165,25009
3410,0.0,0.0,0.0,3611,29160,54165,25005
3412,0.0,0.0,0.0,3611,29164,54165,25001
3413,0.0,0.0,0.0,3611,29168,54165,24997
3414,0.0,0.0,0.0,3611,29172,54165,24993
3416,0.0,0.0,0.0,3611,29176,54165,24989
3417,0.0,0.0,0.0,3611,29180,54165,24985
3419,0.0,0.0,0.0,3611,29184,54165,24981
3420,0.0,0.0,0.0,3611,29188,54165,24977
3421,0.0,0.0,0.0,3611,29192,54165,24973
3422,0.0,0.0,0.0,3611,29196,54165,24969
3424,0.0,0.0,0.0,3611,29200,54165,24965
3425,0.0,0.0,0.0,3611,29204,54165,24961
3426,0.0,0.0,0.0,3611,29208,54165,24957
3427,0.0,0.0,0.0,3611,29212,54165,24953
3428,0.0,0.0,0.0,3611,29216,54165,24949
3429,0.0,0.0,0.0,3611,29220,54165,24945
3430,0.0,0.0,0.0,3611,29224,54165,24941
3431,0.0,0.0,0.0,3611,29228,54165,24937
3432,0.0,0.0,0.0,3611,29232,54165,24933
3433,0.0,0.0,0.0,3611,29236,54165,24929
3434,0.0,0.0,0.0,3611,29240,54165,24925
3435,0.0,0.0,0.0,3611,29244,54165,24921
3436,0.0,0.0,0.0,3611,29248,54165,24917
3438,0.0,0.0,0.0,3611,29252,54165,24913
3439,0.0,0.0,0.0,3611,29256,54165,24909
3440,0.0,0.0,0.0,3611,29260,54165,24905
3442,0.0,0.0,0.0,3611,29264,54165,24901
3443,0.0,0.0,0.0,3611,29268,54165,24897
3444,0.0,0.0,0.0,3611,29272,54165,24893
3445,0.0,0.0,0.0,3611,29276,54165,24889
3446,0.0,0.0,0.0,3611,29280,54165,24885
3447,0.0,0.0,0.0,3611,29284,54165,24881
3448,0.0,0.0,0.0,3611,29288,54165,24877
3449,0.0,0.0,0.0,3611,29292,54165,24873
3450,0.0,0.0,0.0,3611,29296,54165,24869
3451,0.0,0.0,0.0,3611,29300,54165,24865
3452,0.0,0.0,0.0,3611,29304,54165,24861
3454,0.0,0.0,0.0,3611,29308,54165,24857
3456,0.0,0.0,0.0,3611,29312,54165,24853
3457,0.0,0.0,0.0,3611,29316,54165,24849
3458,0.0,0.0,0.0,3611,29320,54165,24845
3459,0.0,0.0,0.0,3611,29324,54165,24841
3460,0.0,0.0,0.0,3611,29328,54165,24837
3462,0.0,0.0,0.0,3611,29332,54165,24833
3463,0.0,0.0,0.0,3611,29336,54165,24829
3464,0.0,0.0,0.0,3611,29340,54165,24825
3465,0.0,0.0,0.0,3611,29344,54165,24821
3466,0.0,0.0,0.0,3611,29348,54165,24817
3467,0.0,0.0,0.0,3611,29352,54165,24813
3468,0.0,0.0,0.0,3611,29356,54165,24809
3469,0.0,0.0,0.0,3611,29360,54165,24805
3470,0.0,0.0,0.0,3611,29364,54165,24801
3471,0.0,0.0,0.0,3611,29368,54165,24797
3472,0.0,0.0,0.0,3611,29372,54165,24793
3473,0.0,0.0,0.0,3611,29376,54165,24789
3476,0.0,0.0,0.0,3611,29380,54165,24785
3477,0.0,0.0,0.0,3611,29384,54165,24781
3480,0.0,0.0,0.0,3611,29388,54165,24777
3483,0.0,0.0,0.0,3611,29392,54165,24773
3484,0.0,0.0,0.0,3611,29396,54165,24769
3489,0.0,0.0,0.0,3611,29400,54165,24765
3490,0.0,0.0,0.0,3611,29404,54165,24761
3491,0.0,0.0,0.0,3611,29408,54165,24757
3492,0.0,0.0,0.0,3611,29412,54165,24753
3493,0.0,0.0,0.0,3611,29416,54165,24749
3494,0.0,0.0,0.0,3611,29420,54165,24745
3495,0.0,0.0,0.0,3611,29424,54165,24741
3496,0.0,0.0,0.0,3611,29428,54165,24737
3497,0.0,0.0,0.0,3611,29432,54165,24733
3498,0.0,0.0,0.0,3611,29436,54165,24729
3499,0.0,0.0,0.0,3611,29440,54165,24725
3501,0.0,0.0,0.0,3611,29444,54165,24721
3502,0.0,0.0,0.0,3611,29448,54165,24717
3503,0.0,0.0,0.0,3611,29452,54165,24713
3504,0.0,0.0,0.0,3611,29456,54165,24709
3505,0.0,0.0,0.0,3611,29460,54165,24705
3506,0.0,0.0,0.0,3611,29464,54165,24701
3507,0.0,0.0,0.0,3611,29468,54165,24697
3508,0.0,0.0,0.0,3611,29472,54165,24693
3509,0.0,0.0,0.0,3611,29476,54165,24689
3510,0.0,0.0,0.0,3611,29480,54165,24685
3511,0.0,0.0,0.0,3611,29484,54165,24681
3513,0.0,0.0,0.0,3611,29488,54165,24677
3515,0.0,0.0,0.0,3611,29492,54165,24673
3517,0.0,0.0,0.0,3611,29496,54165,24669
3520,0.0,0.0,0.0,3611,29500,54165,24665
3521,0.0,0.0,0.0,3611,29504,54165,24661
3522,0.0,0.0,0.0,3611,29508,54165,24657
3523,0.0,0.0,0.0,3611,29512,54165,24653
3524,0.0,0.0,0.0,3611,29516,54165,24649
3525,0.0,0.0,0.0,3611,29520,54165,24645
3526,0.0,0.0,0.0,3611,29524,54165,24641
3528,0.0,0.0,0.0,3611,29528,54165,24637
3529,0.0,0.0,0.0,3611,29532,54165,24633
3530,0.0,0.0,0.0,3611,29536,54165,24629
3533,0.0,0.0,0.0,3611,29540,54165,24625
3534,0.0,0.0,0.0,3611,29544,54165,24621
3535,0.0,0.0,0.0,3611,29548,54165,24617
3536,0.0,0.0,0.0,3611,29552,54165,24613
3537,0.0,0.0,0.0,3611,29556,54165,24609
3538,0.0,0.0,0.0,3611,29560,54165,24605
3539,0.0,0.0,0.0,3611,29564,54165,24601
3540,0.0,0.0,0.0,3611,29568,54165,24597
3542,0.0,0.0,0.0,3611,29572,54165,24593
3543,0.0,0.0,0.0,3611,29576,54165,24589
3544,0.0,0.0,0.0,3611,29580,54165,24585
3545,0.0,0.0,0.0,3611,29584,54165,24581
3546,0.0,0.0,0.0,3611,29588,54165,24577
3547,0.0,0.0,0.0,3611,29592,54165,24573
3548,0.0,0.0,0.0,3611,29596,54165,24569
3549,0.0,0.0,0.0,3611,29600,54165,24565
3550,0.0,0.0,0.0,3611,29604,54165,24561
3551,0.0,0.0,0.0,3611,29608,54165,24557
3553,0.0,0.0,0.0,3611,29612,54165,24553
3554,0.0,0.0,0.0,3611,29616,54165,24549
3555,0.0,0.0,0.0,3611,29620,54165,24545
3557,0.0,0.0,0.0,3611,29624,54165,24541
3558,0.0,0.0,0.0,3611,29628,54165,24537
3559,0.0,0.0,0.0,3611,29632,54165,24533
3560,0.0,0.0,0.0,3611,29636,54165,24529
3561,0.0,0.0,0.0,3611,29640,54165,24525
3562,0.0,0.0,0.0,3611,29644,54165,24521
3563,0.0,0.0,0.0,3611,29648,54165,24517
3564,0.0,0.0,0.0,3611,29652,54165,24513
3567,0.0,0.0,0.0,3611,29656,54165,24509
3568,0.0,0.0,0.0,3611,29660,54165,24505
3569,0.0,0.0,0.0,3611,29664,54165,24501
3570,0.0,0.0,0.0,3611,29668,54165,24497
3571,0.0,0.0,0.0,3611,29672,54165,24493
3572,0.0,0.0,0.0,3611,29676,54165,24489
3573,0.0,0.0,0.0,3611,29680,54165,24485
3574,0.0,0.0,0.0,3611,29684,54165,24481
3575,0.0,0.0,0.0,3611,29688,54165,24477
3576,0.0,0.0,0.0,3611,29692,54165,24473
3577,0.0,0.0,0.0,3611,29696,54165,24469
3578,0.0,0.0,0.0,3611,29700,54165,24465
3579,0.0,0.0,0.0,3611,29704,54165,24461
3580,0.0,0.0,0.0,3611,29708,54165,24457
3581,0.0,0.0,0.0,3611,29712,54165,24453
3582,0.0,0.0,0.0,3611,29716,54165,24449
3584,0.0,0.0,0.0,3611,29720,54165,24445
3585,0.0,0.0,0.0,3611,29724,54165,24441
3589,0.0,0.0,0.0,3611,29728,54165,24437
3590,0.0,0.0,0.0,3611,29732,54165,24433
3591,0.0,0.0,0.0,3611,29736,54165,24429
3594,0.0,0.0,0.0,3611,29740,54165,24425
3595,0.0,0.0,0.0,3611,29744,54165,24421
3596,0.0,0.0,0.0,3611,29748,54165,24417
3597,0.0,0.0,0.0,3611,29752,54165,24413
3598,0.0,0.0,0.0,3611,29756,54165,24409
3599,0.0,0.0,0.0,3611,29760,54165,24405
3601,0.0,0.0,0.0,3611,29764,54165,24401
3602,0.0,0.0,0.0,3611,29768,54165,24397
3603,0.0,0.0,0.0,3611,29772,54165,24393
3604,0.0,0.0,0.0,3611,29776,54165,24389
3605,0.0,0.0,0.0,3611,29780,54165,24385
3607,0.0,0.0,0.0,3611,29784,54165,24381
3608,0.0,0.0,0.0,3611,29788,54165,24377
3609,0.0,0.0,0.0,3611,29792,54165,24373
3610,0.0,0.0,0.0,3611,29796,54165,24369
3611,0.0,0.0,0.0,3611,29800,54165,24365
3612,0.0,0.0,0.0,3611,29804,54165,24361
3613,0.0,0.0,0.0,3611,29808,54165,24357
3614,0.0,0.0,0.0,3611,29812,54165,24353
3615,0.0,0.0,0.0,3611,29816,54165,24349
3619,0.0,0.0,0.0,3611,29820,54165,24345
3620,0.0,0.0,0.0,3611,29824,54165,24341
3621,0.0,0.0,0.0,3611,29828,54165,24337
3622,0.0,0.0,0.0,3611,29832,54165,24333
3623,0.0,0.0,0.0,3611,29836,54165,24329
3625,0.0,0.0,0.0,3611,29840,54165,24325
3626,0.0,0.0,0.0,3611,29844,54165,24321
3629,0.0,0.0,0.0,3611,29848,54165,24317
3631,0.0,0.0,0.0,3611,29852,54165,24313
3632,0.0,0.0,0.0,3611,29856,54165,24309
3633,0.0,0.0,0.0,3611,29860,54165,24305
3634,0.0,0.0,0.0,3611,29864,54165,24301
3635,0.0,0.0,0.0,3611,29868,54165,24297
3636,0.0,0.0,0.0,3611,29872,54165,24293
3637,0.0,0.0,0.0,3611,29876,54165,24289
3638,0.0,0.0,0.0,3611,29880,54165,24285
3639,0.0,0.0,0.0,3611,29884,54165,24281
3640,0.0,0.0,0.0,3611,29888,54165,24277
3641,0.0,0.0,0.0,3611,29892,54165,24273
3642,0.0,0.0,0.0,3611,29896,54165,24269
3643,0.0,0.0,0.0,3611,29900,54165,24265
3646,0.0,0.0,0.0,3611,29904,54165,24261
3647,0.0,0.0,0.0,3611,29908,54165,24257
3648,0.0,0.0,0.0,3611,29912,54165,24253
3649,0.0,0.0,0.0,3611,29916,54165,24249
3651,0.0,0.0,0.0,3611,29920,54165,24245
3652,0.0,0.0,0.0,3611,29924,54165,24241
3653,0.0,0.0,0.0,3611,29928,54165,24237
3654,0.0,0.0,0.0,3611,29932,54165,24233
3655,0.0,0.0,0.0,3611,29936,54165,24229
3656,0.0,0.0,0.0,3611,29940,54165,24225
3657,0.0,0.0,0.0,3611,29944,54165,24221
3658,0.0,0.0,0.0,3611,29948,54165,24217
3659,0.0,0.0,0.0,3611,29952,54165,24213
3660,0.0,0.0,0.0,3611,29956,54165,24209
3661,0.0,0.0,0.0,3611,29960,54165,24205
3662,0.0,0.0,0.0,3611,29964,54165,24201
3663,0.0,0.0,0.0,3611,29968,54165,24197
3664,0.0,0.0,0.0,3611,29972,54165,24193
3666,0.0,0.0,0.0,3611,29976,54165,24189
3667,0.0,0.0,0.0,3611,29980,54165,24185
3669,0.0,0.0,0.0,3611,29984,54165,24181
3670,0.0,0.0,0.0,3611,29988,54165,24177
3671,0.0,0.0,0.0,3611,29992,54165,24173
3675,0.0,0.0,0.0,3611,29996,54165,24169
3676,0.0,0.0,0.0,3611,30000,54165,24165
3677,0.0,0.0,0.0,3611,30004,54165,24161
3678,0.0,0.0,0.0,3611,30008,54165,24157
3679,0.0,0.0,0.0,3611,30012,54165,24153
3680,0.0,0.0,0.0,3611,30016,54165,24149
3681,0.0,0.0,0.0,3611,30020,54165,24145
3682,0.0,0.0,0.0,3611,30024,54165,24141
3683,0.0,0.0,0.0,3611,30028,54165,24137
3684,0.0,0.0,0.0,3611,30032,54165,24133
3686,0.0,0.0,0.0,3611,30036,54165,24129
3687,0.0,0.0,0.0,3611,30040,54165,24125
3688,0.0,0.0,0.0,3611,30044,54165,24121
3689,0.0,0.0,0.0,3611,30048,54165,24117
3690,0.0,0.0,0.0,3611,30052,54165,24113
3691,0.0,0.0,0.0,3611,30056,54165,24109
3692,0.0,0.0,0.0,3611,30060,54165,24105
3693,0.0,0.0,0.0,3611,30064,54165,24101
3695,0.0,0.0,0.0,3611,30068,54165,24097
3696,0.0,0.0,0.0,3611,30072,54165,24093
3697,0.0,0.0,0.0,3611,30076,54165,24089
3698,0.0,0.0,0.0,3611,30080,54165,24085
3701,0.0,0.0,0.0,3611,30084,54165,24081
3703,0.0,0.0,0.0,3611,30088,54165,24077
3704,0.0,0.0,0.0,3611,30092,54165,24073
3705,0.0,0.0,0.0,3611,30096,54165,24069
3707,0.0,0.0,0.0,3611,30100,54165,24065
3708,0.0,0.0,0.0,3611,30104,54165,24061
3709,0.0,0.0,0.0,3611,30108,54165,24057
3710,0.0,0.0,0.0,3611,30112,54165,24053
3711,0.0,0.0,0.0,3611,30116,54165,24049
3712,0.0,0.0,0.0,3611,30120,54165,24045
3714,0.0,0.0,0.0,3611,30124,54165,24041
3715,0.0,0.0,0.0,3611,30128,54165,24037
3717,0.0,0.0,0.0,3611,30132,54165,24033
3719,0.0,0.0,0.0,3611,30136,54165,24029
3721,0.0,0.0,0.0,3611,30140,54165,24025
3722,0.0,0.0,0.0,3611,30144,54165,24021
3723,0.0,0.0,0.0,3611,30148,54165,24017
3724,0.0,0.0,0.0,3611,30152,54165,24013
3725,0.0,0.0,0.0,3611,30156,54165,24009
3728,0.0,0.0,0.0,3611,30160,54165,24005
3729,0.0,0.0,0.0,3611,30164,54165,24001
3730,0.0,0.0,0.0,3611,30168,54165,23997
3731,0.0,0.0,0.0,3611,30172,54165,23993
3732,0.0,0.0,0.0,3611,30176,54165,23989
3736,0.0,0.0,0.0,3611,30180,54165,23985
3738,0.0,0.0,0.0,3611,30184,54165,23981
3741,0.0,0.0,0.0,3611,30188,54165,23977
3742,0.0,0.0,0.0,3611,30192,54165,23973
3743,0.0,0.0,0.0,3611,30196,54165,23969
3744,0.0,0.0,0.0,3611,30200,54165,23965
3746,0.0,0.0,0.0,3611,30204,54165,23961
3747,0.0,0.0,0.0,3611,30208,54165,23957
3748,0.0,0.0,0.0,3611,30212,54165,23953
3749,0.0,0.0,0.0,3611,30216,54165,23949
3750,0.0,0.0,0.0,3611,30220,54165,23945
3751,0.0,0.0,0.0,3611,30224,54165,23941
3752,0.0,0.0,0.0,3611,30228,54165,23937
3753,0.0,0.0,0.0,3611,30232,54165,23933
3754,0.0,0.0,0.0,3611,30236,54165,23929
3756,0.0,0.0,0.0,3611,30240,54165,23925
3757,0.0,0.0,0.0,3611,30244,54165,23921
3758,0.0,0.0,0.0,3611,30248,54165,23917
3759,0.0,0.0,0.0,3611,30252,54165,23913
3760,0.0,0.0,0.0,3611,30256,54165,23909
3761,0.0,0.0,0.0,3611,30260,54165,23905
3762,0.0,0.0,0.0,3611,30264,54165,23901
3763,0.0,0.0,0.0,3611,30268,54165,23897
3764,0.0,0.0,0.0,3611,30272,54165,23893
3765,0.0,0.0,0.0,3611,30276,54165,23889
3766,0.0,0.0,0.0,3611,30280,54165,23885
3767,0.0,0.0,0.0,3611,30284,54165,23881
3768,0.0,0.0,0.0,3611,30288,54165,23877
3769,0.0,0.0,0.0,3611,30292,54165,23873
3770,0.0,0.0,0.0,3611,30296,54165,23869
3771,0.0,0.0,0.0,3611,30300,54165,23865
3772,0.0,0.0,0.0,3611,30304,54165,23861
3773,0.0,0.0,0.0,3611,30308,54165,23857
3774,0.0,0.0,0.0,3611,30312,54165,23853
3775,0.0,0.0,0.0,3611,30316,54165,23849
3776,0.0,0.0,0.0,3611,30320,54165,23845
3777,0.0,0.0,0.0,3611,30324,54165,23841
3778,0.0,0.0,0.0,3611,30328,54165,23837
3779,0.0,0.0,0.0,3611,30332,54165,23833
3780,0.0,0.0,0.0,3611,30336,54165,23829
3781,0.0,0.0,0.0,3611,30340,54165,23825
3782,0.0,0.0,0.0,3611,30344,54165,23821
3783,0.0,0.0,0.0,3611,30348,54165,23817
3784,0.0,0.0,0.0,3611,30352,54165,23813
3785,0.0,0.0,0.0,3611,30356,54165,23809
3786,0.0,0.0,0.0,3611,30360,54165,23805
3788,0.0,0.0,0.0,3611,30364,54165,23801
3789,0.0,0.0,0.0,3611,30368,54165,23797
3790,0.0,0.0,0.0,3611,30372,54165,23793
3791,0.0,0.0,0.0,3611,30376,54165,23789
3792,0.0,0.0,0.0,3611,30380,54165,23785
3793,0.0,0.0,0.0,3611,30384,54165,23781
3794,0.0,0.0,0.0,3611,30388,54165,23777
3796,0.0,0.0,0.0,3611,30392,54165,23773
3800,0.0,0.0,0.0,3611,30396,54165,23769
3801,0.0,0.0,0.0,3611,30400,54165,23765
3802,0.0,0.0,0.0,3611,30404,54165,23761
3803,0.0,0.0,0.0,3611,30408,54165,23757
3805,0.0,0.0,0.0,3611,30412,54165,23753
3806,0.0,0.0,0.0,3611,30416,54165,23749
3807,0.0,0.0,0.0,3611,30420,54165,23745
3809,0.0,0.0,0.0,3611,30424,54165,23741
3810,0.0,0.0,0.0,3611,30428,54165,23737
3811,0.0,0.0,0.0,3611,30432,54165,23733
3812,0.0,0.0,0.0,3611,30436,54165,23729
3813,0.0,0.0,0.0,3611,30440,54165,23725
3814,0.0,0.0,0.0,3611,30444,54165,23721
3815,0.0,0.0,0.0,3611,30448,54165,23717
3817,0.0,0.0,0.0,3611,30452,54165,23713
3819,0.0,0.0,0.0,3611,30456,54165,23709
3821,0.0,0.0,0.0,3611,30460,54165,23705
3823,0.0,0.0,0.0,3611,30464,54165,23701
3826,0.0,0.0,0.0,3611,30468,54165,23697
3827,0.0,0.0,0.0,3611,30472,54165,23693
3828,0.0,0.0,0.0,3611,30476,54165,23689
3829,0.0,0.0,0.0,3611,30480,54165,23685
3831,0.0,0.0,0.0,3611,30484,54165,23681
3832,0.0,0.0,0.0,3611,30488,54165,23677
3834,0.0,0.0,0.0,3611,30492,54165,23673
3838,0.0,0.0,0.0,3611,30496,54165,23669
3839,0.0,0.0,0.0,3611,30500,54165,23665
3840,0.0,0.0,0.0,3611,30504,54165,23661
3841,0.0,0.0,0.0,3611,30508,54165,23657
3842,0.0,0.0,0.0,3611,30512,54165,23653
3845,0.0,0.0,0.0,3611,30516,54165,23649
3847,0.0,0.0,0.0,3611,30520,54165,23645
3849,0.0,0.0,0.0,3611,30524,54165,23641
3852,0.0,0.0,0.0,3611,30528,54165,23637
3853,0.0,0.0,0.0,3611,30532,54165,23633
3854,0.0,0.0,0.0,3611,30536,54165,23629
3855,0.0,0.0,0.0,3611,30540,54165,23625
3858,0.0,0.0,0.0,3611,30544,54165,23621
3859,0.0,0.0,0.0,3611,30548,54165,23617
3860,0.0,0.0,0.0,3611,30552,54165,23613
3861,0.0,0.0,0.0,3611,30556,54165,23609
3862,0.0,0.0,0.0,3611,30560,54165,23605
3863,0.0,0.0,0.0,3611,30564,54165,23601
3864,0.0,0.0,0.0,3611,30568,54165,23597
3865,0.0,0.0,0.0,3611,30572,54165,23593
3867,0.0,0.0,0.0,3611,30576,54165,23589
3868,0.0,0.0,0.0,3611,30580,54165,23585
3870,0.0,0.0,0.0,3611,30584,54165,23581
3871,0.0,0.0,0.0,3611,30588,54165,23577
3872,0.0,0.0,0.0,3611,30592,54165,23573
3873,0.0,0.0,0.0,3611,30596,54165,23569
3874,0.0,0.0,0.0,3611,30600,54165,23565
3875,0.0,0.0,0.0,3611,30604,54165,23561
3876,0.0,0.0,0.0,3611,30608,54165,23557
3877,0.0,0.0,0.0,3611,30612,54165,23553
3878,0.0,0.0,0.0,3611,30616,54165,23549
3879,0.0,0.0,0.0,3611,30620,54165,23545
3880,0.0,0.0,0.0,3611,30624,54165,23541
3881,0.0,0.0,0.0,3611,30628,54165,23537
3882,0.0,0.0,0.0,3611,30632,54165,23533
3883,0.0,0.0,0.0,3611,30636,54165,23529
3884,0.0,0.0,0.0,3611,30640,54165,23525
3885,0.0,0.0,0.0,3611,30644,54165,23521
3886,0.0,0.0,0.0,3611,30648,54165,23517
3887,0.0,0.0,0.0,3611,30652,54165,23513
3889,0.0,0.0,0.0,3611,30656,54165,23509
3890,0.0,0.0,0.0,3611,30660,54165,23505
3891,0.0,0.0,0.0,3611,30664,54165,23501
3892,0.0,0.0,0.0,3611,30668,54165,23497
3893,0.0,0.0,0.0,3611,30672,54165,23493
3894,0.0,0.0,0.0,3611,30676,54165,23489
3895,0.0,0.0,0.0,3611,30680,54165,23485
3896,0.0,0.0,0.0,3611,30684,54165,23481
3897,0.0,0.0,0.0,3611,30688,54165,23477
3899,0.0,0.0,0.0,3611,30692,54165,23473
3900,0.0,0.0,0.0,3611,30696,54165,23469
3901,0.0,0.0,0.0,3611,30700,54165,23465
3902,0.0,0.0,0.0,3611,30704,54165,23461
3903,0.0,0.0,0.0,3611,30708,54165,23457
3904,0.0,0.0,0.0,3611,30712,54165,23453
3905,0.0,0.0,0.0,3611,30716,54165,23449
3906,0.0,0.0,0.0,3611,30720,54165,23445
3907,0.0,0.0,0.0,3611,30724,54165,23441
3908,0.0,0.0,0.0,3611,30728,54165,23437
3909,0.0,0.0,0.0,3611,30732,54165,23433
3910,0.0,0.0,0.0,3611,30736,54165,23429
3911,0.0,0.0,0.0,3611,30740,54165,23425
3912,0.0,0.0,0.0,3611,30744,54165,23421
3913,0.0,0.0,0.0,3611,30748,54165,23417
3914,0.0,0.0,0.0,3611,30752,54165,23413
3915,0.0,0.0,0.0,3611,30756,54165,23409
3916,0.0,0.0,0.0,3611,30760,54165,23405
3917,0.0,0.0,0.0,3611,30764,54165,23401
3919,0.0,0.0,0.0,3611,30768,54165,23397
3920,0.0,0.0,0.0,3611,30772,54165,23393
3921,0.0,0.0,0.0,3611,30776,54165,23389
3922,0.0,0.0,0.0,3611,30780,54165,23385
3923,0.0,0.0,0.0,3611,30784,54165,23381
3924,0.0,0.0,0.0,3611,30788,54165,23377
3926,0.0,0.0,0.0,3611,30792,54165,23373
3929,0.0,0.0,0.0,3611,30796,54165,23369
3930,0.0,0.0,0.0,3611,30800,54165,23365
3932,0.0,0.0,0.0,3611,30804,54165,23361
3933,0.0,0.0,0.0,3611,30808,54165,23357
3936,0.0,0.0,0.0,3611,30812,54165,23353
3938,0.0,0.0,0.0,3611,30816,54165,23349
3939,0.0,0.0,0.0,3611,30820,54165,23345
3942,0.0,0.0,0.0,3611,30824,54165,23341
3943,0.0,0.0,0.0,3611,30828,54165,23337
3944,0.0,0.0,0.0,3611,30832,54165,23333
3946,0.0,0.0,0.0,3611,30836,54165,23329
3947,0.0,0.0,0.0,3611,30840,54165,23325
3948,0.0,0.0,0.0,3611,30844,54165,23321
3950,0.0,0.0,0.0,3611,30848,54165,23317
3951,0.0,0.0,0.0,3611,30852,54165,23313
3953,0.0,0.0,0.0,3611,30856,54165,23309
3954,0.0,0.0,0.0,3611,30860,54165,23305
3955,0.0,0.0,0.0,3611,30864,54165,23301
3956,0.0,0.0,0.0,3611,30868,54165,23297
3957,0.0,0.0,0.0,3611,30872,54165,23293
3958,0.0,0.0,0.0,3611,30876,54165,23289
3959,0.0,0.0,0.0,3611,30880,54165,23285
3960,0.0,0.0,0.0,3611,30884,54165,23281
3961,0.0,0.0,0.0,3611,30888,54165,23277
3962,0.0,0.0,0.0,3611,30892,54165,23273
3963,0.0,0.0,0.0,3611,30896,54165,23269
3964,0.0,0.0,0.0,3611,30900,54165,23265
3965,0.0,0.0,0.0,3611,30904,54165,23261
3966,0.0,0.0,0.0,3611,30908,54165,23257
3967,0.0,0.0,0.0,3611,30912,54165,23253
3968,0.0,0.0,0.0,3611,30916,54165,23249
3970,0.0,0.0,0.0,3611,30920,54165,23245
3971,0.0,0.0,0.0,3611,30924,54165,23241
3972,0.0,0.0,0.0,3611,30928,54165,23237
3975,0.0,0.0,0.0,3611,30932,54165,23233
3976,0.0,0.0,0.0,3611,30936,54165,23229
3978,0.0,0.0,0.0,3611,30940,54165,23225
3979,0.0,0.0,0.0,3611,30944,54165,23221
3980,0.0,0.0,0.0,3611,30948,54165,23217
3981,0.0,0.0,0.0,3611,30952,54165,23213
3982,0.0,0.0,0.0,3611,30956,54165,23209
3983,0.0,0.0,0.0,3611,30960,54165,23205
3984,0.0,0.0,0.0,3611,30964,54165,23201
3985,0.0,0.0,0.0,3611,30968,54165,23197
3986,0.0,0.0,0.0,3611,30972,54165,23193
3987,0.0,0.0,0.0,3611,30976,54165,23189
3988,0.0,0.0,0.0,3611,30980,54165,23185
3989,0.0,0.0,0.0,3611,30984,54165,23181
3990,0.0,0.0,0.0,3611,30988,54165,23177
3991,0.0,0.0,0.0,3611,30992,54165,23173
3992,0.0,0.0,0.0,3611,30996,54165,23169
3993,0.0,0.0,0.0,3611,31000,54165,23165
3995,0.0,0.0,0.0,3611,31004,54165,23161
3996,0.0,0.0,0.0,3611,31008,54165,23157
3997,0.0,0.0,0.0,3611,31012,54165,23153
3998,0.0,0.0,0.0,3611,31016,54165,23149
4000,0.0,0.0,0.0,3611,31020,54165,23145
4001,0.0,0.0,0.0,3611,31024,54165,23141
4004,0.0,0.0,0.0,3611,31028,54165,23137
4005,0.0,0.0,0.0,3611,31032,54165,23133
4006,0.0,0.0,0.0,3611,31036,54165,23129
4008,0.0,0.0,0.0,3611,31040,54165,23125
4010,0.0,0.0,0.0,3611,31044,54165,23121
4012,0.0,0.0,0.0,3611,31048,54165,23117
4013,0.0,0.0,0.0,3611,31052,54165,23113
4014,0.0,0.0,0.0,3611,31056,54165,23109
4015,0.0,0.0,0.0,3611,31060,54165,23105
4017,0.0,0.0,0.0,3611,31064,54165,23101
4018,0.0,0.0,0.0,3611,31068,54165,23097
4019,0.0,0.0,0.0,3611,31072,54165,23093
4020,0.0,0.0,0.0,3611,31076,54165,23089
4022,0.0,0.0,0.0,3611,31080,54165,23085
4023,0.0,0.0,0.0,3611,31084,54165,23081
4024,0.0,0.0,0.0,3611,31088,54165,23077
4025,0.0,0.0,0.0,3611,31092,54165,23073
4026,0.0,0.0,0.0,3611,31096,54165,23069
4028,0.0,0.0,0.0,3611,31100,54165,23065
4030,0.0,0.0,0.0,3611,31104,54165,23061
4031,0.0,0.0,0.0,3611,31108,54165,23057
4032,0.0,0.0,0.0,3611,31112,54165,23053
4033,0.0,0.0,0.0,3611,31116,54165,23049
4034,0.0,0.0,0.0,3611,31120,54165,23045
4035,0.0,0.0,0.0,3611,31124,54165,23041
4036,0.0,0.0,0.0,3611,31128,54165,23037
4037,0.0,0.0,0.0,3611,31132,54165,23033
4038,0.0,0.0,0.0,3611,31136,54165,23029
4040,0.0,0.0,0.0,3611,31140,54165,23025
4042,0.0,0.0,0.0,3611,31144,54165,23021
4043,0.0,0.0,0.0,3611,31148,54165,23017
4044,0.0,0.0,0.0,3611,31152,54165,23013
4045,0.0,0.0,0.0,3611,31156,54165,23009
4047,0.0,0.0,0.0,3611,31160,54165,23005
4048,0.0,0.0,0.0,3611,31164,54165,23001
4049,0.0,0.0,0.0,3611,31168,54165,22997
4050,0.0,0.0,0.0,3611,31172,54165,22993
4052,0.0,0.0,0.0,3611,31176,54165,22989
4053,0.0,0.0,0.0,3611,31180,54165,22985
4054,0.0,0.0,0.0,3611,31184,54165,22981
4057,0.0,0.0,0.0,3611,31188,54165,22977
4058,0.0,0.0,0.0,3611,31192,54165,22973
4060,0.0,0.0,0.0,3611,31196,54165,22969
4061,0.0,0.0,0.0,3611,31200,54165,22965
4062,0.0,0.0,0.0,3611,31204,54165,22961
4063,0.0,0.0,0.0,3611,31208,54165,22957
4065,0.0,0.0,0.0,3611,31212,54165,22953
4066,0.0,0.0,0.0,3611,31216,54165,22949
4068,0.0,0.0,0.0,3611,31220,54165,22945
4069,0.0,0.0,0.0,3611,31224,54165,22941
4071,0.0,0.0,0.0,3611,31228,54165,22937
4072,0.0,0.0,0.0,3611,31232,54165,22933
4073,0.0,0.0,0.0,3611,31236,54165,22929
4074,0.0,0.0,0.0,3611,31240,54165,22925
4075,0.0,0.0,0.0,3611,31244,54165,22921
4076,0.0,0.0,0.0,3611,31248,54165,22917
4077,0.0,0.0,0.0,3611,31252,54165,22913
4078,0.0,0.0,0.0,3611,31256,54165,22909
4080,0.0,0.0,0.0,3611,31260,54165,22905
4081,0.0,0.0,0.0,3611,31264,54165,22901
4082,0.0,0.0,0.0,3611,31268,54165,22897
4083,0.0,0.0,0.0,3611,31272,54165,22893
4084,0.0,0.0,0.0,3611,31276,54165,22889
4085,0.0,0.0,0.0,3611,31280,54165,22885
4086,0.0,0.0,0.0,3611,31284,54165,22881
4087,0.0,0.0,0.0,3611,31288,54165,22877
4088,0.0,0.0,0.0,3611,31292,54165,22873
4089,0.0,0.0,0.0,3611,31296,54165,22869
4090,0.0,0.0,0.0,3611,31300,54165,22865
4091,0.0,0.0,0.0,3611,31304,54165,22861
4093,0.0,0.0,0.0,3611,31308,54165,22857
4094,0.0,0.0,0.0,3611,31312,54165,22853
4095,0.0,0.0,0.0,3611,31316,54165,22849
4096,0.0,0.0,0.0,3611,31320,54165,22845
4097,0.0,0.0,0.0,3611,31324,54165,22841
4098,0.0,0.0,0.0,3611,31328,54165,22837
4101,0.0,0.0,0.0,3611,31332,54165,22833
4102,0.0,0.0,0.0,3611,31336,54165,22829
4103,0.0,0.0,0.0,3611,31340,54165,22825
4104,0.0,0.0,0.0,3611,31344,54165,22821
4105,0.0,0.0,0.0,3611,31348,54165,22817
4107,0.0,0.0,0.0,3611,31352,54165,22813
4108,0.0,0.0,0.0,3611,31356,54165,22809
4109,0.0,0.0,0.0,3611,31360,54165,22805
4110,0.0,0.0,0.0,3611,31364,54165,22801
4111,0.0,0.0,0.0,3611,31368,54165,22797
4112,0.0,0.0,0.0,3611,31372,54165,22793
4113,0.0,0.0,0.0,3611,31376,54165,22789
4114,0.0,0.0,0.0,3611,31380,54165,22785
4115,0.0,0.0,0.0,3611,31384,54165,22781
4116,0.0,0.0,0.0,3611,31388,54165,22777
4117,0.0,0.0,0.0,3611,31392,54165,22773
4118,0.0,0.0,0.0,3611,31396,54165,22769
4119,0.0,0.0,0.0,3611,31400,54165,22765
4122,0.0,0.0,0.0,3611,31404,54165,22761
4123,0.0,0.0,0.0,3611,31408,54165,22757
4124,0.0,0.0,0.0,3611,31412,54165,22753
4125,0.0,0.0,0.0,3611,31416,54165,22749
4126,0.0,0.0,0.0,3611,31420,54165,22745
4127,0.0,0.0,0.0,3611,31424,54165,22741
4128,0.0,0.0,0.0,3611,31428,54165,22737
4129,0.0,0.0,0.0,3611,31432,54165,22733
4130,0.0,0.0,0.0,3611,31436,54165,22729
4131,0.0,0.0,0.0,3611,31440,54165,22725
4132,0.0,0.0,0.0,3611,31444,54165,22721
4133,0.0,0.0,0.0,3611,31448,54165,22717
4134,0.0,0.0,0.0,3611,31452,54165,22713
4135,0.0,0.0,0.0,3611,31456,54165,22709
4136,0.0,0.0,0.0,3611,31460,54165,22705
4137,0.0,0.0,0.0,3611,31464,54165,22701
4139,0.0,0.0,0.0,3611,31468,54165,22697
4140,0.0,0.0,0.0,3611,31472,54165,22693
4142,0.0,0.0,0.0,3611,31476,54165,22689
4144,0.0,0.0,0.0,3611,31480,54165,22685
4145,0.0,0.0,0.0,3611,31484,54165,22681
4146,0.0,0.0,0.0,3611,31488,54165,22677
4148,0.0,0.0,0.0,3611,31492,54165,22673
4149,0.0,0.0,0.0,3611,31496,54165,22669
4150,0.0,0.0,0.0,3611,31500,54165,22665
4151,0.0,0.0,0.0,3611,31504,54165,22661
4153,0.0,0.0,0.0,3611,31508,54165,22657
4154,0.0,0.0,0.0,3611,31512,54165,22653
4155,0.0,0.0,0.0,3611,31516,54165,22649
4156,0.0,0.0,0.0,3611,31520,54165,22645
4157,0.0,0.0,0.0,3611,31524,54165,22641
4159,0.0,0.0,0.0,3611,31528,54165,22637
4160,0.0,0.0,0.0,3611,31532,54165,22633
4162,0.0,0.0,0.0,3611,31536,54165,22629
4163,0.0,0.0,0.0,3611,31540,54165,22625
4164,0.0,0.0,0.0,3611,31544,54165,22621
4167,0.0,0.0,0.0,3611,31548,54165,22617
4168,0.0,0.0,0.0,3611,31552,54165,22613
4169,0.0,0.0,0.0,3611,31556,54165,22609
4170,0.0,0.0,0.0,3611,31560,54165,22605
4173,0.0,0.0,0.0,3611,31564,54165,22601
4174,0.0,0.0,0.0,3611,31568,54165,22597
4175,0.0,0.0,0.0,3611,31572,54165,22593
4176,0.0,0.0,0.0,3611,31576,54165,22589
4177,0.0,0.0,0.0,3611,31580,54165,22585
4178,0.0,0.0,0.0,3611,31584,54165,22581
4179,0.0,0.0,0.0,3611,31588,54165,22577
4180,0.0,0.0,0.0,3611,31592,54165,22573
4181,0.0,0.0,0.0,3611,31596,54165,22569
4182,0.0,0.0,0.0,3611,31600,54165,22565
4183,0.0,0.0,0.0,3611,31604,54165,22561
4184,0.0,0.0,0.0,3611,31608,54165,22557
4185,0.0,0.0,0.0,3611,31612,54165,22553
4186,0.0,0.0,0.0,3611,31616,54165,22549
4187,0.0,0.0,0.0,3611,31620,54165,22545
4188,0.0,0.0,0.0,3611,31624,54165,22541
4189,0.0,0.0,0.0,3611,31628,54165,22537
4190,0.0,0.0,0.0,3611,31632,54165,22533
4191,0.0,0.0,0.0,3611,31636,54165,22529
4192,0.0,0.0,0.0,3611,31640,54165,22525
4193,0.0,0.0,0.0,3611,31644,54165,22521
4194,0.0,0.0,0.0,3611,31648,54165,22517
4195,0.0,0.0,0.0,3611,31652,54165,22513
4196,0.0,0.0,0.0,3611,31656,54165,22509
4198,0.0,0.0,0.0,3611,31660,54165,22505
4199,0.0,0.0,0.0,3611,31664,54165,22501
4201,0.0,0.0,0.0,3611,31668,54165,22497
4202,0.0,0.0,0.0,3611,31672,54165,22493
4203,0.0,0.0,0.0,3611,31676,54165,22489
4204,0.0,0.0,0.0,3611,31680,54165,22485
4205,0.0,0.0,0.0,3611,31684,54165,22481
4206,0.0,0.0,0.0,3611,31688,54165,22477
4207,0.0,0.0,0.0,3611,31692,54165,22473
4208,0.0,0.0,0.0,3611,31696,54165,22469
4209,0.0,0.0,0.0,3611,31700,54165,22465
4211,0.0,0.0,0.0,3611,31704,54165,22461
4213,0.0,0.0,0.0,3611,31708,54165,22457
4214,0.0,0.0,0.0,3611,31712,54165,22453
4215,0.0,0.0,0.0,3611,31716,54165,22449
4217,0.0,0.0,0.0,3611,31720,54165,22445
4220,0.0,0.0,0.0,3611,31724,54165,22441
4222,0.0,0.0,0.0,3611,31728,54165,22437
4223,0.0,0.0,0.0,3611,31732,54165,22433
4224,0.0,0.0,0.0,3611,31736,54165,22429
4225,0.0,0.0,0.0,3611,31740,54165,22425
4226,0.0,0.0,0.0,3611,31744,54165,22421
4227,0.0,0.0,0.0,3611,31748,54165,22417
4228,0.0,0.0,0.0,3611,31752,54165,22413
4229,0.0,0.0,0.0,3611,31756,54165,22409
4230,0.0,0.0,0.0,3611,31760,54165,22405
4231,0.0,0.0,0.0,3611,31764,54165,22401
4232,0.0,0.0,0.0,3611,31768,54165,22397
4233,0.0,0.0,0.0,3611,31772,54165,22393
4234,0.0,0.0,0.0,3611,31776,54165,22389
4235,0.0,0.0,0.0,3611,31780,54165,22385
4236,0.0,0.0,0.0,3611,31784,54165,22381
4238,0.0,0.0,0.0,3611,31788,54165,22377
4240,0.0,0.0,0.0,3611,31792,54165,22373
4241,0.0,0.0,0.0,3611,31796,54165,22369
4242,0.0,0.0,0.0,3611,31800,54165,22365
4243,0.0,0.0,0.0,3611,31804,54165,22361
4246,0.0,0.0,0.0,3611,31808,54165,22357
4247,0.0,0.0,0.0,3611,31812,54165,22353
4248,0.0,0.0,0.0,3611,31816,54165,22349
4249,0.0,0.0,0.0,3611,31820,54165,22345
4250,0.0,0.0,0.0,3611,31824,54165,22341
4251,0.0,0.0,0.0,3611,31828,54165,22337
4252,0.0,0.0,0.0,3611,31832,54165,22333
4253,0.0,0.0,0.0,3611,31836,54165,22329
4254,0.0,0.0,0.0,3611,31840,54165,22325
4255,0.0,0.0,0.0,3611,31844,54165,22321
4256,0.0,0.0,0.0,3611,31848,54165,22317
4257,0.0,0.0,0.0,3611,31852,54165,22313
4258,0.0,0.0,0.0,3611,31856,54165,22309
4260,0.0,0.0,0.0,3611,31860,54165,22305
4261,0.0,0.0,0.0,3611,31864,54165,22301
4263,0.0,0.0,0.0,3611,31868,54165,22297
4264,0.0,0.0,0.0,3611,31872,54165,22293
4265,0.0,0.0,0.0,3611,31876,54165,22289
4266,0.0,0.0,0.0,3611,31880,54165,22285
4268,0.0,0.0,0.0,3611,31884,54165,22281
4269,0.0,0.0,0.0,3611,31888,54165,22277
4270,0.0,0.0,0.0,3611,31892,54165,22273
4271,0.0,0.0,0.0,3611,31896,54165,22269
4272,0.0,0.0,0.0,3611,31900,54165,22265
4273,0.0,0.0,0.0,3611,31904,54165,22261
4274,0.0,0.0,0.0,3611,31908,54165,22257
4275,0.0,0.0,0.0,3611,31912,54165,22253
4276,0.0,0.0,0.0,3611,31916,54165,22249
4277,0.0,0.0,0.0,3611,31920,54165,22245
4278,0.0,0.0,0.0,3611,31924,54165,22241
4282,0.0,0.0,0.0,3611,31928,54165,22237
4283,0.0,0.0,0.0,3611,31932,54165,22233
4284,0.0,0.0,0.0,3611,31936,54165,22229
4286,0.0,0.0,0.0,3611,31940,54165,22225
4287,0.0,0.0,0.0,3611,31944,54165,22221
4289,0.0,0.0,0.0,3611,31948,54165,22217
4290,0.0,0.0,0.0,3611,31952,54165,22213
4293,0.0,0.0,0.0,3611,31956,54165,22209
4295,0.0,0.0,0.0,3611,31960,54165,22205
4296,0.0,0.0,0.0,3611,31964,54165,22201
4297,0.0,0.0,0.0,3611,31968,54165,22197
4298,0.0,0.0,0.0,3611,31972,54165,22193
4299,0.0,0.0,0.0,3611,31976,54165,22189
4300,0.0,0.0,0.0,3611,31980,54165,22185
4301,0.0,0.0,0.0,3611,31984,54165,22181
4302,0.0,0.0,0.0,3611,31988,54165,22177
4303,0.0,0.0,0.0,3611,31992,54165,22173
4304,0.0,0.0,0.0,3611,31996,54165,22169
4306,0.0,0.0,0.0,3611,32000,54165,22165
4307,0.0,0.0,0.0,3611,32004,54165,22161
4309,0.0,0.0,0.0,3611,32008,54165,22157
4310,0.0,0.0,0.0,3611,32012,54165,22153
4311,0.0,0.0,0.0,3611,32016,54165,22149
4312,0.0,0.0,0.0,3611,32020,54165,22145
4313,0.0,0.0,0.0,3611,32024,54165,22141
4315,0.0,0.0,0.0,3611,32028,54165,22137
4316,0.0,0.0,0.0,3611,32032,54165,22133
4317,0.0,0.0,0.0,3611,32036,54165,22129
4318,0.0,0.0,0.0,3611,32040,54165,22125
4319,0.0,0.0,0.0,3611,32044,54165,22121
4320,0.0,0.0,0.0,3611,32048,54165,22117
4322,0.0,0.0,0.0,3611,32052,54165,22113
4323,0.0,0.0,0.0,3611,32056,54165,22109
4324,0.0,0.0,0.0,3611,32060,54165,22105
4325,0.0,0.0,0.0,3611,32064,54165,22101
4326,0.0,0.0,0.0,3611,32068,54165,22097
4327,0.0,0.0,0.0,3611,32072,54165,22093
4328,0.0,0.0,0.0,3611,32076,54165,22089
4329,0.0,0.0,0.0,3611,32080,54165,22085
4331,0.0,0.0,0.0,3611,32084,54165,22081
4332,0.0,0.0,0.0,3611,32088,54165,22077
4333,0.0,0.0,0.0,3611,32092,54165,22073
4334,0.0,0.0,0.0,3611,32096,54165,22069
4335,0.0,0.0,0.0,3611,32100,54165,22065
4336,0.0,0.0,0.0,3611,32104,54165,22061
4337,0.0,0.0,0.0,3611,32108,54165,22057
4338,0.0,0.0,0.0,3611,32112,54165,22053
4339,0.0,0.0,0.0,3611,32116,54165,22049
4340,0.0,0.0,0.0,3611,32120,54165,22045
4341,0.0,0.0,0.0,3611,32124,54165,22041
4342,0.0,0.0,0.0,3611,32128,54165,22037
4344,0.0,0.0,0.0,3611,32132,54165,22033
4345,0.0,0.0,0.0,3611,32136,54165,22029
4346,0.0,0.0,0.0,3611,32140,54165,22025
4347,0.0,0.0,0.0,3611,32144,54165,22021
4348,0.0,0.0,0.0,3611,32148,54165,22017
4353,0.0,0.0,0.0,3611,32152,54165,22013
4354,0.0,0.0,0.0,3611,32156,54165,22009
4355,0.0,0.0,0.0,3611,32160,54165,22005
4357,0.0,0.0,0.0,3611,32164,54165,22001
4358,0.0,0.0,0.0,3611,32168,54165,21997
4360,0.0,0.0,0.0,3611,32172,54165,21993
4362,0.0,0.0,0.0,3611,32176,54165,21989
4363,0.0,0.0,0.0,3611,32180,54165,21985
4364,0.0,0.0,0.0,3611,32184,54165,21981
4365,0.0,0.0,0.0,3611,32188,54165,21977
4366,0.0,0.0,0.0,3611,32192,54165,21973
4367,0.0,0.0,0.0,3611,32196,54165,21969
4368,0.0,0.0,0.0,3611,32200,54165,21965
4369,0.0,0.0,0.0,3611,32204,54165,21961
4370,0.0,0.0,0.0,3611,32208,54165,21957
4372,0.0,0.0,0.0,3611,32212,54165,21953
4373,0.0,0.0,0.0,3611,32216,54165,21949
4374,0.0,0.0,0.0,3611,32220,54165,21945
4376,0.0,0.0,0.0,3611,32224,54165,21941
4377,0.0,0.0,0.0,3611,32228,54165,21937
4378,0.0,0.0,0.0,3611,32232,54165,21933
4379,0.0,0.0,0.0,3611,32236,54165,21929
4380,0.0,0.0,0.0,3611,32240,54165,21925
4381,0.0,0.0,0.0,3611,32244,54165,21921
4382,0.0,0.0,0.0,3611,32248,54165,21917
4384,0.0,0.0,0.0,3611,32252,54165,21913
4386,0.0,0.0,0.0,3611,32256,54165,21909
4387,0.0,0.0,0.0,3611,32260,54165,21905
4390,0.0,0.0,0.0,3611,32264,54165,21901
4391,0.0,0.0,0.0,3611,32268,54165,21897
4392,0.0,0.0,0.0,3611,32272,54165,21893
4394,0.0,0.0,0.0,3611,32276,54165,21889
4396,0.0,0.0,0.0,3611,32280,54165,21885
4397,0.0,0.0,0.0,3611,32284,54165,21881
4398,0.0,0.0,0.0,3611,32288,54165,21877
4400,0.0,0.0,0.0,3611,32292,54165,21873
4401,0.0,0.0,0.0,3611,32296,54165,21869
4402,0.0,0.0,0.0,3611,32300,54165,21865
4403,0.0,0.0,0.0,3611,32304,54165,21861
4404,0.0,0.0,0.0,3611,32308,54165,21857
4405,0.0,0.0,0.0,3611,32312,54165,21853
4406,0.0,0.0,0.0,3611,32316,54165,21849
4407,0.0,0.0,0.0,3611,32320,54165,21845
4408,0.0,0.0,0.0,3611,32324,54165,21841
4410,0.0,0.0,0.0,3611,32328,54165,21837
4411,0.0,0.0,0.0,3611,32332,54165,21833
4412,0.0,0.0,0.0,3611,32336,54165,21829
4414,0.0,0.0,0.0,3611,32340,54165,21825
4415,0.0,0.0,0.0,3611,32344,54165,21821
4419,0.0,0.0,0.0,3611,32348,54165,21817
4420,0.0,0.0,0.0,3611,32352,54165,21813
4421,0.0,0.0,0.0,3611,32356,54165,21809
4422,0.0,0.0,0.0,3611,32360,54165,21805
4423,0.0,0.0,0.0,3611,32364,54165,21801
4424,0.0,0.0,0.0,3611,32368,54165,21797
4425,0.0,0.0,0.0,3611,32372,54165,21793
4426,0.0,0.0,0.0,3611,32376,54165,21789
4427,0.0,0.0,0.0,3611,32380,54165,21785
4431,0.0,0.0,0.0,3611,32384,54165,21781
4432,0.0,0.0,0.0,3611,32388,54165,21777
4433,0.0,0.0,0.0,3611,32392,54165,21773
4435,0.0,0.0,0.0,3611,32396,54165,21769
4436,0.0,0.0,0.0,3611,32400,54165,21765
4437,0.0,0.0,0.0,3611,32404,54165,21761
4439,0.0,0.0,0.0,3611,32408,54165,21757
4441,0.0,0.0,0.0,3611,32412,54165,21753
4442,0.0,0.0,0.0,3611,32416,54165,21749
4443,0.0,0.0,0.0,3611,32420,54165,21745
4444,0.0,0.0,0.0,3611,32424,54165,21741
4445,0.0,0.0,0.0,3611,32428,54165,21737
4446,0.0,0.0,0.0,3611,32432,54165,21733
4448,0.0,0.0,0.0,3611,32436,54165,21729
4449,0.0,0.0,0.0,3611,32440,54165,21725
4450,0.0,0.0,0.0,3611,32444,54165,21721
4453,0.0,0.0,0.0,3611,32448,54165,21717
4454,0.0,0.0,0.0,3611,32452,54165,21713
4455,0.0,0.0,0.0,3611,32456,54165,21709
4456,0.0,0.0,0.0,3611,32460,54165,21705
4458,0.0,0.0,0.0,3611,32464,54165,21701
4460,0.0,0.0,0.0,3611,32468,54165,21697
4461,0.0,0.0,0.0,3611,32472,54165,21693
4462,0.0,0.0,0.0,3611,32476,54165,21689
4464,0.0,0.0,0.0,3611,32480,54165,21685
4465,0.0,0.0,0.0,3611,32484,54165,21681
4466,0.0,0.0,0.0,3611,32488,54165,21677
4467,0.0,0.0,0.0,3611,32492,54165,21673
4468,0.0,0.0,0.0,3611,32496,54165,21669
4469,0.0,0.0,0.0,3611,32500,54165,21665
4471,0.0,0.0,0.0,3611,32504,54165,21661
4472,0.0,0.0,0.0,3611,32508,54165,21657
4473,0.0,0.0,0.0,3611,32512,54165,21653
4474,0.0,0.0,0.0,3611,32516,54165,21649
4475,0.0,0.0,0.0,3611,32520,54165,21645
4476,0.0,0.0,0.0,3611,32524,54165,21641
4477,0.0,0.0,0.0,3611,32528,54165,21637
4478,0.0,0.0,0.0,3611,32532,54165,21633
4479,0.0,0.0,0.0,3611,32536,54165,21629
4480,0.0,0.0,0.0,3611,32540,54165,21625
4481,0.0,0.0,0.0,3611,32544,54165,21621
4482,0.0,0.0,0.0,3611,32548,54165,21617
4483,0.0,0.0,0.0,3611,32552,54165,21613
4484,0.0,0.0,0.0,3611,32556,54165,21609
4485,0.0,0.0,0.0,3611,32560,54165,21605
4486,0.0,0.0,0.0,3611,32564,54165,21601
4487,0.0,0.0,0.0,3611,32568,54165,21597
4488,0.0,0.0,0.0,3611,32572,54165,21593
4489,0.0,0.0,0.0,3611,32576,54165,21589
4491,0.0,0.0,0.0,3611,32580,54165,21585
4492,0.0,0.0,0.0,3611,32584,54165,21581
4493,0.0,0.0,0.0,3611,32588,54165,21577
4494,0.0,0.0,0.0,3611,32592,54165,21573
4496,0.0,0.0,0.0,3611,32596,54165,21569
4498,0.0,0.0,0.0,3611,32600,54165,21565
4499,0.0,0.0,0.0,3611,32604,54165,21561
4501,0.0,0.0,0.0,3611,32608,54165,21557
4502,0.0,0.0,0.0,3611,32612,54165,21553
4503,0.0,0.0,0.0,3611,32616,54165,21549
4504,0.0,0.0,0.0,3611,32620,54165,21545
4505,0.0,0.0,0.0,3611,32624,54165,21541
4506,0.0,0.0,0.0,3611,32628,54165,21537
4507,0.0,0.0,0.0,3611,32632,54165,21533
4508,0.0,0.0,0.0,3611,32636,54165,21529
4509,0.0,0.0,0.0,3611,32640,54165,21525
4511,0.0,0.0,0.0,3611,32644,54165,21521
4512,0.0,0.0,0.0,3611,32648,54165,21517
4513,0.0,0.0,0.0,3611,32652,54165,21513
4514,0.0,0.0,0.0,3611,32656,54165,21509
4515,0.0,0.0,0.0,3611,32660,54165,21505
4516,0.0,0.0,0.0,3611,32664,54165,21501
4517,0.0,0.0,0.0,3611,32668,54165,21497
4518,0.0,0.0,0.0,3611,32672,54165,21493
4519,0.0,0.0,0.0,3611,32676,54165,21489
4521,0.0,0.0,0.0,3611,32680,54165,21485
4522,0.0,0.0,0.0,3611,32684,54165,21481
4523,0.0,0.0,0.0,3611,32688,54165,21477
4524,0.0,0.0,0.0,3611,32692,54165,21473
4525,0.0,0.0,0.0,3611,32696,54165,21469
4526,0.0,0.0,0.0,3611,32700,54165,21465
4527,0.0,0.0,0.0,3611,32704,54165,21461
4528,0.0,0.0,0.0,3611,32708,54165,21457
4529,0.0,0.0,0.0,3611,32712,54165,21453
4530,0.0,0.0,0.0,3611,32716,54165,21449
4531,0.0,0.0,0.0,3611,32720,54165,21445
4532,0.0,0.0,0.0,3611,32724,54165,21441
4533,0.0,0.0,0.0,3611,32728,54165,21437
4534,0.0,0.0,0.0,3611,32732,54165,21433
4536,0.0,0.0,0.0,3611,32736,54165,21429
4537,0.0,0.0,0.0,3611,32740,54165,21425
4538,0.0,0.0,0.0,3611,32744,54165,21421
4539,0.0,0.0,0.0,3611,32748,54165,21417
4541,0.0,0.0,0.0,3611,32752,54165,21413
4542,0.0,0.0,0.0,3611,32756,54165,21409
4543,0.0,0.0,0.0,3611,32760,54165,21405
4544,0.0,0.0,0.0,3611,32764,54165,21401
4545,0.0,0.0,0.0,3611,32768,54165,21397
4547,0.0,0.0,0.0,3611,32772,54165,21393
4548,0.0,0.0,0.0,3611,32776,54165,21389
4549,0.0,0.0,0.0,3611,32780,54165,21385
4551,0.0,0.0,0.0,3611,32784,54165,21381
4552,0.0,0.0,0.0,3611,32788,54165,21377
4553,0.0,0.0,0.0,3611,32792,54165,21373
4554,0.0,0.0,0.0,3611,32796,54165,21369
4556,0.0,0.0,0.0,3611,32800,54165,21365
4557,0.0,0.0,0.0,3611,32804,54165,21361
4558,0.0,0.0,0.0,3611,32808,54165,21357
4559,0.0,0.0,0.0,3611,32812,54165,21353
4560,0.0,0.0,0.0,3611,32816,54165,21349
4561,0.0,0.0,0.0,3611,32820,54165,21345
4562,0.0,0.0,0.0,3611,32824,54165,21341
4563,0.0,0.0,0.0,3611,32828,54165,21337
4564,0.0,0.0,0.0,3611,32832,54165,21333
4565,0.0,0.0,0.0,3611,32836,54165,21329
4566,0.0,0.0,0.0,3611,32840,54165,21325
4567,0.0,0.0,0.0,3611,32844,54165,21321
4568,0.0,0.0,0.0,3611,32848,54165,21317
4569,0.0,0.0,0.0,3611,32852,54165,21313
4570,0.0,0.0,0.0,3611,32856,54165,21309
4571,0.0,0.0,0.0,3611,32860,54165,21305
4572,0.0,0.0,0.0,3611,32864,54165,21301
4573,0.0,0.0,0.0,3611,32868,54165,21297
4575,0.0,0.0,0.0,3611,32872,54165,21293
4577,0.0,0.0,0.0,3611,32876,54165,21289
4578,0.0,0.0,0.0,3611,32880,54165,21285
4579,0.0,0.0,0.0,3611,32884,54165,21281
4580,0.0,0.0,0.0,3611,32888,54165,21277
4581,0.0,0.0,0.0,3611,32892,54165,21273
4583,0.0,0.0,0.0,3611,32896,54165,21269
4584,0.0,0.0,0.0,3611,32900,54165,21265
4586,0.0,0.0,0.0,3611,32904,54165,21261
4587,0.0,0.0,0.0,3611,32908,54165,21257
4588,0.0,0.0,0.0,3611,32912,54165,21253
4589,0.0,0.0,0.0,3611,32916,54165,21249
4590,0.0,0.0,0.0,3611,32920,54165,21245
4592,0.0,0.0,0.0,3611,32924,54165,21241
4593,0.0,0.0,0.0,3611,32928,54165,21237
4595,0.0,0.0,0.0,3611,32932,54165,21233
4597,0.0,0.0,0.0,3611,32936,54165,21229
4598,0.0,0.0,0.0,3611,32940,54165,21225
4600,0.0,0.0,0.0,3611,32944,54165,21221
4602,0.0,0.0,0.0,3611,32948,54165,21217
4603,0.0,0.0,0.0,3611,32952,54165,21213
4604,0.0,0.0,0.0,3611,32956,54165,21209
4605,0.0,0.0,0.0,3611,32960,54165,21205
4606,0.0,0.0,0.0,3611,32964,54165,21201
4608,0.0,0.0,0.0,3611,32968,54165,21197
4609,0.0,0.0,0.0,3611,32972,54165,21193
4610,0.0,0.0,0.0,3611,32976,54165,21189
4611,0.0,0.0,0.0,3611,32980,54165,21185
4614,0.0,0.0,0.0,3611,32984,54165,21181
4615,0.0,0.0,0.0,3611,32988,54165,21177
4616,0.0,0.0,0.0,3611,32992,54165,21173
4617,0.0,0.0,0.0,3611,32996,54165,21169
4618,0.0,0.0,0.0,3611,33000,54165,21165
4619,0.0,0.0,0.0,3611,33004,54165,21161
4620,0.0,0.0,0.0,3611,33008,54165,21157
4621,0.0,0.0,0.0,3611,33012,54165,21153
4622,0.0,0.0,0.0,3611,33016,54165,21149
4624,0.0,0.0,0.0,3611,33020,54165,21145
4625,0.0,0.0,0.0,3611,33024,54165,21141
4626,0.0,0.0,0.0,3611,33028,54165,21137
4627,0.0,0.0,0.0,3611,33032,54165,21133
4628,0.0,0.0,0.0,3611,33036,54165,21129
4629,0.0,0.0,0.0,3611,33040,54165,21125
4630,0.0,0.0,0.0,3611,33044,54165,21121
4633,0.0,0.0,0.0,3611,33048,54165,21117
4634,0.0,0.0,0.0,3611,33052,54165,21113
4635,0.0,0.0,0.0,3611,33056,54165,21109
4636,0.0,0.0,0.0,3611,33060,54165,21105
4637,0.0,0.0,0.0,3611,33064,54165,21101
4638,0.0,0.0,0.0,3611,33068,54165,21097
4640,0.0,0.0,0.0,3611,33072,54165,21093
4641,0.0,0.0,0.0,3611,33076,54165,21089
4642,0.0,0.0,0.0,3611,33080,54165,21085
4643,0.0,0.0,0.0,3611,33084,54165,21081
4645,0.0,0.0,0.0,3611,33088,54165,21077
4646,0.0,0.0,0.0,3611,33092,54165,21073
4647,0.0,0.0,0.0,3611,33096,54165,21069
4649,0.0,0.0,0.0,3611,33100,54165,21065
4650,0.0,0.0,0.0,3611,33104,54165,21061
4651,0.0,0.0,0.0,3611,33108,54165,21057
4652,0.0,0.0,0.0,3611,33112,54165,21053
4654,0.0,0.0,0.0,3611,33116,54165,21049
4656,0.0,0.0,0.0,3611,33120,54165,21045
4658,0.0,0.0,0.0,3611,33124,54165,21041
4659,0.0,0.0,0.0,3611,33128,54165,21037
4660,0.0,0.0,0.0,3611,33132,54165,21033
4661,0.0,0.0,0.0,3611,33136,54165,21029
4662,0.0,0.0,0.0,3611,33140,54165,21025
4664,0.0,0.0,0.0,3611,33144,54165,21021
4665,0.0,0.0,0.0,3611,33148,54165,21017
4666,0.0,0.0,0.0,3611,33152,54165,21013
4667,0.0,0.0,0.0,3611,33156,54165,21009
4668,0.0,0.0,0.0,3611,33160,54165,21005
4669,0.0,0.0,0.0,3611,33164,54165,21001
4670,0.0,0.0,0.0,3611,33168,54165,20997
4671,0.0,0.0,0.0,3611,33172,54165,20993
4672,0.0,0.0,0.0,3611,33176,54165,20989
4673,0.0,0.0,0.0,3611,33180,54165,20985
4675,0.0,0.0,0.0,3611,33184,54165,20981
4676,0.0,0.0,0.0,3611,33188,54165,20977
4677,0.0,0.0,0.0,3611,33192,54165,20973
4678,0.0,0.0,0.0,3611,33196,54165,20969
4679,0.0,0.0,0.0,3611,33200,54165,20965
4681,0.0,0.0,0.0,3611,33204,54165,20961
4682,0.0,0.0,0.0,3611,33208,54165,20957
4684,0.0,0.0,0.0,3611,33212,54165,20953
4686,0.0,0.0,0.0,3611,33216,54165,20949
4687,0.0,0.0,0.0,3611,33220,54165,20945
4688,0.0,0.0,0.0,3611,33224,54165,20941
4691,0.0,0.0,0.0,3611,33228,54165,20937
4692,0.0,0.0,0.0,3611,33232,54165,20933
4693,0.0,0.0,0.0,3611,33236,54165,20929
4694,0.0,0.0,0.0,3611,33240,54165,20925
4695,0.0,0.0,0.0,3611,33244,54165,20921
4696,0.0,0.0,0.0,3611,33248,54165,20917
4697,0.0,0.0,0.0,3611,33252,54165,20913
4699,0.0,0.0,0.0,3611,33256,54165,20909
4702,0.0,0.0,0.0,3611,33260,54165,20905
4703,0.0,0.0,0.0,3611,33264,54165,20901
4706,0.0,0.0,0.0,3611,33268,54165,20897
4708,0.0,0.0,0.0,3611,33272,54165,20893
4709,0.0,0.0,0.0,3611,33276,54165,20889
4710,0.0,0.0,0.0,3611,33280,54165,20885
4711,0.0,0.0,0.0,3611,33284,54165,20881
4712,0.0,0.0,0.0,3611,33288,54165,20877
4714,0.0,0.0,0.0,3611,33292,54165,20873
4715,0.0,0.0,0.0,3611,33296,54165,20869
4716,0.0,0.0,0.0,3611,33300,54165,20865
4717,0.0,0.0,0.0,3611,33304,54165,20861
4718,0.0,0.0,0.0,3611,33308,54165,20857
4719,0.0,0.0,0.0,3611,33312,54165,20853
4720,0.0,0.0,0.0,3611,33316,54165,20849
4721,0.0,0.0,0.0,3611,33320,54165,20845
4723,0.0,0.0,0.0,3611,33324,54165,20841
4725,0.0,0.0,0.0,3611,33328,54165,20837
4726,0.0,0.0,0.0,3611,33332,54165,20833
4728,0.0,0.0,0.0,3611,33336,54165,20829
4729,0.0,0.0,0.0,3611,33340,54165,20825
4731,0.0,0.0,0.0,3611,33344,54165,20821
4732,0.0,0.0,0.0,3611,33348,54165,20817
4733,0.0,0.0,0.0,3611,33352,54165,20813
4734,0.0,0.0,0.0,3611,33356,54165,20809
4735,0.0,0.0,0.0,3611,33360,54165,20805
4736,0.0,0.0,0.0,3611,33364,54165,20801
4737,0.0,0.0,0.0,3611,33368,54165,20797
4739,0.0,0.0,0.0,3611,33372,54165,20793
4740,0.0,0.0,0.0,3611,33376,54165,20789
4741,0.0,0.0,0.0,3611,33380,54165,20785
4743,0.0,0.0,0.0,3611,33384,54165,20781
4744,0.0,0.0,0.0,3611,33388,54165,20777
4745,0.0,0.0,0.0,3611,33392,54165,20773
4746,0.0,0.0,0.0,3611,33396,54165,20769
4747,0.0,0.0,0.0,3611,33400,54165,20765
4748,0.0,0.0,0.0,3611,33404,54165,20761
4750,0.0,0.0,0.0,3611,33408,54165,20757
4751,0.0,0.0,0.0,3611,33412,54165,20753
4753,0.0,0.0,0.0,3611,33416,54165,20749
4754,0.0,0.0,0.0,3611,33420,54165,20745
4755,0.0,0.0,0.0,3611,33424,54165,20741
4756,0.0,0.0,0.0,3611,33428,54165,20737
4757,0.0,0.0,0.0,3611,33432,54165,20733
4758,0.0,0.0,0.0,3611,33436,54165,20729
4759,0.0,0.0,0.0,3611,33440,54165,20725
4760,0.0,0.0,0.0,3611,33444,54165,20721
4761,0.0,0.0,0.0,3611,33448,54165,20717
4762,0.0,0.0,0.0,3611,33452,54165,20713
4763,0.0,0.0,0.0,3611,33456,54165,20709
4764,0.0,0.0,0.0,3611,33460,54165,20705
4765,0.0,0.0,0.0,3611,33464,54165,20701
4766,0.0,0.0,0.0,3611,33468,54165,20697
4767,0.0,0.0,0.0,3611,33472,54165,20693
4769,0.0,0.0,0.0,3611,33476,54165,20689
4770,0.0,0.0,0.0,3611,33480,54165,20685
4772,0.0,0.0,0.0,3611,33484,54165,20681
4773,0.0,0.0,0.0,3611,33488,54165,20677
4774,0.0,0.0,0.0,3611,33492,54165,20673
4775,0.0,0.0,0.0,3611,33496,54165,20669
4776,0.0,0.0,0.0,3611,33500,54165,20665
4778,0.0,0.0,0.0,3611,33504,54165,20661
4779,0.0,0.0,0.0,3611,33508,54165,20657
4780,0.0,0.0,0.0,3611,33512,54165,20653
4781,0.0,0.0,0.0,3611,33516,54165,20649
4783,0.0,0.0,0.0,3611,33520,54165,20645
4784,0.0,0.0,0.0,3611,33524,54165,20641
4785,0.0,0.0,0.0,3611,33528,54165,20637
4786,0.0,0.0,0.0,3611,33532,54165,20633
4787,0.0,0.0,0.0,3611,33536,54165,20629
4788,0.0,0.0,0.0,3611,33540,54165,20625
4790,0.0,0.0,0.0,3611,33544,54165,20621
4791,0.0,0.0,0.0,3611,33548,54165,20617
4793,0.0,0.0,0.0,3611,33552,54165,20613
4794,0.0,0.0,0.0,3611,33556,54165,20609
4795,0.0,0.0,0.0,3611,33560,54165,20605
4797,0.0,0.0,0.0,3611,33564,54165,20601
4798,0.0,0.0,0.0,3611,33568,54165,20597
4799,0.0,0.0,0.0,3611,33572,54165,20593
4800,0.0,0.0,0.0,3611,33576,54165,20589
4801,0.0,0.0,0.0,3611,33580,54165,20585
4802,0.0,0.0,0.0,3611,33584,54165,20581
4804,0.0,0.0,0.0,3611,33588,54165,20577
4805,0.0,0.0,0.0,3611,33592,54165,20573
4808,0.0,0.0,0.0,3611,33596,54165,20569
4809,0.0,0.0,0.0,3611,33600,54165,20565
4810,0.0,0.0,0.0,3611,33604,54165,20561
4811,0.0,0.0,0.0,3611,33608,54165,20557
4812,0.0,0.0,0.0,3611,33612,54165,20553
4815,0.0,0.0,0.0,3611,33616,54165,20549
4816,0.0,0.0,0.0,3611,33620,54165,20545
4817,0.0,0.0,0.0,3611,33624,54165,20541
4818,0.0,0.0,0.0,3611,33628,54165,20537
4819,0.0,0.0,0.0,3611,33632,54165,20533
4820,0.0,0.0,0.0,3611,33636,54165,20529
4821,0.0,0.0,0.0,3611,33640,54165,20525
4822,0.0,0.0,0.0,3611,33644,54165,20521
4823,0.0,0.0,0.0,3611,33648,54165,20517
4824,0.0,0.0,0.0,3611,33652,54165,20513
4825,0.0,0.0,0.0,3611,33656,54165,20509
4826,0.0,0.0,0.0,3611,33660,54165,20505
4829,0.0,0.0,0.0,3611,33664,54165,20501
4830,0.0,0.0,0.0,3611,33668,54165,20497
4831,0.0,0.0,0.0,3611,33672,54165,20493
4832,0.0,0.0,0.0,3611,33676,54165,20489
4833,0.0,0.0,0.0,3611,33680,54165,20485
4834,0.0,0.0,0.0,3611,33684,54165,20481
4835,0.0,0.0,0.0,3611,33688,54165,20477
4836,0.0,0.0,0.0,3611,33692,54165,20473
4837,0.0,0.0,0.0,3611,33696,54165,20469
4838,0.0,0.0,0.0,3611,33700,54165,20465
4839,0.0,0.0,0.0,3611,33704,54165,20461
4840,0.0,0.0,0.0,3611,33708,54165,20457
4841,0.0,0.0,0.0,3611,33712,54165,20453
4842,0.0,0.0,0.0,3611,33716,54165,20449
4843,0.0,0.0,0.0,3611,33720,54165,20445
4844,0.0,0.0,0.0,3611,33724,54165,20441
4845,0.0,0.0,0.0,3611,33728,54165,20437
4847,0.0,0.0,0.0,3611,33732,54165,20433
4848,0.0,0.0,0.0,3611,33736,54165,20429
4849,0.0,0.0,0.0,3611,33740,54165,20425
4850,0.0,0.0,0.0,3611,33744,54165,20421
4851,0.0,0.0,0.0,3611,33748,54165,20417
4852,0.0,0.0,0.0,3611,33752,54165,20413
4853,0.0,0.0,0.0,3611,33756,54165,20409
4854,0.0,0.0,0.0,3611,33760,54165,20405
4855,0.0,0.0,0.0,3611,33764,54165,20401
4856,0.0,0.0,0.0,3611,33768,54165,20397
4857,0.0,0.0,0.0,3611,33772,54165,20393
4858,0.0,0.0,0.0,3611,33776,54165,20389
4860,0.0,0.0,0.0,3611,33780,54165,20385
4861,0.0,0.0,0.0,3611,33784,54165,20381
4862,0.0,0.0,0.0,3611,33788,54165,20377
4863,0.0,0.0,0.0,3611,33792,54165,20373
4864,0.0,0.0,0.0,3611,33796,54165,20369
4865,0.0,0.0,0.0,3611,33800,54165,20365
4866,0.0,0.0,0.0,3611,33804,54165,20361
4867,0.0,0.0,0.0,3611,33808,54165,20357
4868,0.0,0.0,0.0,3611,33812,54165,20353
4869,0.0,0.0,0.0,3611,33816,54165,20349
4871,0.0,0.0,0.0,3611,33820,54165,20345
4872,0.0,0.0,0.0,3611,33824,54165,20341
4874,0.0,0.0,0.0,3611,33828,54165,20337
4875,0.0,0.0,0.0,3611,33832,54165,20333
4876,0.0,0.0,0.0,3611,33836,54165,20329
4877,0.0,0.0,0.0,3611,33840,54165,20325
4878,0.0,0.0,0.0,3611,33844,54165,20321
4879,0.0,0.0,0.0,3611,33848,54165,20317
4880,0.0,0.0,0.0,3611,33852,54165,20313
4881,0.0,0.0,0.0,3611,33856,54165,20309
4882,0.0,0.0,0.0,3611,33860,54165,20305
4883,0.0,0.0,0.0,3611,33864,54165,20301
4886,0.0,0.0,0.0,3611,33868,54165,20297
4888,0.0,0.0,0.0,3611,33872,54165,20293
4889,0.0,0.0,0.0,3611,33876,54165,20289
4890,0.0,0.0,0.0,3611,33880,54165,20285
4891,0.0,0.0,0.0,3611,33884,54165,20281
4893,0.0,0.0,0.0,3611,33888,54165,20277
4894,0.0,0.0,0.0,3611,33892,54165,20273
4895,0.0,0.0,0.0,3611,33896,54165,20269
4896,0.0,0.0,0.0,3611,33900,54165,20265
4898,0.0,0.0,0.0,3611,33904,54165,20261
4900,0.0,0.0,0.0,3611,33908,54165,20257
4903,0.0,0.0,0.0,3611,33912,54165,20253
4904,0.0,0.0,0.0,3611,33916,54165,20249
4905,0.0,0.0,0.0,3611,33920,54165,20245
4906,0.0,0.0,0.0,3611,33924,54165,20241
4907,0.0,0.0,0.0,3611,33928,54165,20237
4908,0.0,0.0,0.0,3611,33932,54165,20233
4909,0.0,0.0,0.0,3611,33936,54165,20229
4911,0.0,0.0,0.0,3611,33940,54165,20225
4912,0.0,0.0,0.0,3611,33944,54165,20221
4913,0.0,0.0,0.0,3611,33948,54165,20217
4915,0.0,0.0,0.0,3611,33952,54165,20213
4916,0.0,0.0,0.0,3611,33956,54165,20209
4917,0.0,0.0,0.0,3611,33960,54165,20205
4918,0.0,0.0,0.0,3611,33964,54165,20201
4919,0.0,0.0,0.0,3611,33968,54165,20197
4920,0.0,0.0,0.0,3611,33972,54165,20193
4921,0.0,0.0,0.0,3611,33976,54165,20189
4922,0.0,0.0,0.0,3611,33980,54165,20185
4923,0.0,0.0,0.0,3611,33984,54165,20181
4924,0.0,0.0,0.0,3611,33988,54165,20177
4925,0.0,0.0,0.0,3611,33992,54165,20173
4926,0.0,0.0,0.0,3611,33996,54165,20169
4927,0.0,0.0,0.0,3611,34000,54165,20165
4928,0.0,0.0,0.0,3611,34004,54165,20161
4929,0.0,0.0,0.0,3611,34008,54165,20157
4930,0.0,0.0,0.0,3611,34012,54165,20153
4931,0.0,0.0,0.0,3611,34016,54165,20149
4932,0.0,0.0,0.0,3611,34020,54165,20145
4933,0.0,0.0,0.0,3611,34024,54165,20141
4935,0.0,0.0,0.0,3611,34028,54165,20137
4936,0.0,0.0,0.0,3611,34032,54165,20133
4937,0.0,0.0,0.0,3611,34036,54165,20129
4940,0.0,0.0,0.0,3611,34040,54165,20125
4941,0.0,0.0,0.0,3611,34044,54165,20121
4942,0.0,0.0,0.0,3611,34048,54165,20117
4943,0.0,0.0,0.0,3611,34052,54165,20113
4944,0.0,0.0,0.0,3611,34056,54165,20109
4947,0.0,0.0,0.0,3611,34060,54165,20105
4948,0.0,0.0,0.0,3611,34064,54165,20101
4949,0.0,0.0,0.0,3611,34068,54165,20097
4950,0.0,0.0,0.0,3611,34072,54165,20093
4951,0.0,0.0,0.0,3611,34076,54165,20089
4952,0.0,0.0,0.0,3611,34080,54165,20085
4953,0.0,0.0,0.0,3611,34084,54165,20081
4954,0.0,0.0,0.0,3611,34088,54165,20077
4955,0.0,0.0,0.0,3611,34092,54165,20073
4956,0.0,0.0,0.0,3611,34096,54165,20069
4957,0.0,0.0,0.0,3611,34100,54165,20065
4958,0.0,0.0,0.0,3611,34104,54165,20061
4959,0.0,0.0,0.0,3611,34108,54165,20057
4960,0.0,0.0,0.0,3611,34112,54165,20053
4961,0.0,0.0,0.0,3611,34116,54165,20049
4962,0.0,0.0,0.0,3611,34120,54165,20045
4963,0.0,0.0,0.0,3611,34124,54165,20041
4964,0.0,0.0,0.0,3611,34128,54165,20037
4965,0.0,0.0,0.0,3611,34132,54165,20033
4966,0.0,0.0,0.0,3611,34136,54165,20029
4967,0.0,0.0,0.0,3611,34140,54165,20025
4968,0.0,0.0,0.0,3611,34144,54165,20021
4971,0.0,0.0,0.0,3611,34148,54165,20017
4972,0.0,0.0,0.0,3611,34152,54165,20013
4973,0.0,0.0,0.0,3611,34156,54165,20009
4975,0.0,0.0,0.0,3611,34160,54165,20005
4976,0.0,0.0,0.0,3611,34164,54165,20001
4977,0.0,0.0,0.0,3611,34168,54165,19997
4978,0.0,0.0,0.0,3611,34172,54165,19993
4980,0.0,0.0,0.0,3611,34176,54165,19989
4981,0.0,0.0,0.0,3611,34180,54165,19985
4984,0.0,0.0,0.0,3611,34184,54165,19981
4985,0.0,0.0,0.0,3611,34188,54165,19977
4986,0.0,0.0,0.0,3611,34192,54165,19973
4987,0.0,0.0,0.0,3611,34196,54165,19969
4988,0.0,0.0,0.0,3611,34200,54165,19965
4989,0.0,0.0,0.0,3611,34204,54165,19961
4991,0.0,0.0,0.0,3611,34208,54165,19957
4992,0.0,0.0,0.0,3611,34212,54165,19953
4993,0.0,0.0,0.0,3611,34216,54165,19949
4994,0.0,0.0,0.0,3611,34220,54165,19945
4995,0.0,0.0,0.0,3611,34224,54165,19941
4996,0.0,0.0,0.0,3611,34228,54165,19937
4997,0.0,0.0,0.0,3611,34232,54165,19933
4999,0.0,0.0,0.0,3611,34236,54165,19929
5001,0.0,0.0,0.0,3611,34240,54165,19925
5004,0.0,0.0,0.0,3611,34244,54165,19921
5005,0.0,0.0,0.0,3611,34248,54165,19917
5006,0.0,0.0,0.0,3611,34252,54165,19913
5007,0.0,0.0,0.0,3611,34256,54165,19909
5008,0.0,0.0,0.0,3611,34260,54165,19905
5009,0.0,0.0,0.0,3611,34264,54165,19901
5010,0.0,0.0,0.0,3611,34268,54165,19897
5011,0.0,0.0,0.0,3611,34272,54165,19893
5013,0.0,0.0,0.0,3611,34276,54165,19889
5014,0.0,0.0,0.0,3611,34280,54165,19885
5016,0.0,0.0,0.0,3611,34284,54165,19881
5017,0.0,0.0,0.0,3611,34288,54165,19877
5018,0.0,0.0,0.0,3611,34292,54165,19873
5020,0.0,0.0,0.0,3611,34296,54165,19869
5022,0.0,0.0,0.0,3611,34300,54165,19865
5023,0.0,0.0,0.0,3611,34304,54165,19861
5024,0.0,0.0,0.0,3611,34308,54165,19857
5026,0.0,0.0,0.0,3611,34312,54165,19853
5027,0.0,0.0,0.0,3611,34316,54165,19849
5029,0.0,0.0,0.0,3611,34320,54165,19845
5030,0.0,0.0,0.0,3611,34324,54165,19841
5031,0.0,0.0,0.0,3611,34328,54165,19837
5032,0.0,0.0,0.0,3611,34332,54165,19833
5033,0.0,0.0,0.0,3611,34336,54165,19829
5034,0.0,0.0,0.0,3611,34340,54165,19825
5035,0.0,0.0,0.0,3611,34344,54165,19821
5036,0.0,0.0,0.0,3611,34348,54165,19817
5037,0.0,0.0,0.0,3611,34352,54165,19813
5038,0.0,0.0,0.0,3611,34356,54165,19809
5039,0.0,0.0,0.0,3611,34360,54165,19805
5040,0.0,0.0,0.0,3611,34364,54165,19801
5041,0.0,0.0,0.0,3611,34368,54165,19797
5042,0.0,0.0,0.0,3611,34372,54165,19793
5043,0.0,0.0,0.0,3611,34376,54165,19789
5045,0.0,0.0,0.0,3611,34380,54165,19785
5046,0.0,0.0,0.0,3611,34384,54165,19781
5047,0.0,0.0,0.0,3611,34388,54165,19777
5048,0.0,0.0,0.0,3611,34392,54165,19773
5050,0.0,0.0,0.0,3611,34396,54165,19769
5051,0.0,0.0,0.0,3611,34400,54165,19765
5053,0.0,0.0,0.0,3611,34404,54165,19761
5054,0.0,0.0,0.0,3611,34408,54165,19757
5055,0.0,0.0,0.0,3611,34412,54165,19753
5056,0.0,0.0,0.0,3611,34416,54165,19749
5057,0.0,0.0,0.0,3611,34420,54165,19745
5058,0.0,0.0,0.0,3611,34424,54165,19741
5059,0.0,0.0,0.0,3611,34428,54165,19737
5061,0.0,0.0,0.0,3611,34432,54165,19733
5062,0.0,0.0,0.0,3611,34436,54165,19729
5064,0.0,0.0,0.0,3611,34440,54165,19725
5065,0.0,0.0,0.0,3611,34444,54165,19721
5066,0.0,0.0,0.0,3611,34448,54165,19717
5068,0.0,0.0,0.0,3611,34452,54165,19713
5069,0.0,0.0,0.0,3611,34456,54165,19709
5071,0.0,0.0,0.0,3611,34460,54165,19705
5073,0.0,0.0,0.0,3611,34464,54165,19701
5074,0.0,0.0,0.0,3611,34468,54165,19697
5076,0.0,0.0,0.0,3611,34472,54165,19693
5077,0.0,0.0,0.0,3611,34476,54165,19689
5079,0.0,0.0,0.0,3611,34480,54165,19685
5080,0.0,0.0,0.0,3611,34484,54165,19681
5082,0.0,0.0,0.0,3611,34488,54165,19677
5083,0.0,0.0,0.0,3611,34492,54165,19673
5084,0.0,0.0,0.0,3611,34496,54165,19669
5085,0.0,0.0,0.0,3611,34500,54165,19665
5087,0.0,0.0,0.0,3611,34504,54165,19661
5088,0.0,0.0,0.0,3611,34508,54165,19657
5089,0.0,0.0,0.0,3611,34512,54165,19653
5090,0.0,0.0,0.0,3611,34516,54165,19649
5091,0.0,0.0,0.0,3611,34520,54165,19645
5092,0.0,0.0,0.0,3611,34524,54165,19641
5094,0.0,0.0,0.0,3611,34528,54165,19637
5095,0.0,0.0,0.0,3611,34532,54165,19633
5096,0.0,0.0,0.0,3611,34536,54165,19629
5097,0.0,0.0,0.0,3611,34540,54165,19625
5098,0.0,0.0,0.0,3611,34544,54165,19621
5099,0.0,0.0,0.0,3611,34548,54165,19617
5100,0.0,0.0,0.0,3611,34552,54165,19613
5101,0.0,0.0,0.0,3611,34556,54165,19609
5102,0.0,0.0,0.0,3611,34560,54165,19605
5103,0.0,0.0,0.0,3611,34564,54165,19601
5104,0.0,0.0,0.0,3611,34568,54165,19597
5105,0.0,0.0,0.0,3611,34572,54165,19593
5107,0.0,0.0,0.0,3611,34576,54165,19589
5108,0.0,0.0,0.0,3611,34580,54165,19585
5109,0.0,0.0,0.0,3611,34584,54165,19581
5110,0.0,0.0,0.0,3611,34588,54165,19577
5113,0.0,0.0,0.0,3611,34592,54165,19573
5114,0.0,0.0,0.0,3611,34596,54165,19569
5115,0.0,0.0,0.0,3611,34600,54165,19565
5116,0.0,0.0,0.0,3611,34604,54165,19561
5117,0.0,0.0,0.0,3611,34608,54165,19557
5118,0.0,0.0,0.0,3611,34612,54165,19553
5119,0.0,0.0,0.0,3611,34616,54165,19549
5120,0.0,0.0,0.0,3611,34620,54165,19545
5121,0.0,0.0,0.0,3611,34624,54165,19541
5123,0.0,0.0,0.0,3611,34628,54165,19537
5125,0.0,0.0,0.0,3611,34632,54165,19533
5126,0.0,0.0,0.0,3611,34636,54165,19529
5127,0.0,0.0,0.0,3611,34640,54165,19525
5128,0.0,0.0,0.0,3611,34644,54165,19521
5129,0.0,0.0,0.0,3611,34648,54165,19517
5130,0.0,0.0,0.0,3611,34652,54165,19513
5132,0.0,0.0,0.0,3611,34656,54165,19509
5133,0.0,0.0,0.0,3611,34660,54165,19505
5134,0.0,0.0,0.0,3611,34664,54165,19501
5135,0.0,0.0,0.0,3611,34668,54165,19497
5136,0.0,0.0,0.0,3611,34672,54165,19493
5137,0.0,0.0,0.0,3611,34676,54165,19489
5138,0.0,0.0,0.0,3611,34680,54165,19485
5140,0.0,0.0,0.0,3611,34684,54165,19481
5141,0.0,0.0,0.0,3611,34688,54165,19477
5142,0.0,0.0,0.0,3611,34692,54165,19473
5143,0.0,0.0,0.0,3611,34696,54165,19469
5144,0.0,0.0,0.0,3611,34700,54165,19465
5145,0.0,0.0,0.0,3611,34704,54165,19461
5146,0.0,0.0,0.0,3611,34708,54165,19457
5147,0.0,0.0,0.0,3611,34712,54165,19453
5148,0.0,0.0,0.0,3611,34716,54165,19449
5149,0.0,0.0,0.0,3611,34720,54165,19445
5150,0.0,0.0,0.0,3611,34724,54165,19441
5151,0.0,0.0,0.0,3611,34728,54165,19437
5152,0.0,0.0,0.0,3611,34732,54165,19433
5153,0.0,0.0,0.0,3611,34736,54165,19429
5154,0.0,0.0,0.0,3611,34740,54165,19425
5155,0.0,0.0,0.0,3611,34744,54165,19421
5156,0.0,0.0,0.0,3611,34748,54165,19417
5157,0.0,0.0,0.0,3611,34752,54165,19413
5158,0.0,0.0,0.0,3611,34756,54165,19409
5159,0.0,0.0,0.0,3611,34760,54165,19405
5160,0.0,0.0,0.0,3611,34764,54165,19401
5161,0.0,0.0,0.0,3611,34768,54165,19397
5162,0.0,0.0,0.0,3611,34772,54165,19393
5163,0.0,0.0,0.0,3611,34776,54165,19389
5164,0.0,0.0,0.0,3611,34780,54165,19385
5165,0.0,0.0,0.0,3611,34784,54165,19381
5166,0.0,0.0,0.0,3611,34788,54165,19377
5167,0.0,0.0,0.0,3611,34792,54165,19373
5168,0.0,0.0,0.0,3611,34796,54165,19369
5170,0.0,0.0,0.0,3611,34800,54165,19365
5171,0.0,0.0,0.0,3611,34804,54165,19361
5173,0.0,0.0,0.0,3611,34808,54165,19357
5174,0.0,0.0,0.0,3611,34812,54165,19353
5175,0.0,0.0,0.0,3611,34816,54165,19349
5177,0.0,0.0,0.0,3611,34820,54165,19345
5178,0.0,0.0,0.0,3611,34824,54165,19341
5179,0.0,0.0,0.0,3611,34828,54165,19337
5181,0.0,0.0,0.0,3611,34832,54165,19333
5182,0.0,0.0,0.0,3611,34836,54165,19329
5183,0.0,0.0,0.0,3611,34840,54165,19325
5184,0.0,0.0,0.0,3611,34844,54165,19321
5186,0.0,0.0,0.0,3611,34848,54165,19317
5188,0.0,0.0,0.0,3611,34852,54165,19313
5191,0.0,0.0,0.0,3611,34856,54165,19309
5192,0.0,0.0,0.0,3611,34860,54165,19305
5193,0.0,0.0,0.0,3611,34864,54165,19301
5194,0.0,0.0,0.0,3611,34868,54165,19297
5195,0.0,0.0,0.0,3611,34872,54165,19293
5196,0.0,0.0,0.0,3611,34876,54165,19289
5197,0.0,0.0,0.0,3611,34880,54165,19285
5198,0.0,0.0,0.0,3611,34884,54165,19281
5199,0.0,0.0,0.0,3611,34888,54165,19277
5200,0.0,0.0,0.0,3611,34892,54165,19273
5201,0.0,0.0,0.0,3611,34896,54165,19269
5202,0.0,0.0,0.0,3611,34900,54165,19265
5203,0.0,0.0,0.0,3611,34904,54165,19261
5204,0.0,0.0,0.0,3611,34908,54165,19257
5205,0.0,0.0,0.0,3611,34912,54165,19253
5206,0.0,0.0,0.0,3611,34916,54165,19249
5207,0.0,0.0,0.0,3611,34920,54165,19245
5208,0.0,0.0,0.0,3611,34924,54165,19241
5209,0.0,0.0,0.0,3611,34928,54165,19237
5210,0.0,0.0,0.0,3611,34932,54165,19233
5211,0.0,0.0,0.0,3611,34936,54165,19229
5212,0.0,0.0,0.0,3611,34940,54165,19225
5214,0.0,0.0,0.0,3611,34944,54165,19221
5215,0.0,0.0,0.0,3611,34948,54165,19217
5216,0.0,0.0,0.0,3611,34952,54165,19213
5217,0.0,0.0,0.0,3611,34956,54165,19209
5221,0.0,0.0,0.0,3611,34960,54165,19205
5222,0.0,0.0,0.0,3611,34964,54165,19201
5223,0.0,0.0,0.0,3611,34968,54165,19197
5224,0.0,0.0,0.0,3611,34972,54165,19193
5225,0.0,0.0,0.0,3611,34976,54165,19189
5227,0.0,0.0,0.0,3611,34980,54165,19185
5228,0.0,0.0,0.0,3611,34984,54165,19181
5229,0.0,0.0,0.0,3611,34988,54165,19177
5230,0.0,0.0,0.0,3611,34992,54165,19173
5231,0.0,0.0,0.0,3611,34996,54165,19169
5232,0.0,0.0,0.0,3611,35000,54165,19165
5233,0.0,0.0,0.0,3611,35004,54165,19161
5234,0.0,0.0,0.0,3611,35008,54165,19157
5235,0.0,0.0,0.0,3611,35012,54165,19153
5236,0.0,0.0,0.0,3611,35016,54165,19149
5237,0.0,0.0,0.0,3611,35020,54165,19145
5238,0.0,0.0,0.0,3611,35024,54165,19141
5239,0.0,0.0,0.0,3611,35028,54165,19137
5240,0.0,0.0,0.0,3611,35032,54165,19133
5241,0.0,0.0,0.0,3611,35036,54165,19129
5242,0.0,0.0,0.0,3611,35040,54165,19125
5243,0.0,0.0,0.0,3611,35044,54165,19121
5244,0.0,0.0,0.0,3611,35048,54165,19117
5245,0.0,0.0,0.0,3611,35052,54165,19113
5246,0.0,0.0,0.0,3611,35056,54165,19109
5247,0.0,0.0,0.0,3611,35060,54165,19105
5248,0.0,0.0,0.0,3611,35064,54165,19101
5251,0.0,0.0,0.0,3611,35068,54165,19097
5252,0.0,0.0,0.0,3611,35072,54165,19093
5253,0.0,0.0,0.0,3611,35076,54165,19089
5254,0.0,0.0,0.0,3611,35080,54165,19085
5255,0.0,0.0,0.0,3611,35084,54165,19081
5256,0.0,0.0,0.0,3611,35088,54165,19077
5258,0.0,0.0,0.0,3611,35092,54165,19073
5259,0.0,0.0,0.0,3611,35096,54165,19069
5260,0.0,0.0,0.0,3611,35100,54165,19065
5262,0.0,0.0,0.0,3611,35104,54165,19061
5263,0.0,0.0,0.0,3611,35108,54165,19057
5265,0.0,0.0,0.0,3611,35112,54165,19053
5266,0.0,0.0,0.0,3611,35116,54165,19049
5267,0.0,0.0,0.0,3611,35120,54165,19045
5270,0.0,0.0,0.0,3611,35124,54165,19041
5272,0.0,0.0,0.0,3611,35128,54165,19037
5274,0.0,0.0,0.0,3611,35132,54165,19033
5275,0.0,0.0,0.0,3611,35136,54165,19029
5276,0.0,0.0,0.0,3611,35140,54165,19025
5277,0.0,0.0,0.0,3611,35144,54165,19021
5279,0.0,0.0,0.0,3611,35148,54165,19017
5280,0.0,0.0,0.0,3611,35152,54165,19013
5281,0.0,0.0,0.0,3611,35156,54165,19009
5283,0.0,0.0,0.0,3611,35160,54165,19005
5284,0.0,0.0,0.0,3611,35164,54165,19001
5285,0.0,0.0,0.0,3611,35168,54165,18997
5286,0.0,0.0,0.0,3611,35172,54165,18993
5288,0.0,0.0,0.0,3611,35176,54165,18989
5290,0.0,0.0,0.0,3611,35180,54165,18985
5291,0.0,0.0,0.0,3611,35184,54165,18981
5292,0.0,0.0,0.0,3611,35188,54165,18977
5293,0.0,0.0,0.0,3611,35192,54165,18973
5294,0.0,0.0,0.0,3611,35196,54165,18969
5295,0.0,0.0,0.0,3611,35200,54165,18965
5296,0.0,0.0,0.0,3611,35204,54165,18961
5297,0.0,0.0,0.0,3611,35208,54165,18957
5298,0.0,0.0,0.0,3611,35212,54165,18953
5299,0.0,0.0,0.0,3611,35216,54165,18949
5300,0.0,0.0,0.0,3611,35220,54165,18945
5303,0.0,0.0,0.0,3611,35224,54165,18941
5305,0.0,0.0,0.0,3611,35228,54165,18937
5306,0.0,0.0,0.0,3611,35232,54165,18933
5307,0.0,0.0,0.0,3611,35236,54165,18929
5308,0.0,0.0,0.0,3611,35240,54165,18925
5309,0.0,0.0,0.0,3611,35244,54165,18921
5310,0.0,0.0,0.0,3611,35248,54165,18917
5311,0.0,0.0,0.0,3611,35252,54165,18913
5312,0.0,0.0,0.0,3611,35256,54165,18909
5313,0.0,0.0,0.0,3611,35260,54165,18905
5314,0.0,0.0,0.0,3611,35264,54165,18901
5315,0.0,0.0,0.0,3611,35268,54165,18897
5317,0.0,0.0,0.0,3611,35272,54165,18893
5318,0.0,0.0,0.0,3611,35276,54165,18889
5319,0.0,0.0,0.0,3611,35280,54165,18885
5320,0.0,0.0,0.0,3611,35284,54165,18881
5321,0.0,0.0,0.0,3611,35288,54165,18877
5322,0.0,0.0,0.0,3611,35292,54165,18873
5323,0.0,0.0,0.0,3611,35296,54165,18869
5324,0.0,0.0,0.0,3611,35300,54165,18865
5326,0.0,0.0,0.0,3611,35304,54165,18861
5327,0.0,0.0,0.0,3611,35308,54165,18857
5328,0.0,0.0,0.0,3611,35312,54165,18853
5329,0.0,0.0,0.0,3611,35316,54165,18849
5331,0.0,0.0,0.0,3611,35320,54165,18845
5332,0.0,0.0,0.0,3611,35324,54165,18841
5333,0.0,0.0,0.0,3611,35328,54165,18837
5334,0.0,0.0,0.0,3611,35332,54165,18833
5335,0.0,0.0,0.0,3611,35336,54165,18829
5336,0.0,0.0,0.0,3611,35340,54165,18825
5337,0.0,0.0,0.0,3611,35344,54165,18821
5338,0.0,0.0,0.0,3611,35348,54165,18817
5340,0.0,0.0,0.0,3611,35352,54165,18813
5342,0.0,0.0,0.0,3611,35356,54165,18809
5343,0.0,0.0,0.0,3611,35360,54165,18805
5344,0.0,0.0,0.0,3611,35364,54165,18801
5345,0.0,0.0,0.0,3611,35368,54165,18797
5346,0.0,0.0,0.0,3611,35372,54165,18793
5348,0.0,0.0,0.0,3611,35376,54165,18789
5349,0.0,0.0,0.0,3611,35380,54165,18785
5350,0.0,0.0,0.0,3611,35384,54165,18781
5351,0.0,0.0,0.0,3611,35388,54165,18777
5352,0.0,0.0,0.0,3611,35392,54165,18773
5353,0.0,0.0,0.0,3611,35396,54165,18769
5354,0.0,0.0,0.0,3611,35400,54165,18765
5358,0.0,0.0,0.0,3611,35404,54165,18761
5359,0.0,0.0,0.0,3611,35408,54165,18757
5360,0.0,0.0,0.0,3611,35412,54165,18753
5362,0.0,0.0,0.0,3611,35416,54165,18749
5363,0.0,0.0,0.0,3611,35420,54165,18745
5364,0.0,0.0,0.0,3611,35424,54165,18741
5365,0.0,0.0,0.0,3611,35428,54165,18737
5366,0.0,0.0,0.0,3611,35432,54165,18733
5367,0.0,0.0,0.0,3611,35436,54165,18729
5368,0.0,0.0,0.0,3611,35440,54165,18725
5369,0.0,0.0,0.0,3611,35444,54165,18721
5370,0.0,0.0,0.0,3611,35448,54165,18717
5371,0.0,0.0,0.0,3611,35452,54165,18713
5372,0.0,0.0,0.0,3611,35456,54165,18709
5373,0.0,0.0,0.0,3611,35460,54165,18705
5374,0.0,0.0,0.0,3611,35464,54165,18701
5376,0.0,0.0,0.0,3611,35468,54165,18697
5377,0.0,0.0,0.0,3611,35472,54165,18693
5378,0.0,0.0,0.0,3611,35476,54165,18689
5379,0.0,0.0,0.0,3611,35480,54165,18685
5380,0.0,0.0,0.0,3611,35484,54165,18681
5381,0.0,0.0,0.0,3611,35488,54165,18677
5382,0.0,0.0,0.0,3611,35492,54165,18673
5384,0.0,0.0,0.0,3611,35496,54165,18669
5385,0.0,0.0,0.0,3611,35500,54165,18665
5386,0.0,0.0,0.0,3611,35504,54165,18661
5387,0.0,0.0,0.0,3611,35508,54165,18657
5388,0.0,0.0,0.0,3611,35512,54165,18653
5389,0.0,0.0,0.0,3611,35516,54165,18649
5390,0.0,0.0,0.0,3611,35520,54165,18645
5391,0.0,0.0,0.0,3611,35524,54165,18641
5392,0.0,0.0,0.0,3611,35528,54165,18637
5393,0.0,0.0,0.0,3611,35532,54165,18633
5394,0.0,0.0,0.0,3611,35536,54165,18629
5395,0.0,0.0,0.0,3611,35540,54165,18625
5397,0.0,0.0,0.0,3611,35544,54165,18621
5398,0.0,0.0,0.0,3611,35548,54165,18617
5399,0.0,0.0,0.0,3611,35552,54165,18613
5400,0.0,0.0,0.0,3611,35556,54165,18609
5402,0.0,0.0,0.0,3611,35560,54165,18605
5405,0.0,0.0,0.0,3611,35564,54165,18601
5407,0.0,0.0,0.0,3611,35568,54165,18597
5408,0.0,0.0,0.0,3611,35572,54165,18593
5409,0.0,0.0,0.0,3611,35576,54165,18589
5411,0.0,0.0,0.0,3611,35580,54165,18585
5413,0.0,0.0,0.0,3611,35584,54165,18581
5414,0.0,0.0,0.0,3611,35588,54165,18577
5416,0.0,0.0,0.0,3611,35592,54165,18573
5417,0.0,0.0,0.0,3611,35596,54165,18569
5418,0.0,0.0,0.0,3611,35600,54165,18565
5419,0.0,0.0,0.0,3611,35604,54165,18561
5420,0.0,0.0,0.0,3611,35608,54165,18557
5421,0.0,0.0,0.0,3611,35612,54165,18553
5422,0.0,0.0,0.0,3611,35616,54165,18549
5423,0.0,0.0,0.0,3611,35620,54165,18545
5424,0.0,0.0,0.0,3611,35624,54165,18541
5425,0.0,0.0,0.0,3611,35628,54165,18537
5426,0.0,0.0,0.0,3611,35632,54165,18533
5428,0.0,0.0,0.0,3611,35636,54165,18529
5429,0.0,0.0,0.0,3611,35640,54165,18525
5430,0.0,0.0,0.0,3611,35644,54165,18521
5431,0.0,0.0,0.0,3611,35648,54165,18517
5432,0.0,0.0,0.0,3611,35652,54165,18513
5433,0.0,0.0,0.0,3611,35656,54165,18509
5435,0.0,0.0,0.0,3611,35660,54165,18505
5436,0.0,0.0,0.0,3611,35664,54165,18501
5437,0.0,0.0,0.0,3611,35668,54165,18497
5439,0.0,0.0,0.0,3611,35672,54165,18493
5440,0.0,0.0,0.0,3611,35676,54165,18489
5441,0.0,0.0,0.0,3611,35680,54165,18485
5442,0.0,0.0,0.0,3611,35684,54165,18481
5443,0.0,0.0,0.0,3611,35688,54165,18477
5444,0.0,0.0,0.0,3611,35692,54165,18473
5445,0.0,0.0,0.0,3611,35696,54165,18469
5446,0.0,0.0,0.0,3611,35700,54165,18465
5447,0.0,0.0,0.0,3611,35704,54165,18461
5448,0.0,0.0,0.0,3611,35708,54165,18457
5449,0.0,0.0,0.0,3611,35712,54165,18453
5450,0.0,0.0,0.0,3611,35716,54165,18449
5451,0.0,0.0,0.0,3611,35720,54165,18445
5452,0.0,0.0,0.0,3611,35724,54165,18441
5453,0.0,0.0,0.0,3611,35728,54165,18437
5454,0.0,0.0,0.0,3611,35732,54165,18433
5455,0.0,0.0,0.0,3611,35736,54165,18429
5457,0.0,0.0,0.0,3611,35740,54165,18425
5458,0.0,0.0,0.0,3611,35744,54165,18421
5459,0.0,0.0,0.0,3611,35748,54165,18417
5460,0.0,0.0,0.0,3611,35752,54165,18413
5461,0.0,0.0,0.0,3611,35756,54165,18409
5462,0.0,0.0,0.0,3611,35760,54165,18405
5464,0.0,0.0,0.0,3611,35764,54165,18401
5465,0.0,0.0,0.0,3611,35768,54165,18397
5466,0.0,0.0,0.0,3611,35772,54165,18393
5467,0.0,0.0,0.0,3611,35776,54165,18389
5471,0.0,0.0,0.0,3611,35780,54165,18385
5472,0.0,0.0,0.0,3611,35784,54165,18381
5473,0.0,0.0,0.0,3611,35788,54165,18377
5474,0.0,0.0,0.0,3611,35792,54165,18373
5476,0.0,0.0,0.0,3611,35796,54165,18369
5477,0.0,0.0,0.0,3611,35800,54165,18365
5480,0.0,0.0,0.0,3611,35804,54165,18361
5481,0.0,0.0,0.0,3611,35808,54165,18357
5483,0.0,0.0,0.0,3611,35812,54165,18353
5485,0.0,0.0,0.0,3611,35816,54165,18349
5486,0.0,0.0,0.0,3611,35820,54165,18345
5487,0.0,0.0,0.0,3611,35824,54165,18341
5488,0.0,0.0,0.0,3611,35828,54165,18337
5489,0.0,0.0,0.0,3611,35832,54165,18333
5491,0.0,0.0,0.0,3611,35836,54165,18329
5492,0.0,0.0,0.0,3611,35840,54165,18325
5493,0.0,0.0,0.0,3611,35844,54165,18321
5494,0.0,0.0,0.0,3611,35848,54165,18317
5495,0.0,0.0,0.0,3611,35852,54165,18313
5496,0.0,0.0,0.0,3611,35856,54165,18309
5497,0.0,0.0,0.0,3611,35860,54165,18305
5498,0.0,0.0,0.0,3611,35864,54165,18301
5499,0.0,0.0,0.0,3611,35868,54165,18297
5501,0.0,0.0,0.0,3611,35872,54165,18293
5502,0.0,0.0,0.0,3611,35876,54165,18289
5503,0.0,0.0,0.0,3611,35880,54165,18285
5504,0.0,0.0,0.0,3611,35884,54165,18281
5505,0.0,0.0,0.0,3611,35888,54165,18277
5506,0.0,0.0,0.0,3611,35892,54165,18273
5507,0.0,0.0,0.0,3611,35896,54165,18269
5509,0.0,0.0,0.0,3611,35900,54165,18265
5510,0.0,0.0,0.0,3611,35904,54165,18261
5511,0.0,0.0,0.0,3611,35908,54165,18257
5512,0.0,0.0,0.0,3611,35912,54165,18253
5513,0.0,0.0,0.0,3611,35916,54165,18249
5514,0.0,0.0,0.0,3611,35920,54165,18245
5515,0.0,0.0,0.0,3611,35924,54165,18241
5516,0.0,0.0,0.0,3611,35928,54165,18237
5517,0.0,0.0,0.0,3611,35932,54165,18233
5518,0.0,0.0,0.0,3611,35936,54165,18229
5519,0.0,0.0,0.0,3611,35940,54165,18225
5520,0.0,0.0,0.0,3611,35944,54165,18221
5521,0.0,0.0,0.0,3611,35948,54165,18217
5523,0.0,0.0,0.0,3611,35952,54165,18213
5524,0.0,0.0,0.0,3611,35956,54165,18209
5527,0.0,0.0,0.0,3611,35960,54165,18205
5528,0.0,0.0,0.0,3611,35964,54165,18201
5529,0.0,0.0,0.0,3611,35968,54165,18197
5532,0.0,0.0,0.0,3611,35972,54165,18193
5533,0.0,0.0,0.0,3611,35976,54165,18189
5534,0.0,0.0,0.0,3611,35980,54165,18185
5535,0.0,0.0,0.0,3611,35984,54165,18181
5536,0.0,0.0,0.0,3611,35988,54165,18177
5537,0.0,0.0,0.0,3611,35992,54165,18173
5538,0.0,0.0,0.0,3611,35996,54165,18169
5539,0.0,0.0,0.0,3611,36000,54165,18165
5540,0.0,0.0,0.0,3611,36004,54165,18161
5541,0.0,0.0,0.0,3611,36008,54165,18157
5543,0.0,0.0,0.0,3611,36012,54165,18153
5544,0.0,0.0,0.0,3611,36016,54165,18149
5545,0.0,0.0,0.0,3611,36020,54165,18145
5546,0.0,0.0,0.0,3611,36024,54165,18141
5548,0.0,0.0,0.0,3611,36028,54165,18137
5549,0.0,0.0,0.0,3611,36032,54165,18133
5550,0.0,0.0,0.0,3611,36036,54165,18129
5551,0.0,0.0,0.0,3611,36040,54165,18125
5552,0.0,0.0,0.0,3611,36044,54165,18121
5553,0.0,0.0,0.0,3611,36048,54165,18117
5554,0.0,0.0,0.0,3611,36052,54165,18113
5555,0.0,0.0,0.0,3611,36056,54165,18109
5556,0.0,0.0,0.0,3611,36060,54165,18105
5557,0.0,0.0,0.0,3611,36064,54165,18101
5558,0.0,0.0,0.0,3611,36068,54165,18097
5559,0.0,0.0,0.0,3611,36072,54165,18093
5562,0.0,0.0,0.0,3611,36076,54165,18089
5563,0.0,0.0,0.0,3611,36080,54165,18085
5564,0.0,0.0,0.0,3611,36084,54165,18081
5565,0.0,0.0,0.0,3611,36088,54165,18077
5566,0.0,0.0,0.0,3611,36092,54165,18073
5567,0.0,0.0,0.0,3611,36096,54165,18069
5569,0.0,0.0,0.0,3611,36100,54165,18065
5571,0.0,0.0,0.0,3611,36104,54165,18061
5572,0.0,0.0,0.0,3611,36108,54165,18057
5574,0.0,0.0,0.0,3611,36112,54165,18053
5575,0.0,0.0,0.0,3611,36116,54165,18049
5576,0.0,0.0,0.0,3611,36120,54165,18045
5577,0.0,0.0,0.0,3611,36124,54165,18041
5578,0.0,0.0,0.0,3611,36128,54165,18037
5579,0.0,0.0,0.0,3611,36132,54165,18033
5580,0.0,0.0,0.0,3611,36136,54165,18029
5581,0.0,0.0,0.0,3611,36140,54165,18025
5582,0.0,0.0,0.0,3611,36144,54165,18021
5583,0.0,0.0,0.0,3611,36148,54165,18017
5584,0.0,0.0,0.0,3611,36152,54165,18013
5586,0.0,0.0,0.0,3611,36156,54165,18009
5587,0.0,0.0,0.0,3611,36160,54165,18005
5588,0.0,0.0,0.0,3611,36164,54165,18001
5589,0.0,0.0,0.0,3611,36168,54165,17997
5590,0.0,0.0,0.0,3611,36172,54165,17993
5591,0.0,0.0,0.0,3611,36176,54165,17989
5592,0.0,0.0,0.0,3611,36180,54165,17985
5593,0.0,0.0,0.0,3611,36184,54165,17981
5595,0.0,0.0,0.0,3611,36188,54165,17977
5596,0.0,0.0,0.0,3611,36192,54165,17973
5597,0.0,0.0,0.0,3611,36196,54165,17969
5599,0.0,0.0,0.0,3611,36200,54165,17965
5600,0.0,0.0,0.0,3611,36204,54165,17961
5603,0.0,0.0,0.0,3611,36208,54165,17957
5604,0.0,0.0,0.0,3611,36212,54165,17953
5606,0.0,0.0,0.0,3611,36216,54165,17949
5607,0.0,0.0,0.0,3611,36220,54165,17945
5608,0.0,0.0,0.0,3611,36224,54165,17941
5609,0.0,0.0,0.0,3611,36228,54165,17937
5610,0.0,0.0,0.0,3611,36232,54165,17933
5611,0.0,0.0,0.0,3611,36236,54165,17929
5612,0.0,0.0,0.0,3611,36240,54165,17925
5613,0.0,0.0,0.0,3611,36244,54165,17921
5614,0.0,0.0,0.0,3611,36248,54165,17917
5615,0.0,0.0,0.0,3611,36252,54165,17913
5617,0.0,0.0,0.0,3611,36256,54165,17909
5618,0.0,0.0,0.0,3611,36260,54165,17905
5619,0.0,0.0,0.0,3611,36264,54165,17901
5620,0.0,0.0,0.0,3611,36268,54165,17897
5621,0.0,0.0,0.0,3611,36272,54165,17893
5623,0.0,0.0,0.0,3611,36276,54165,17889
5624,0.0,0.0,0.0,3611,36280,54165,17885
5625,0.0,0.0,0.0,3611,36284,54165,17881
5626,0.0,0.0,0.0,3611,36288,54165,17877
5628,0.0,0.0,0.0,3611,36292,54165,17873
5629,0.0,0.0,0.0,3611,36296,54165,17869
5630,0.0,0.0,0.0,3611,36300,54165,17865
5632,0.0,0.0,0.0,3611,36304,54165,17861
5633,0.0,0.0,0.0,3611,36308,54165,17857
5634,0.0,0.0,0.0,3611,36312,54165,17853
5635,0.0,0.0,0.0,3611,36316,54165,17849
5636,0.0,0.0,0.0,3611,36320,54165,17845
5638,0.0,0.0,0.0,3611,36324,54165,17841
5639,0.0,0.0,0.0,3611,36328,54165,17837
5640,0.0,0.0,0.0,3611,36332,54165,17833
5641,0.0,0.0,0.0,3611,36336,54165,17829
5644,0.0,0.0,0.0,3611,36340,54165,17825
5645,0.0,0.0,0.0,3611,36344,54165,17821
5646,0.0,0.0,0.0,3611,36348,54165,17817
5647,0.0,0.0,0.0,3611,36352,54165,17813
5648,0.0,0.0,0.0,3611,36356,54165,17809
5650,0.0,0.0,0.0,3611,36360,54165,17805
5651,0.0,0.0,0.0,3611,36364,54165,17801
5652,0.0,0.0,0.0,3611,36368,54165,17797
5653,0.0,0.0,0.0,3611,36372,54165,17793
5654,0.0,0.0,0.0,3611,36376,54165,17789
5655,0.0,0.0,0.0,3611,36380,54165,17785
5656,0.0,0.0,0.0,3611,36384,54165,17781
5657,0.0,0.0,0.0,3611,36388,54165,17777
5658,0.0,0.0,0.0,3611,36392,54165,17773
5659,0.0,0.0,0.0,3611,36396,54165,17769
5660,0.0,0.0,0.0,3611,36400,54165,17765
5661,0.0,0.0,0.0,3611,36404,54165,17761
5662,0.0,0.0,0.0,3611,36408,54165,17757
5663,0.0,0.0,0.0,3611,36412,54165,17753
5665,0.0,0.0,0.0,3611,36416,54165,17749
5666,0.0,0.0,0.0,3611,36420,54165,17745
5667,0.0,0.0,0.0,3611,36424,54165,17741
5668,0.0,0.0,0.0,3611,36428,54165,17737
5669,0.0,0.0,0.0,3611,36432,54165,17733
5671,0.0,0.0,0.0,3611,36436,54165,17729
5672,0.0,0.0,0.0,3611,36440,54165,17725
5673,0.0,0.0,0.0,3611,36444,54165,17721
5674,0.0,0.0,0.0,3611,36448,54165,17717
5675,0.0,0.0,0.0,3611,36452,54165,17713
5676,0.0,0.0,0.0,3611,36456,54165,17709
5677,0.0,0.0,0.0,3611,36460,54165,17705
5679,0.0,0.0,0.0,3611,36464,54165,17701
5680,0.0,0.0,0.0,3611,36468,54165,17697
5681,0.0,0.0,0.0,3611,36472,54165,17693
5682,0.0,0.0,0.0,3611,36476,54165,17689
5684,0.0,0.0,0.0,3611,36480,54165,17685
5685,0.0,0.0,0.0,3611,36484,54165,17681
5686,0.0,0.0,0.0,3611,36488,54165,17677
5687,0.0,0.0,0.0,3611,36492,54165,17673
5688,0.0,0.0,0.0,3611,36496,54165,17669
5689,0.0,0.0,0.0,3611,36500,54165,17665
5690,0.0,0.0,0.0,3611,36504,54165,17661
5691,0.0,0.0,0.0,3611,36508,54165,17657
5694,0.0,0.0,0.0,3611,36512,54165,17653
5695,0.0,0.0,0.0,3611,36516,54165,17649
5696,0.0,0.0,0.0,3611,36520,54165,17645
5697,0.0,0.0,0.0,3611,36524,54165,17641
5698,0.0,0.0,0.0,3611,36528,54165,17637
5699,0.0,0.0,0.0,3611,36532,54165,17633
5700,0.0,0.0,0.0,3611,36536,54165,17629
5701,0.0,0.0,0.0,3611,36540,54165,17625
5703,0.0,0.0,0.0,3611,36544,54165,17621
5704,0.0,0.0,0.0,3611,36548,54165,17617
5705,0.0,0.0,0.0,3611,36552,54165,17613
5706,0.0,0.0,0.0,3611,36556,54165,17609
5707,0.0,0.0,0.0,3611,36560,54165,17605
5708,0.0,0.0,0.0,3611,36564,54165,17601
5709,0.0,0.0,0.0,3611,36568,54165,17597
5710,0.0,0.0,0.0,3611,36572,54165,17593
5711,0.0,0.0,0.0,3611,36576,54165,17589
5712,0.0,0.0,0.0,3611,36580,54165,17585
5714,0.0,0.0,0.0,3611,36584,54165,17581
5717,0.0,0.0,0.0,3611,36588,54165,17577
5718,0.0,0.0,0.0,3611,36592,54165,17573
5720,0.0,0.0,0.0,3611,36596,54165,17569
5721,0.0,0.0,0.0,3611,36600,54165,17565
5722,0.0,0.0,0.0,3611,36604,54165,17561
5723,0.0,0.0,0.0,3611,36608,54165,17557
5724,0.0,0.0,0.0,3611,36612,54165,17553
5728,0.0,0.0,0.0,3611,36616,54165,17549
5729,0.0,0.0,0.0,3611,36620,54165,17545
5730,0.0,0.0,0.0,3611,36624,54165,17541
5731,0.0,0.0,0.0,3611,36628,54165,17537
5733,0.0,0.0,0.0,3611,36632,54165,17533
5734,0.0,0.0,0.0,3611,36636,54165,17529
5736,0.0,0.0,0.0,3611,36640,54165,17525
5737,0.0,0.0,0.0,3611,36644,54165,17521
5739,0.0,0.0,0.0,3611,36648,54165,17517
5740,0.0,0.0,0.0,3611,36652,54165,17513
5741,0.0,0.0,0.0,3611,36656,54165,17509
5742,0.0,0.0,0.0,3611,36660,54165,17505
5743,0.0,0.0,0.0,3611,36664,54165,17501
5745,0.0,0.0,0.0,3611,36668,54165,17497
5746,0.0,0.0,0.0,3611,36672,54165,17493
5747,0.0,0.0,0.0,3611,36676,54165,17489
5748,0.0,0.0,0.0,3611,36680,54165,17485
5749,0.0,0.0,0.0,3611,36684,54165,17481
5750,0.0,0.0,0.0,3611,36688,54165,17477
5751,0.0,0.0,0.0,3611,36692,54165,17473
5753,0.0,0.0,0.0,3611,36696,54165,17469
5754,0.0,0.0,0.0,3611,36700,54165,17465
5756,0.0,0.0,0.0,3611,36704,54165,17461
5757,0.0,0.0,0.0,3611,36708,54165,17457
5760,0.0,0.0,0.0,3611,36712,54165,17453
5761,0.0,0.0,0.0,3611,36716,54165,17449
5762,0.0,0.0,0.0,3611,36720,54165,17445
5763,0.0,0.0,0.0,3611,36724,54165,17441
5764,0.0,0.0,0.0,3611,36728,54165,17437
5767,0.0,0.0,0.0,3611,36732,54165,17433
5769,0.0,0.0,0.0,3611,36736,54165,17429
5770,0.0,0.0,0.0,3611,36740,54165,17425
5772,0.0,0.0,0.0,3611,36744,54165,17421
5773,0.0,0.0,0.0,3611,36748,54165,17417
5774,0.0,0.0,0.0,3611,36752,54165,17413
5776,0.0,0.0,0.0,3611,36756,54165,17409
5777,0.0,0.0,0.0,3611,36760,54165,17405
5778,0.0,0.0,0.0,3611,36764,54165,17401
5779,0.0,0.0,0.0,3611,36768,54165,17397
5781,0.0,0.0,0.0,3611,36772,54165,17393
5782,0.0,0.0,0.0,3611,36776,54165,17389
5783,0.0,0.0,0.0,3611,36780,54165,17385
5784,0.0,0.0,0.0,3611,36784,54165,17381
5785,0.0,0.0,0.0,3611,36788,54165,17377
5786,0.0,0.0,0.0,3611,36792,54165,17373
5787,0.0,0.0,0.0,3611,36796,54165,17369
5788,0.0,0.0,0.0,3611,36800,54165,17365
5789,0.0,0.0,0.0,3611,36804,54165,17361
5790,0.0,0.0,0.0,3611,36808,54165,17357
5791,0.0,0.0,0.0,3611,36812,54165,17353
5792,0.0,0.0,0.0,3611,36816,54165,17349
5793,0.0,0.0,0.0,3611,36820,54165,17345
5794,0.0,0.0,0.0,3611,36824,54165,17341
5795,0.0,0.0,0.0,3611,36828,54165,17337
5796,0.0,0.0,0.0,3611,36832,54165,17333
5797,0.0,0.0,0.0,3611,36836,54165,17329
5798,0.0,0.0,0.0,3611,36840,54165,17325
5803,0.0,0.0,0.0,3611,36844,54165,17321
5804,0.0,0.0,0.0,3611,36848,54165,17317
5805,0.0,0.0,0.0,3611,36852,54165,17313
5806,0.0,0.0,0.0,3611,36856,54165,17309
5807,0.0,0.0,0.0,3611,36860,54165,17305
5808,0.0,0.0,0.0,3611,36864,54165,17301
5809,0.0,0.0,0.0,3611,36868,54165,17297
5810,0.0,0.0,0.0,3611,36872,54165,17293
5811,0.0,0.0,0.0,3611,36876,54165,17289
5812,0.0,0.0,0.0,3611,36880,54165,17285
5813,0.0,0.0,0.0,3611,36884,54165,17281
5814,0.0,0.0,0.0,3611,36888,54165,17277
5815,0.0,0.0,0.0,3611,36892,54165,17273
5817,0.0,0.0,0.0,3611,36896,54165,17269
5818,0.0,0.0,0.0,3611,36900,54165,17265
5819,0.0,0.0,0.0,3611,36904,54165,17261
5820,0.0,0.0,0.0,3611,36908,54165,17257
5821,0.0,0.0,0.0,3611,36912,54165,17253
5823,0.0,0.0,0.0,3611,36916,54165,17249
5824,0.0,0.0,0.0,3611,36920,54165,17245
5825,0.0,0.0,0.0,3611,36924,54165,17241
5826,0.0,0.0,0.0,3611,36928,54165,17237
5827,0.0,0.0,0.0,3611,36932,54165,17233
5828,0.0,0.0,0.0,3611,36936,54165,17229
5829,0.0,0.0,0.0,3611,36940,54165,17225
5831,0.0,0.0,0.0,3611,36944,54165,17221
5832,0.0,0.0,0.0,3611,36948,54165,17217
5833,0.0,0.0,0.0,3611,36952,54165,17213
5834,0.0,0.0,0.0,3611,36956,54165,17209
5835,0.0,0.0,0.0,3611,36960,54165,17205
5836,0.0,0.0,0.0,3611,36964,54165,17201
5838,0.0,0.0,0.0,3611,36968,54165,17197
5839,0.0,0.0,0.0,3611,36972,54165,17193
5841,0.0,0.0,0.0,3611,36976,54165,17189
5842,0.0,0.0,0.0,3611,36980,54165,17185
5843,0.0,0.0,0.0,3611,36984,54165,17181
5844,0.0,0.0,0.0,3611,36988,54165,17177
5845,0.0,0.0,0.0,3611,36992,54165,17173
5846,0.0,0.0,0.0,3611,36996,54165,17169
5847,0.0,0.0,0.0,3611,37000,54165,17165
5849,0.0,0.0,0.0,3611,37004,54165,17161
5850,0.0,0.0,0.0,3611,37008,54165,17157
5851,0.0,0.0,0.0,3611,37012,54165,17153
5853,0.0,0.0,0.0,3611,37016,54165,17149
5855,0.0,0.0,0.0,3611,37020,54165,17145
5856,0.0,0.0,0.0,3611,37024,54165,17141
5858,0.0,0.0,0.0,3611,37028,54165,17137
5860,0.0,0.0,0.0,3611,37032,54165,17133
5862,0.0,0.0,0.0,3611,37036,54165,17129
5863,0.0,0.0,0.0,3611,37040,54165,17125
5864,0.0,0.0,0.0,3611,37044,54165,17121
5866,0.0,0.0,0.0,3611,37048,54165,17117
5867,0.0,0.0,0.0,3611,37052,54165,17113
5868,0.0,0.0,0.0,3611,37056,54165,17109
5869,0.0,0.0,0.0,3611,37060,54165,17105
5870,0.0,0.0,0.0,3611,37064,54165,17101
5872,0.0,0.0,0.0,3611,37068,54165,17097
5873,0.0,0.0,0.0,3611,37072,54165,17093
5876,0.0,0.0,0.0,3611,37076,54165,17089
5878,0.0,0.0,0.0,3611,37080,54165,17085
5879,0.0,0.0,0.0,3611,37084,54165,17081
5880,0.0,0.0,0.0,3611,37088,54165,17077
5881,0.0,0.0,0.0,3611,37092,54165,17073
5882,0.0,0.0,0.0,3611,37096,54165,17069
5886,0.0,0.0,0.0,3611,37100,54165,17065
5887,0.0,0.0,0.0,3611,37104,54165,17061
5888,0.0,0.0,0.0,3611,37108,54165,17057
5890,0.0,0.0,0.0,3611,37112,54165,17053
5891,0.0,0.0,0.0,3611,37116,54165,17049
5892,0.0,0.0,0.0,3611,37120,54165,17045
5894,0.0,0.0,0.0,3611,37124,54165,17041
5895,0.0,0.0,0.0,3611,37128,54165,17037
5896,0.0,0.0,0.0,3611,37132,54165,17033
5897,0.0,0.0,0.0,3611,37136,54165,17029
5898,0.0,0.0,0.0,3611,37140,54165,17025
5899,0.0,0.0,0.0,3611,37144,54165,17021
5900,0.0,0.0,0.0,3611,37148,54165,17017
5901,0.0,0.0,0.0,3611,37152,54165,17013
5902,0.0,0.0,0.0,3611,37156,54165,17009
5903,0.0,0.0,0.0,3611,37160,54165,17005
5904,0.0,0.0,0.0,3611,37164,54165,17001
5906,0.0,0.0,0.0,3611,37168,54165,16997
5907,0.0,0.0,0.0,3611,37172,54165,16993
5909,0.0,0.0,0.0,3611,37176,54165,16989
5910,0.0,0.0,0.0,3611,37180,54165,16985
5911,0.0,0.0,0.0,3611,37184,54165,16981
5912,0.0,0.0,0.0,3611,37188,54165,16977
5915,0.0,0.0,0.0,3611,37192,54165,16973
5916,0.0,0.0,0.0,3611,37196,54165,16969
5917,0.0,0.0,0.0,3611,37200,54165,16965
5918,0.0,0.0,0.0,3611,37204,54165,16961
5919,0.0,0.0,0.0,3611,37208,54165,16957
5920,0.0,0.0,0.0,3611,37212,54165,16953
5921,0.0,0.0,0.0,3611,37216,54165,16949
5924,0.0,0.0,0.0,3611,37220,54165,16945
5925,0.0,0.0,0.0,3611,37224,54165,16941
5929,0.0,0.0,0.0,3611,37228,54165,16937
5930,0.0,0.0,0.0,3611,37232,54165,16933
5932,0.0,0.0,0.0,3611,37236,54165,16929
5933,0.0,0.0,0.0,3611,37240,54165,16925
5935,0.0,0.0,0.0,3611,37244,54165,16921
5936,0.0,0.0,0.0,3611,37248,54165,16917
5937,0.0,0.0,0.0,3611,37252,54165,16913
5938,0.0,0.0,0.0,3611,37256,54165,16909
5939,0.0,0.0,0.0,3611,37260,54165,16905
5941,0.0,0.0,0.0,3611,37264,54165,16901
5942,0.0,0.0,0.0,3611,37268,54165,16897
5944,0.0,0.0,0.0,3611,37272,54165,16893
5946,0.0,0.0,0.0,3611,37276,54165,16889
5947,0.0,0.0,0.0,3611,37280,54165,16885
5948,0.0,0.0,0.0,3611,37284,54165,16881
5949,0.0,0.0,0.0,3611,37288,54165,16877
5950,0.0,0.0,0.0,3611,37292,54165,16873
5952,0.0,0.0,0.0,3611,37296,54165,16869
5954,0.0,0.0,0.0,3611,37300,54165,16865
5957,0.0,0.0,0.0,3611,37304,54165,16861
5959,0.0,0.0,0.0,3611,37308,54165,16857
5960,0.0,0.0,0.0,3611,37312,54165,16853
5961,0.0,0.0,0.0,3611,37316,54165,16849
5962,0.0,0.0,0.0,3611,37320,54165,16845
5963,0.0,0.0,0.0,3611,37324,54165,16841
5964,0.0,0.0,0.0,3611,37328,54165,16837
5965,0.0,0.0,0.0,3611,37332,54165,16833
5966,0.0,0.0,0.0,3611,37336,54165,16829
5968,0.0,0.0,0.0,3611,37340,54165,16825
5970,0.0,0.0,0.0,3611,37344,54165,16821
5971,0.0,0.0,0.0,3611,37348,54165,16817
5972,0.0,0.0,0.0,3611,37352,54165,16813
5973,0.0,0.0,0.0,3611,37356,54165,16809
5974,0.0,0.0,0.0,3611,37360,54165,16805
5975,0.0,0.0,0.0,3611,37364,54165,16801
5976,0.0,0.0,0.0,3611,37368,54165,16797
5977,0.0,0.0,0.0,3611,37372,54165,16793
5978,0.0,0.0,0.0,3611,37376,54165,16789
5979,0.0,0.0,0.0,3611,37380,54165,16785
5980,0.0,0.0,0.0,3611,37384,54165,16781
5982,0.0,0.0,0.0,3611,37388,54165,16777
5986,0.0,0.0,0.0,3611,37392,54165,16773
5988,0.0,0.0,0.0,3611,37396,54165,16769
5989,0.0,0.0,0.0,3611,37400,54165,16765
5990,0.0,0.0,0.0,3611,37404,54165,16761
5992,0.0,0.0,0.0,3611,37408,54165,16757
5994,0.0,0.0,0.0,3611,37412,54165,16753
5995,0.0,0.0,0.0,3611,37416,54165,16749
5996,0.0,0.0,0.0,3611,37420,54165,16745
5997,0.0,0.0,0.0,3611,37424,54165,16741
5998,0.0,0.0,0.0,3611,37428,54165,16737
5999,0.0,0.0,0.0,3611,37432,54165,16733
6000,0.0,0.0,0.0,3611,37436,54165,16729
6001,0.0,0.0,0.0,3611,37440,54165,16725
6002,0.0,0.0,0.0,3611,37444,54165,16721
6003,0.0,0.0,0.0,3611,37448,54165,16717
6004,0.0,0.0,0.0,3611,37452,54165,16713
6006,0.0,0.0,0.0,3611,37456,54165,16709
6007,0.0,0.0,0.0,3611,37460,54165,16705
6009,0.0,0.0,0.0,3611,37464,54165,16701
6011,0.0,0.0,0.0,3611,37468,54165,16697
6013,0.0,0.0,0.0,3611,37472,54165,16693
6014,0.0,0.0,0.0,3611,37476,54165,16689
6016,0.0,0.0,0.0,3611,37480,54165,16685
6017,0.0,0.0,0.0,3611,37484,54165,16681
6018,0.0,0.0,0.0,3611,37488,54165,16677
6019,0.0,0.0,0.0,3611,37492,54165,16673
6020,0.0,0.0,0.0,3611,37496,54165,16669
6021,0.0,0.0,0.0,3611,37500,54165,16665
6022,0.0,0.0,0.0,3611,37504,54165,16661
6023,0.0,0.0,0.0,3611,37508,54165,16657
6024,0.0,0.0,0.0,3611,37512,54165,16653
6025,0.0,0.0,0.0,3611,37516,54165,16649
6026,0.0,0.0,0.0,3611,37520,54165,16645
6027,0.0,0.0,0.0,3611,37524,54165,16641
6028,0.0,0.0,0.0,3611,37528,54165,16637
6030,0.0,0.0,0.0,3611,37532,54165,16633
6031,0.0,0.0,0.0,3611,37536,54165,16629
6032,0.0,0.0,0.0,3611,37540,54165,16625
6033,0.0,0.0,0.0,3611,37544,54165,16621
6034,0.0,0.0,0.0,3611,37548,54165,16617
6035,0.0,0.0,0.0,3611,37552,54165,16613
6037,0.0,0.0,0.0,3611,37556,54165,16609
6039,0.0,0.0,0.0,3611,37560,54165,16605
6041,0.0,0.0,0.0,3611,37564,54165,16601
6042,0.0,0.0,0.0,3611,37568,54165,16597
6043,0.0,0.0,0.0,3611,37572,54165,16593
6044,0.0,0.0,0.0,3611,37576,54165,16589
6045,0.0,0.0,0.0,3611,37580,54165,16585
6046,0.0,0.0,0.0,3611,37584,54165,16581
6049,0.0,0.0,0.0,3611,37588,54165,16577
6051,0.0,0.0,0.0,3611,37592,54165,16573
6052,0.0,0.0,0.0,3611,37596,54165,16569
6053,0.0,0.0,0.0,3611,37600,54165,16565
6054,0.0,0.0,0.0,3611,37604,54165,16561
6055,0.0,0.0,0.0,3611,37608,54165,16557
6056,0.0,0.0,0.0,3611,37612,54165,16553
6057,0.0,0.0,0.0,3611,37616,54165,16549
6058,0.0,0.0,0.0,3611,37620,54165,16545
6059,0.0,0.0,0.0,3611,37624,54165,16541
6062,0.0,0.0,0.0,3611,37628,54165,16537
6063,0.0,0.0,0.0,3611,37632,54165,16533
6064,0.0,0.0,0.0,3611,37636,54165,16529
6065,0.0,0.0,0.0,3611,37640,54165,16525
6066,0.0,0.0,0.0,3611,37644,54165,16521
6067,0.0,0.0,0.0,3611,37648,54165,16517
6068,0.0,0.0,0.0,3611,37652,54165,16513
6069,0.0,0.0,0.0,3611,37656,54165,16509
6070,0.0,0.0,0.0,3611,37660,54165,16505
6072,0.0,0.0,0.0,3611,37664,54165,16501
6075,0.0,0.0,0.0,3611,37668,54165,16497
6077,0.0,0.0,0.0,3611,37672,54165,16493
6078,0.0,0.0,0.0,3611,37676,54165,16489
6080,0.0,0.0,0.0,3611,37680,54165,16485
6081,0.0,0.0,0.0,3611,37684,54165,16481
6083,0.0,0.0,0.0,3611,37688,54165,16477
6085,0.0,0.0,0.0,3611,37692,54165,16473
6086,0.0,0.0,0.0,3611,37696,54165,16469
6087,0.0,0.0,0.0,3611,37700,54165,16465
6088,0.0,0.0,0.0,3611,37704,54165,16461
6090,0.0,0.0,0.0,3611,37708,54165,16457
6091,0.0,0.0,0.0,3611,37712,54165,16453
6092,0.0,0.0,0.0,3611,37716,54165,16449
6093,0.0,0.0,0.0,3611,37720,54165,16445
6095,0.0,0.0,0.0,3611,37724,54165,16441
6096,0.0,0.0,0.0,3611,37728,54165,16437
6097,0.0,0.0,0.0,3611,37732,54165,16433
6098,0.0,0.0,0.0,3611,37736,54165,16429
6099,0.0,0.0,0.0,3611,37740,54165,16425
6100,0.0,0.0,0.0,3611,37744,54165,16421
6101,0.0,0.0,0.0,3611,37748,54165,16417
6102,0.0,0.0,0.0,3611,37752,54165,16413
6107,0.0,0.0,0.0,3611,37756,54165,16409
6108,0.0,0.0,0.0,3611,37760,54165,16405
6109,0.0,0.0,0.0,3611,37764,54165,16401
6110,0.0,0.0,0.0,3611,37768,54165,16397
6113,0.0,0.0,0.0,3611,37772,54165,16393
6114,0.0,0.0,0.0,3611,37776,54165,16389
6115,0.0,0.0,0.0,3611,37780,54165,16385
6116,0.0,0.0,0.0,3611,37784,54165,16381
6118,0.0,0.0,0.0,3611,37788,54165,16377
6119,0.0,0.0,0.0,3611,37792,54165,16373
6120,0.0,0.0,0.0,3611,37796,54165,16369
6121,0.0,0.0,0.0,3611,37800,54165,16365
6122,0.0,0.0,0.0,3611,37804,54165,16361
6123,0.0,0.0,0.0,3611,37808,54165,16357
6124,0.0,0.0,0.0,3611,37812,54165,16353
6126,0.0,0.0,0.0,3611,37816,54165,16349
6129,0.0,0.0,0.0,3611,37820,54165,16345
6130,0.0,0.0,0.0,3611,37824,54165,16341
6131,0.0,0.0,0.0,3611,37828,54165,16337
6132,0.0,0.0,0.0,3611,37832,54165,16333
6133,0.0,0.0,0.0,3611,37836,54165,16329
6134,0.0,0.0,0.0,3611,37840,54165,16325
6136,0.0,0.0,0.0,3611,37844,54165,16321
6137,0.0,0.0,0.0,3611,37848,54165,16317
6138,0.0,0.0,0.0,3611,37852,54165,16313
6139,0.0,0.0,0.0,3611,37856,54165,16309
6140,0.0,0.0,0.0,3611,37860,54165,16305
6141,0.0,0.0,0.0,3611,37864,54165,16301
6142,0.0,0.0,0.0,3611,37868,54165,16297
6143,0.0,0.0,0.0,3611,37872,54165,16293
6144,0.0,0.0,0.0,3611,37876,54165,16289
6145,0.0,0.0,0.0,3611,37880,54165,16285
6146,0.0,0.0,0.0,3611,37884,54165,16281
6147,0.0,0.0,0.0,3611,37888,54165,16277
6148,0.0,0.0,0.0,3611,37892,54165,16273
6149,0.0,0.0,0.0,3611,37896,54165,16269
6150,0.0,0.0,0.0,3611,37900,54165,16265
6153,0.0,0.0,0.0,3611,37904,54165,16261
6155,0.0,0.0,0.0,3611,37908,54165,16257
6156,0.0,0.0,0.0,3611,37912,54165,16253
6157,0.0,0.0,0.0,3611,37916,54165,16249
6158,0.0,0.0,0.0,3611,37920,54165,16245
6160,0.0,0.0,0.0,3611,37924,54165,16241
6161,0.0,0.0,0.0,3611,37928,54165,16237
6162,0.0,0.0,0.0,3611,37932,54165,16233
6163,0.0,0.0,0.0,3611,37936,54165,16229
6164,0.0,0.0,0.0,3611,37940,54165,16225
6165,0.0,0.0,0.0,3611,37944,54165,16221
6167,0.0,0.0,0.0,3611,37948,54165,16217
6168,0.0,0.0,0.0,3611,37952,54165,16213
6169,0.0,0.0,0.0,3611,37956,54165,16209
6171,0.0,0.0,0.0,3611,37960,54165,16205
6172,0.0,0.0,0.0,3611,37964,54165,16201
6173,0.0,0.0,0.0,3611,37968,54165,16197
6174,0.0,0.0,0.0,3611,37972,54165,16193
6175,0.0,0.0,0.0,3611,37976,54165,16189
6176,0.0,0.0,0.0,3611,37980,54165,16185
6177,0.0,0.0,0.0,3611,37984,54165,16181
6178,0.0,0.0,0.0,3611,37988,54165,16177
6180,0.0,0.0,0.0,3611,37992,54165,16173
6181,0.0,0.0,0.0,3611,37996,54165,16169
6182,0.0,0.0,0.0,3611,38000,54165,16165
6183,0.0,0.0,0.0,3611,38004,54165,16161
6184,0.0,0.0,0.0,3611,38008,54165,16157
6185,0.0,0.0,0.0,3611,38012,54165,16153
6186,0.0,0.0,0.0,3611,38016,54165,16149
6187,0.0,0.0,0.0,3611,38020,54165,16145
6188,0.0,0.0,0.0,3611,38024,54165,16141
6190,0.0,0.0,0.0,3611,38028,54165,16137
6191,0.0,0.0,0.0,3611,38032,54165,16133
6192,0.0,0.0,0.0,3611,38036,54165,16129
6193,0.0,0.0,0.0,3611,38040,54165,16125
6195,0.0,0.0,0.0,3611,38044,54165,16121
6198,0.0,0.0,0.0,3611,38048,54165,16117
6199,0.0,0.0,0.0,3611,38052,54165,16113
6200,0.0,0.0,0.0,3611,38056,54165,16109
6201,0.0,0.0,0.0,3611,38060,54165,16105
6202,0.0,0.0,0.0,3611,38064,54165,16101
6204,0.0,0.0,0.0,3611,38068,54165,16097
6206,0.0,0.0,0.0,3611,38072,54165,16093
6207,0.0,0.0,0.0,3611,38076,54165,16089
6208,0.0,0.0,0.0,3611,38080,54165,16085
6209,0.0,0.0,0.0,3611,38084,54165,16081
6210,0.0,0.0,0.0,3611,38088,54165,16077
6211,0.0,0.0,0.0,3611,38092,54165,16073
6212,0.0,0.0,0.0,3611,38096,54165,16069
6213,0.0,0.0,0.0,3611,38100,54165,16065
6214,0.0,0.0,0.0,3611,38104,54165,16061
6215,0.0,0.0,0.0,3611,38108,54165,16057
6216,0.0,0.0,0.0,3611,38112,54165,16053
6218,0.0,0.0,0.0,3611,38116,54165,16049
6221,0.0,0.0,0.0,3611,38120,54165,16045
6222,0.0,0.0,0.0,3611,38124,54165,16041
6223,0.0,0.0,0.0,3611,38128,54165,16037
6224,0.0,0.0,0.0,3611,38132,54165,16033
6225,0.0,0.0,0.0,3611,38136,54165,16029
6227,0.0,0.0,0.0,3611,38140,54165,16025
6228,0.0,0.0,0.0,3611,38144,54165,16021
6229,0.0,0.0,0.0,3611,38148,54165,16017
6230,0.0,0.0,0.0,3611,38152,54165,16013
6231,0.0,0.0,0.0,3611,38156,54165,16009
6232,0.0,0.0,0.0,3611,38160,54165,16005
6233,0.0,0.0,0.0,3611,38164,54165,16001
6234,0.0,0.0,0.0,3611,38168,54165,15997
6235,0.0,0.0,0.0,3611,38172,54165,15993
6236,0.0,0.0,0.0,3611,38176,54165,15989
6237,0.0,0.0,0.0,3611,38180,54165,15985
6238,0.0,0.0,0.0,3611,38184,54165,15981
6239,0.0,0.0,0.0,3611,38188,54165,15977
6240,0.0,0.0,0.0,3611,38192,54165,15973
6241,0.0,0.0,0.0,3611,38196,54165,15969
6242,0.0,0.0,0.0,3611,38200,54165,15965
6243,0.0,0.0,0.0,3611,38204,54165,15961
6244,0.0,0.0,0.0,3611,38208,54165,15957
6246,0.0,0.0,0.0,3611,38212,54165,15953
6247,0.0,0.0,0.0,3611,38216,54165,15949
6248,0.0,0.0,0.0,3611,38220,54165,15945
6249,0.0,0.0,0.0,3611,38224,54165,15941
6250,0.0,0.0,0.0,3611,38228,54165,15937
6251,0.0,0.0,0.0,3611,38232,54165,15933
6252,0.0,0.0,0.0,3611,38236,54165,15929
6253,0.0,0.0,0.0,3611,38240,54165,15925
6254,0.0,0.0,0.0,3611,38244,54165,15921
6255,0.0,0.0,0.0,3611,38248,54165,15917
6257,0.0,0.0,0.0,3611,38252,54165,15913
6258,0.0,0.0,0.0,3611,38256,54165,15909
6259,0.0,0.0,0.0,3611,38260,54165,15905
6260,0.0,0.0,0.0,3611,38264,54165,15901
6261,0.0,0.0,0.0,3611,38268,54165,15897
6262,0.0,0.0,0.0,3611,38272,54165,15893
6263,0.0,0.0,0.0,3611,38276,54165,15889
6264,0.0,0.0,0.0,3611,38280,54165,15885
6265,0.0,0.0,0.0,3611,38284,54165,15881
6266,0.0,0.0,0.0,3611,38288,54165,15877
6267,0.0,0.0,0.0,3611,38292,54165,15873
6268,0.0,0.0,0.0,3611,38296,54165,15869
6270,0.0,0.0,0.0,3611,38300,54165,15865
6271,0.0,0.0,0.0,3611,38304,54165,15861
6272,0.0,0.0,0.0,3611,38308,54165,15857
6273,0.0,0.0,0.0,3611,38312,54165,15853
6274,0.0,0.0,0.0,3611,38316,54165,15849
6275,0.0,0.0,0.0,3611,38320,54165,15845
6276,0.0,0.0,0.0,3611,38324,54165,15841
6277,0.0,0.0,0.0,3611,38328,54165,15837
6279,0.0,0.0,0.0,3611,38332,54165,15833
6280,0.0,0.0,0.0,3611,38336,54165,15829
6281,0.0,0.0,0.0,3611,38340,54165,15825
6282,0.0,0.0,0.0,3611,38344,54165,15821
6283,0.0,0.0,0.0,3611,38348,54165,15817
6284,0.0,0.0,0.0,3611,38352,54165,15813
6285,0.0,0.0,0.0,3611,38356,54165,15809
6286,0.0,0.0,0.0,3611,38360,54165,15805
6287,0.0,0.0,0.0,3611,38364,54165,15801
6289,0.0,0.0,0.0,3611,38368,54165,15797
6291,0.0,0.0,0.0,3611,38372,54165,15793
6292,0.0,0.0,0.0,3611,38376,54165,15789
6293,0.0,0.0,0.0,3611,38380,54165,15785
6294,0.0,0.0,0.0,3611,38384,54165,15781
6295,0.0,0.0,0.0,3611,38388,54165,15777
6296,0.0,0.0,0.0,3611,38392,54165,15773
6297,0.0,0.0,0.0,3611,38396,54165,15769
6298,0.0,0.0,0.0,3611,38400,54165,15765
6299,0.0,0.0,0.0,3611,38404,54165,15761
6300,0.0,0.0,0.0,3611,38408,54165,15757
6301,0.0,0.0,0.0,3611,38412,54165,15753
6302,0.0,0.0,0.0,3611,38416,54165,15749
6303,0.0,0.0,0.0,3611,38420,54165,15745
6304,0.0,0.0,0.0,3611,38424,54165,15741
6306,0.0,0.0,0.0,3611,38428,54165,15737
6307,0.0,0.0,0.0,3611,38432,54165,15733
6308,0.0,0.0,0.0,3611,38436,54165,15729
6310,0.0,0.0,0.0,3611,38440,54165,15725
6311,0.0,0.0,0.0,3611,38444,54165,15721
6313,0.0,0.0,0.0,3611,38448,54165,15717
6315,0.0,0.0,0.0,3611,38452,54165,15713
6316,0.0,0.0,0.0,3611,38456,54165,15709
6317,0.0,0.0,0.0,3611,38460,54165,15705
6319,0.0,0.0,0.0,3611,38464,54165,15701
6320,0.0,0.0,0.0,3611,38468,54165,15697
6321,0.0,0.0,0.0,3611,38472,54165,15693
6322,0.0,0.0,0.0,3611,38476,54165,15689
6324,0.0,0.0,0.0,3611,38480,54165,15685
6325,0.0,0.0,0.0,3611,38484,54165,15681
6326,0.0,0.0,0.0,3611,38488,54165,15677
6327,0.0,0.0,0.0,3611,38492,54165,15673
6328,0.0,0.0,0.0,3611,38496,54165,15669
6331,0.0,0.0,0.0,3611,38500,54165,15665
6332,0.0,0.0,0.0,3611,38504,54165,15661
6333,0.0,0.0,0.0,3611,38508,54165,15657
6335,0.0,0.0,0.0,3611,38512,54165,15653
6336,0.0,0.0,0.0,3611,38516,54165,15649
6337,0.0,0.0,0.0,3611,38520,54165,15645
6338,0.0,0.0,0.0,3611,38524,54165,15641
6339,0.0,0.0,0.0,3611,38528,54165,15637
6340,0.0,0.0,0.0,3611,38532,54165,15633
6341,0.0,0.0,0.0,3611,38536,54165,15629
6342,0.0,0.0,0.0,3611,38540,54165,15625
6344,0.0,0.0,0.0,3611,38544,54165,15621
6345,0.0,0.0,0.0,3611,38548,54165,15617
6346,0.0,0.0,0.0,3611,38552,54165,15613
6347,0.0,0.0,0.0,3611,38556,54165,15609
6348,0.0,0.0,0.0,3611,38560,54165,15605
6350,0.0,0.0,0.0,3611,38564,54165,15601
6352,0.0,0.0,0.0,3611,38568,54165,15597
6353,0.0,0.0,0.0,3611,38572,54165,15593
6355,0.0,0.0,0.0,3611,38576,54165,15589
6356,0.0,0.0,0.0,3611,38580,54165,15585
6357,0.0,0.0,0.0,3611,38584,54165,15581
6358,0.0,0.0,0.0,3611,38588,54165,15577
6359,0.0,0.0,0.0,3611,38592,54165,15573
6360,0.0,0.0,0.0,3611,38596,54165,15569
6361,0.0,0.0,0.0,3611,38600,54165,15565
6362,0.0,0.0,0.0,3611,38604,54165,15561
6363,0.0,0.0,0.0,3611,38608,54165,15557
6364,0.0,0.0,0.0,3611,38612,54165,15553
6365,0.0,0.0,0.0,3611,38616,54165,15549
6366,0.0,0.0,0.0,3611,38620,54165,15545
6367,0.0,0.0,0.0,3611,38624,54165,15541
6368,0.0,0.0,0.0,3611,38628,54165,15537
6369,0.0,0.0,0.0,3611,38632,54165,15533
6370,0.0,0.0,0.0,3611,38636,54165,15529
6371,0.0,0.0,0.0,3611,38640,54165,15525
6372,0.0,0.0,0.0,3611,38644,54165,15521
6373,0.0,0.0,0.0,3611,38648,54165,15517
6374,0.0,0.0,0.0,3611,38652,54165,15513
6375,0.0,0.0,0.0,3611,38656,54165,15509
6377,0.0,0.0,0.0,3611,38660,54165,15505
6378,0.0,0.0,0.0,3611,38664,54165,15501
6379,0.0,0.0,0.0,3611,38668,54165,15497
6380,0.0,0.0,0.0,3611,38672,54165,15493
6381,0.0,0.0,0.0,3611,38676,54165,15489
6382,0.0,0.0,0.0,3611,38680,54165,15485
6383,0.0,0.0,0.0,3611,38684,54165,15481
6385,0.0,0.0,0.0,3611,38688,54165,15477
6387,0.0,0.0,0.0,3611,38692,54165,15473
6389,0.0,0.0,0.0,3611,38696,54165,15469
6390,0.0,0.0,0.0,3611,38700,54165,15465
6392,0.0,0.0,0.0,3611,38704,54165,15461
6393,0.0,0.0,0.0,3611,38708,54165,15457
6394,0.0,0.0,0.0,3611,38712,54165,15453
6395,0.0,0.0,0.0,3611,38716,54165,15449
6396,0.0,0.0,0.0,3611,38720,54165,15445
6397,0.0,0.0,0.0,3611,38724,54165,15441
6398,0.0,0.0,0.0,3611,38728,54165,15437
6399,0.0,0.0,0.0,3611,38732,54165,15433
6400,0.0,0.0,0.0,3611,38736,54165,15429
6401,0.0,0.0,0.0,3611,38740,54165,15425
6402,0.0,0.0,0.0,3611,38744,54165,15421
6403,0.0,0.0,0.0,3611,38748,54165,15417
6404,0.0,0.0,0.0,3611,38752,54165,15413
6405,0.0,0.0,0.0,3611,38756,54165,15409
6407,0.0,0.0,0.0,3611,38760,54165,15405
6408,0.0,0.0,0.0,3611,38764,54165,15401
6410,0.0,0.0,0.0,3611,38768,54165,15397
6411,0.0,0.0,0.0,3611,38772,54165,15393
6413,0.0,0.0,0.0,3611,38776,54165,15389
6414,0.0,0.0,0.0,3611,38780,54165,15385
6415,0.0,0.0,0.0,3611,38784,54165,15381
6417,0.0,0.0,0.0,3611,38788,54165,15377
6418,0.0,0.0,0.0,3611,38792,54165,15373
6419,0.0,0.0,0.0,3611,38796,54165,15369
6420,0.0,0.0,0.0,3611,38800,54165,15365
6421,0.0,0.0,0.0,3611,38804,54165,15361
6423,0.0,0.0,0.0,3611,38808,54165,15357
6426,0.0,0.0,0.0,3611,38812,54165,15353
6427,0.0,0.0,0.0,3611,38816,54165,15349
6428,0.0,0.0,0.0,3611,38820,54165,15345
6430,0.0,0.0,0.0,3611,38824,54165,15341
6431,0.0,0.0,0.0,3611,38828,54165,15337
6432,0.0,0.0,0.0,3611,38832,54165,15333
6433,0.0,0.0,0.0,3611,38836,54165,15329
6435,0.0,0.0,0.0,3611,38840,54165,15325
6436,0.0,0.0,0.0,3611,38844,54165,15321
6438,0.0,0.0,0.0,3611,38848,54165,15317
6439,0.0,0.0,0.0,3611,38852,54165,15313
6440,0.0,0.0,0.0,3611,38856,54165,15309
6441,0.0,0.0,0.0,3611,38860,54165,15305
6442,0.0,0.0,0.0,3611,38864,54165,15301
6443,0.0,0.0,0.0,3611,38868,54165,15297
6444,0.0,0.0,0.0,3611,38872,54165,15293
6445,0.0,0.0,0.0,3611,38876,54165,15289
6446,0.0,0.0,0.0,3611,38880,54165,15285
6447,0.0,0.0,0.0,3611,38884,54165,15281
6449,0.0,0.0,0.0,3611,38888,54165,15277
6450,0.0,0.0,0.0,3611,38892,54165,15273
6451,0.0,0.0,0.0,3611,38896,54165,15269
6452,0.0,0.0,0.0,3611,38900,54165,15265
6453,0.0,0.0,0.0,3611,38904,54165,15261
6455,0.0,0.0,0.0,3611,38908,54165,15257
6456,0.0,0.0,0.0,3611,38912,54165,15253
6457,0.0,0.0,0.0,3611,38916,54165,15249
6460,0.0,0.0,0.0,3611,38920,54165,15245
6463,0.0,0.0,0.0,3611,38924,54165,15241
6464,0.0,0.0,0.0,3611,38928,54165,15237
6465,0.0,0.0,0.0,3611,38932,54165,15233
6467,0.0,0.0,0.0,3611,38936,54165,15229
6468,0.0,0.0,0.0,3611,38940,54165,15225
6469,0.0,0.0,0.0,3611,38944,54165,15221
6470,0.0,0.0,0.0,3611,38948,54165,15217
6471,0.0,0.0,0.0,3611,38952,54165,15213
6472,0.0,0.0,0.0,3611,38956,54165,15209
6473,0.0,0.0,0.0,3611,38960,54165,15205
6474,0.0,0.0,0.0,3611,38964,54165,15201
6475,0.0,0.0,0.0,3611,38968,54165,15197
6476,0.0,0.0,0.0,3611,38972,54165,15193
6477,0.0,0.0,0.0,3611,38976,54165,15189
6478,0.0,0.0,0.0,3611,38980,54165,15185
6479,0.0,0.0,0.0,3611,38984,54165,15181
6480,0.0,0.0,0.0,3611,38988,54165,15177
6481,0.0,0.0,0.0,3611,38992,54165,15173
6482,0.0,0.0,0.0,3611,38996,54165,15169
6483,0.0,0.0,0.0,3611,39000,54165,15165
6484,0.0,0.0,0.0,3611,39004,54165,15161
6486,0.0,0.0,0.0,3611,39008,54165,15157
6488,0.0,0.0,0.0,3611,39012,54165,15153
6489,0.0,0.0,0.0,3611,39016,54165,15149
6490,0.0,0.0,0.0,3611,39020,54165,15145
6491,0.0,0.0,0.0,3611,39024,54165,15141
6492,0.0,0.0,0.0,3611,39028,54165,15137
6493,0.0,0.0,0.0,3611,39032,54165,15133
6494,0.0,0.0,0.0,3611,39036,54165,15129
6495,0.0,0.0,0.0,3611,39040,54165,15125
6496,0.0,0.0,0.0,3611,39044,54165,15121
6497,0.0,0.0,0.0,3611,39048,54165,15117
6498,0.0,0.0,0.0,3611,39052,54165,15113
6499,0.0,0.0,0.0,3611,39056,54165,15109
6500,0.0,0.0,0.0,3611,39060,54165,15105
6502,0.0,0.0,0.0,3611,39064,54165,15101
6504,0.0,0.0,0.0,3611,39068,54165,15097
6505,0.0,0.0,0.0,3611,39072,54165,15093
6506,0.0,0.0,0.0,3611,39076,54165,15089
6507,0.0,0.0,0.0,3611,39080,54165,15085
6508,0.0,0.0,0.0,3611,39084,54165,15081
6509,0.0,0.0,0.0,3611,39088,54165,15077
6510,0.0,0.0,0.0,3611,39092,54165,15073
6512,0.0,0.0,0.0,3611,39096,54165,15069
6513,0.0,0.0,0.0,3611,39100,54165,15065
6514,0.0,0.0,0.0,3611,39104,54165,15061
6515,0.0,0.0,0.0,3611,39108,54165,15057
6516,0.0,0.0,0.0,3611,39112,54165,15053
6517,0.0,0.0,0.0,3611,39116,54165,15049
6518,0.0,0.0,0.0,3611,39120,54165,15045
6520,0.0,0.0,0.0,3611,39124,54165,15041
6521,0.0,0.0,0.0,3611,39128,54165,15037
6522,0.0,0.0,0.0,3611,39132,54165,15033
6523,0.0,0.0,0.0,3611,39136,54165,15029
6524,0.0,0.0,0.0,3611,39140,54165,15025
6525,0.0,0.0,0.0,3611,39144,54165,15021
6529,0.0,0.0,0.0,3611,39148,54165,15017
6530,0.0,0.0,0.0,3611,39152,54165,15013
6531,0.0,0.0,0.0,3611,39156,54165,15009
6532,0.0,0.0,0.0,3611,39160,54165,15005
6533,0.0,0.0,0.0,3611,39164,54165,15001
6534,0.0,0.0,0.0,3611,39168,54165,14997
6535,0.0,0.0,0.0,3611,39172,54165,14993
6536,0.0,0.0,0.0,3611,39176,54165,14989
6537,0.0,0.0,0.0,3611,39180,54165,14985
6538,0.0,0.0,0.0,3611,39184,54165,14981
6540,0.0,0.0,0.0,3611,39188,54165,14977
6541,0.0,0.0,0.0,3611,39192,54165,14973
6542,0.0,0.0,0.0,3611,39196,54165,14969
6543,0.0,0.0,0.0,3611,39200,54165,14965
6544,0.0,0.0,0.0,3611,39204,54165,14961
6545,0.0,0.0,0.0,3611,39208,54165,14957
6546,0.0,0.0,0.0,3611,39212,54165,14953
6549,0.0,0.0,0.0,3611,39216,54165,14949
6550,0.0,0.0,0.0,3611,39220,54165,14945
6551,0.0,0.0,0.0,3611,39224,54165,14941
6552,0.0,0.0,0.0,3611,39228,54165,14937
6553,0.0,0.0,0.0,3611,39232,54165,14933
6555,0.0,0.0,0.0,3611,39236,54165,14929
6556,0.0,0.0,0.0,3611,39240,54165,14925
6557,0.0,0.0,0.0,3611,39244,54165,14921
6558,0.0,0.0,0.0,3611,39248,54165,14917
6559,0.0,0.0,0.0,3611,39252,54165,14913
6560,0.0,0.0,0.0,3611,39256,54165,14909
6561,0.0,0.0,0.0,3611,39260,54165,14905
6562,0.0,0.0,0.0,3611,39264,54165,14901
6564,0.0,0.0,0.0,3611,39268,54165,14897
6565,0.0,0.0,0.0,3611,39272,54165,14893
6567,0.0,0.0,0.0,3611,39276,54165,14889
6568,0.0,0.0,0.0,3611,39280,54165,14885
6569,0.0,0.0,0.0,3611,39284,54165,14881
6570,0.0,0.0,0.0,3611,39288,54165,14877
6571,0.0,0.0,0.0,3611,39292,54165,14873
6572,0.0,0.0,0.0,3611,39296,54165,14869
6573,0.0,0.0,0.0,3611,39300,54165,14865
6574,0.0,0.0,0.0,3611,39304,54165,14861
6575,0.0,0.0,0.0,3611,39308,54165,14857
6578,0.0,0.0,0.0,3611,39312,54165,14853
6579,0.0,0.0,0.0,3611,39316,54165,14849
6580,0.0,0.0,0.0,3611,39320,54165,14845
6582,0.0,0.0,0.0,3611,39324,54165,14841
6583,0.0,0.0,0.0,3611,39328,54165,14837
6584,0.0,0.0,0.0,3611,39332,54165,14833
6585,0.0,0.0,0.0,3611,39336,54165,14829
6586,0.0,0.0,0.0,3611,39340,54165,14825
6588,0.0,0.0,0.0,3611,39344,54165,14821
6589,0.0,0.0,0.0,3611,39348,54165,14817
6592,0.0,0.0,0.0,3611,39352,54165,14813
6593,0.0,0.0,0.0,3611,39356,54165,14809
6594,0.0,0.0,0.0,3611,39360,54165,14805
6595,0.0,0.0,0.0,3611,39364,54165,14801
6596,0.0,0.0,0.0,3611,39368,54165,14797
6598,0.0,0.0,0.0,3611,39372,54165,14793
6599,0.0,0.0,0.0,3611,39376,54165,14789
6600,0.0,0.0,0.0,3611,39380,54165,14785
6601,0.0,0.0,0.0,3611,39384,54165,14781
6602,0.0,0.0,0.0,3611,39388,54165,14777
6603,0.0,0.0,0.0,3611,39392,54165,14773
6604,0.0,0.0,0.0,3611,39396,54165,14769
6605,0.0,0.0,0.0,3611,39400,54165,14765
6606,0.0,0.0,0.0,3611,39404,54165,14761
6607,0.0,0.0,0.0,3611,39408,54165,14757
6608,0.0,0.0,0.0,3611,39412,54165,14753
6609,0.0,0.0,0.0,3611,39416,54165,14749
6610,0.0,0.0,0.0,3611,39420,54165,14745
6612,0.0,0.0,0.0,3611,39424,54165,14741
6613,0.0,0.0,0.0,3611,39428,54165,14737
6614,0.0,0.0,0.0,3611,39432,54165,14733
6615,0.0,0.0,0.0,3611,39436,54165,14729
6616,0.0,0.0,0.0,3611,39440,54165,14725
6617,0.0,0.0,0.0,3611,39444,54165,14721
6618,0.0,0.0,0.0,3611,39448,54165,14717
6622,0.0,0.0,0.0,3611,39452,54165,14713
6623,0.0,0.0,0.0,3611,39456,54165,14709
6624,0.0,0.0,0.0,3611,39460,54165,14705
6625,0.0,0.0,0.0,3611,39464,54165,14701
6627,0.0,0.0,0.0,3611,39468,54165,14697
6630,0.0,0.0,0.0,3611,39472,54165,14693
6632,0.0,0.0,0.0,3611,39476,54165,14689
6633,0.0,0.0,0.0,3611,39480,54165,14685
6635,0.0,0.0,0.0,3611,39484,54165,14681
6636,0.0,0.0,0.0,3611,39488,54165,14677
6637,0.0,0.0,0.0,3611,39492,54165,14673
6638,0.0,0.0,0.0,3611,39496,54165,14669
6639,0.0,0.0,0.0,3611,39500,54165,14665
6641,0.0,0.0,0.0,3611,39504,54165,14661
6642,0.0,0.0,0.0,3611,39508,54165,14657
6643,0.0,0.0,0.0,3611,39512,54165,14653
6644,0.0,0.0,0.0,3611,39516,54165,14649
6645,0.0,0.0,0.0,3611,39520,54165,14645
6646,0.0,0.0,0.0,3611,39524,54165,14641
6647,0.0,0.0,0.0,3611,39528,54165,14637
6648,0.0,0.0,0.0,3611,39532,54165,14633
6650,0.0,0.0,0.0,3611,39536,54165,14629
6651,0.0,0.0,0.0,3611,39540,54165,14625
6652,0.0,0.0,0.0,3611,39544,54165,14621
6653,0.0,0.0,0.0,3611,39548,54165,14617
6655,0.0,0.0,0.0,3611,39552,54165,14613
6656,0.0,0.0,0.0,3611,39556,54165,14609
6657,0.0,0.0,0.0,3611,39560,54165,14605
6658,0.0,0.0,0.0,3611,39564,54165,14601
6659,0.0,0.0,0.0,3611,39568,54165,14597
6660,0.0,0.0,0.0,3611,39572,54165,14593
6661,0.0,0.0,0.0,3611,39576,54165,14589
6662,0.0,0.0,0.0,3611,39580,54165,14585
6663,0.0,0.0,0.0,3611,39584,54165,14581
6664,0.0,0.0,0.0,3611,39588,54165,14577
6665,0.0,0.0,0.0,3611,39592,54165,14573
6666,0.0,0.0,0.0,3611,39596,54165,14569
6667,0.0,0.0,0.0,3611,39600,54165,14565
6668,0.0,0.0,0.0,3611,39604,54165,14561
6669,0.0,0.0,0.0,3611,39608,54165,14557
6670,0.0,0.0,0.0,3611,39612,54165,14553
6671,0.0,0.0,0.0,3611,39616,54165,14549
6672,0.0,0.0,0.0,3611,39620,54165,14545
6673,0.0,0.0,0.0,3611,39624,54165,14541
6674,0.0,0.0,0.0,3611,39628,54165,14537
6675,0.0,0.0,0.0,3611,39632,54165,14533
6676,0.0,0.0,0.0,3611,39636,54165,14529
6677,0.0,0.0,0.0,3611,39640,54165,14525
6678,0.0,0.0,0.0,3611,39644,54165,14521
6679,0.0,0.0,0.0,3611,39648,54165,14517
6680,0.0,0.0,0.0,3611,39652,54165,14513
6681,0.0,0.0,0.0,3611,39656,54165,14509
6682,0.0,0.0,0.0,3611,39660,54165,14505
6683,0.0,0.0,0.0,3611,39664,54165,14501
6684,0.0,0.0,0.0,3611,39668,54165,14497
6685,0.0,0.0,0.0,3611,39672,54165,14493
6686,0.0,0.0,0.0,3611,39676,54165,14489
6687,0.0,0.0,0.0,3611,39680,54165,14485
6688,0.0,0.0,0.0,3611,39684,54165,14481
6689,0.0,0.0,0.0,3611,39688,54165,14477
6690,0.0,0.0,0.0,3611,39692,54165,14473
6691,0.0,0.0,0.0,3611,39696,54165,14469
6692,0.0,0.0,0.0,3611,39700,54165,14465
6693,0.0,0.0,0.0,3611,39704,54165,14461
6694,0.0,0.0,0.0,3611,39708,54165,14457
6696,0.0,0.0,0.0,3611,39712,54165,14453
6698,0.0,0.0,0.0,3611,39716,54165,14449
6699,0.0,0.0,0.0,3611,39720,54165,14445
6700,0.0,0.0,0.0,3611,39724,54165,14441
6703,0.0,0.0,0.0,3611,39728,54165,14437
6704,0.0,0.0,0.0,3611,39732,54165,14433
6706,0.0,0.0,0.0,3611,39736,54165,14429
6708,0.0,0.0,0.0,3611,39740,54165,14425
6709,0.0,0.0,0.0,3611,39744,54165,14421
6710,0.0,0.0,0.0,3611,39748,54165,14417
6712,0.0,0.0,0.0,3611,39752,54165,14413
6713,0.0,0.0,0.0,3611,39756,54165,14409
6714,0.0,0.0,0.0,3611,39760,54165,14405
6715,0.0,0.0,0.0,3611,39764,54165,14401
6717,0.0,0.0,0.0,3611,39768,54165,14397
6718,0.0,0.0,0.0,3611,39772,54165,14393
6719,0.0,0.0,0.0,3611,39776,54165,14389
6723,0.0,0.0,0.0,3611,39780,54165,14385
6725,0.0,0.0,0.0,3611,39784,54165,14381
6726,0.0,0.0,0.0,3611,39788,54165,14377
6728,0.0,0.0,0.0,3611,39792,54165,14373
6729,0.0,0.0,0.0,3611,39796,54165,14369
6730,0.0,0.0,0.0,3611,39800,54165,14365
6731,0.0,0.0,0.0,3611,39804,54165,14361
6732,0.0,0.0,0.0,3611,39808,54165,14357
6733,0.0,0.0,0.0,3611,39812,54165,14353
6734,0.0,0.0,0.0,3611,39816,54165,14349
6735,0.0,0.0,0.0,3611,39820,54165,14345
6737,0.0,0.0,0.0,3611,39824,54165,14341
6738,0.0,0.0,0.0,3611,39828,54165,14337
6739,0.0,0.0,0.0,3611,39832,54165,14333
6740,0.0,0.0,0.0,3611,39836,54165,14329
6741,0.0,0.0,0.0,3611,39840,54165,14325
6743,0.0,0.0,0.0,3611,39844,54165,14321
6744,0.0,0.0,0.0,3611,39848,54165,14317
6745,0.0,0.0,0.0,3611,39852,54165,14313
6746,0.0,0.0,0.0,3611,39856,54165,14309
6747,0.0,0.0,0.0,3611,39860,54165,14305
6750,0.0,0.0,0.0,3611,39864,54165,14301
6751,0.0,0.0,0.0,3611,39868,54165,14297
6753,0.0,0.0,0.0,3611,39872,54165,14293
6755,0.0,0.0,0.0,3611,39876,54165,14289
6758,0.0,0.0,0.0,3611,39880,54165,14285
6760,0.0,0.0,0.0,3611,39884,54165,14281
6761,0.0,0.0,0.0,3611,39888,54165,14277
6762,0.0,0.0,0.0,3611,39892,54165,14273
6764,0.0,0.0,0.0,3611,39896,54165,14269
6765,0.0,0.0,0.0,3611,39900,54165,14265
6767,0.0,0.0,0.0,3611,39904,54165,14261
6768,0.0,0.0,0.0,3611,39908,54165,14257
6769,0.0,0.0,0.0,3611,39912,54165,14253
6770,0.0,0.0,0.0,3611,39916,54165,14249
6771,0.0,0.0,0.0,3611,39920,54165,14245
6772,0.0,0.0,0.0,3611,39924,54165,14241
6774,0.0,0.0,0.0,3611,39928,54165,14237
6775,0.0,0.0,0.0,3611,39932,54165,14233
6776,0.0,0.0,0.0,3611,39936,54165,14229
6777,0.0,0.0,0.0,3611,39940,54165,14225
6778,0.0,0.0,0.0,3611,39944,54165,14221
6779,0.0,0.0,0.0,3611,39948,54165,14217
6780,0.0,0.0,0.0,3611,39952,54165,14213
6783,0.0,0.0,0.0,3611,39956,54165,14209
6784,0.0,0.0,0.0,3611,39960,54165,14205
6785,0.0,0.0,0.0,3611,39964,54165,14201
6787,0.0,0.0,0.0,3611,39968,54165,14197
6788,0.0,0.0,0.0,3611,39972,54165,14193
6789,0.0,0.0,0.0,3611,39976,54165,14189
6791,0.0,0.0,0.0,3611,39980,54165,14185
6792,0.0,0.0,0.0,3611,39984,54165,14181
6793,0.0,0.0,0.0,3611,39988,54165,14177
6795,0.0,0.0,0.0,3611,39992,54165,14173
6796,0.0,0.0,0.0,3611,39996,54165,14169
6797,0.0,0.0,0.0,3611,40000,54165,14165
6798,0.0,0.0,0.0,3611,40004,54165,14161
6799,0.0,0.0,0.0,3611,40008,54165,14157
6800,0.0,0.0,0.0,3611,40012,54165,14153
6801,0.0,0.0,0.0,3611,40016,54165,14149
6802,0.0,0.0,0.0,3611,40020,54165,14145
6803,0.0,0.0,0.0,3611,40024,54165,14141
6804,0.0,0.0,0.0,3611,40028,54165,14137
6806,0.0,0.0,0.0,3611,40032,54165,14133
6807,0.0,0.0,0.0,3611,40036,54165,14129
6808,0.0,0.0,0.0,3611,40040,54165,14125
6809,0.0,0.0,0.0,3611,40044,54165,14121
6811,0.0,0.0,0.0,3611,40048,54165,14117
6812,0.0,0.0,0.0,3611,40052,54165,14113
6814,0.0,0.0,0.0,3611,40056,54165,14109
6815,0.0,0.0,0.0,3611,40060,54165,14105
6816,0.0,0.0,0.0,3611,40064,54165,14101
6817,0.0,0.0,0.0,3611,40068,54165,14097
6818,0.0,0.0,0.0,3611,40072,54165,14093
6819,0.0,0.0,0.0,3611,40076,54165,14089
6821,0.0,0.0,0.0,3611,40080,54165,14085
6822,0.0,0.0,0.0,3611,40084,54165,14081
6823,0.0,0.0,0.0,3611,40088,54165,14077
6824,0.0,0.0,0.0,3611,40092,54165,14073
6825,0.0,0.0,0.0,3611,40096,54165,14069
6826,0.0,0.0,0.0,3611,40100,54165,14065
6827,0.0,0.0,0.0,3611,40104,54165,14061
6828,0.0,0.0,0.0,3611,40108,54165,14057
6829,0.0,0.0,0.0,3611,40112,54165,14053
6830,0.0,0.0,0.0,3611,40116,54165,14049
6831,0.0,0.0,0.0,3611,40120,54165,14045
6833,0.0,0.0,0.0,3611,40124,54165,14041
6834,0.0,0.0,0.0,3611,40128,54165,14037
6835,0.0,0.0,0.0,3611,40132,54165,14033
6836,0.0,0.0,0.0,3611,40136,54165,14029
6838,0.0,0.0,0.0,3611,40140,54165,14025
6839,0.0,0.0,0.0,3611,40144,54165,14021
6841,0.0,0.0,0.0,3611,40148,54165,14017
6842,0.0,0.0,0.0,3611,40152,54165,14013
6843,0.0,0.0,0.0,3611,40156,54165,14009
6845,0.0,0.0,0.0,3611,40160,54165,14005
6847,0.0,0.0,0.0,3611,40164,54165,14001
6848,0.0,0.0,0.0,3611,40168,54165,13997
6850,0.0,0.0,0.0,3611,40172,54165,13993
6851,0.0,0.0,0.0,3611,40176,54165,13989
6852,0.0,0.0,0.0,3611,40180,54165,13985
6854,0.0,0.0,0.0,3611,40184,54165,13981
6855,0.0,0.0,0.0,3611,40188,54165,13977
6857,0.0,0.0,0.0,3611,40192,54165,13973
6858,0.0,0.0,0.0,3611,40196,54165,13969
6859,0.0,0.0,0.0,3611,40200,54165,13965
6861,0.0,0.0,0.0,3611,40204,54165,13961
6862,0.0,0.0,0.0,3611,40208,54165,13957
6864,0.0,0.0,0.0,3611,40212,54165,13953
6865,0.0,0.0,0.0,3611,40216,54165,13949
6866,0.0,0.0,0.0,3611,40220,54165,13945
6867,0.0,0.0,0.0,3611,40224,54165,13941
6868,0.0,0.0,0.0,3611,40228,54165,13937
6870,0.0,0.0,0.0,3611,40232,54165,13933
6872,0.0,0.0,0.0,3611,40236,54165,13929
6873,0.0,0.0,0.0,3611,40240,54165,13925
6874,0.0,0.0,0.0,3611,40244,54165,13921
6875,0.0,0.0,0.0,3611,40248,54165,13917
6876,0.0,0.0,0.0,3611,40252,54165,13913
6877,0.0,0.0,0.0,3611,40256,54165,13909
6878,0.0,0.0,0.0,3611,40260,54165,13905
6879,0.0,0.0,0.0,3611,40264,54165,13901
6880,0.0,0.0,0.0,3611,40268,54165,13897
6881,0.0,0.0,0.0,3611,40272,54165,13893
6882,0.0,0.0,0.0,3611,40276,54165,13889
6883,0.0,0.0,0.0,3611,40280,54165,13885
6884,0.0,0.0,0.0,3611,40284,54165,13881
6886,0.0,0.0,0.0,3611,40288,54165,13877
6889,0.0,0.0,0.0,3611,40292,54165,13873
6890,0.0,0.0,0.0,3611,40296,54165,13869
6891,0.0,0.0,0.0,3611,40300,54165,13865
6892,0.0,0.0,0.0,3611,40304,54165,13861
6893,0.0,0.0,0.0,3611,40308,54165,13857
6894,0.0,0.0,0.0,3611,40312,54165,13853
6895,0.0,0.0,0.0,3611,40316,54165,13849
6896,0.0,0.0,0.0,3611,40320,54165,13845
6897,0.0,0.0,0.0,3611,40324,54165,13841
6898,0.0,0.0,0.0,3611,40328,54165,13837
6899,0.0,0.0,0.0,3611,40332,54165,13833
6900,0.0,0.0,0.0,3611,40336,54165,13829
6901,0.0,0.0,0.0,3611,40340,54165,13825
6902,0.0,0.0,0.0,3611,40344,54165,13821
6904,0.0,0.0,0.0,3611,40348,54165,13817
6905,0.0,0.0,0.0,3611,40352,54165,13813
6906,0.0,0.0,0.0,3611,40356,54165,13809
6907,0.0,0.0,0.0,3611,40360,54165,13805
6909,0.0,0.0,0.0,3611,40364,54165,13801
6910,0.0,0.0,0.0,3611,40368,54165,13797
6911,0.0,0.0,0.0,3611,40372,54165,13793
6912,0.0,0.0,0.0,3611,40376,54165,13789
6913,0.0,0.0,0.0,3611,40380,54165,13785
6914,0.0,0.0,0.0,3611,40384,54165,13781
6915,0.0,0.0,0.0,3611,40388,54165,13777
6917,0.0,0.0,0.0,3611,40392,54165,13773
6918,0.0,0.0,0.0,3611,40396,54165,13769
6919,0.0,0.0,0.0,3611,40400,54165,13765
6920,0.0,0.0,0.0,3611,40404,54165,13761
6921,0.0,0.0,0.0,3611,40408,54165,13757
6922,0.0,0.0,0.0,3611,40412,54165,13753
6923,0.0,0.0,0.0,3611,40416,54165,13749
6925,0.0,0.0,0.0,3611,40420,54165,13745
6926,0.0,0.0,0.0,3611,40424,54165,13741
6927,0.0,0.0,0.0,3611,40428,54165,13737
6928,0.0,0.0,0.0,3611,40432,54165,13733
6929,0.0,0.0,0.0,3611,40436,54165,13729
6930,0.0,0.0,0.0,3611,40440,54165,13725
6932,0.0,0.0,0.0,3611,40444,54165,13721
6933,0.0,0.0,0.0,3611,40448,54165,13717
6934,0.0,0.0,0.0,3611,40452,54165,13713
6935,0.0,0.0,0.0,3611,40456,54165,13709
6936,0.0,0.0,0.0,3611,40460,54165,13705
6937,0.0,0.0,0.0,3611,40464,54165,13701
6938,0.0,0.0,0.0,3611,40468,54165,13697
6939,0.0,0.0,0.0,3611,40472,54165,13693
6940,0.0,0.0,0.0,3611,40476,54165,13689
6941,0.0,0.0,0.0,3611,40480,54165,13685
6942,0.0,0.0,0.0,3611,40484,54165,13681
6943,0.0,0.0,0.0,3611,40488,54165,13677
6944,0.0,0.0,0.0,3611,40492,54165,13673
6946,0.0,0.0,0.0,3611,40496,54165,13669
6948,0.0,0.0,0.0,3611,40500,54165,13665
6949,0.0,0.0,0.0,3611,40504,54165,13661
6950,0.0,0.0,0.0,3611,40508,54165,13657
6951,0.0,0.0,0.0,3611,40512,54165,13653
6952,0.0,0.0,0.0,3611,40516,54165,13649
6953,0.0,0.0,0.0,3611,40520,54165,13645
6954,0.0,0.0,0.0,3611,40524,54165,13641
6955,0.0,0.0,0.0,3611,40528,54165,13637
6958,0.0,0.0,0.0,3611,40532,54165,13633
6959,0.0,0.0,0.0,3611,40536,54165,13629
6960,0.0,0.0,0.0,3611,40540,54165,13625
6961,0.0,0.0,0.0,3611,40544,54165,13621
6962,0.0,0.0,0.0,3611,40548,54165,13617
6963,0.0,0.0,0.0,3611,40552,54165,13613
6964,0.0,0.0,0.0,3611,40556,54165,13609
6965,0.0,0.0,0.0,3611,40560,54165,13605
6966,0.0,0.0,0.0,3611,40564,54165,13601
6967,0.0,0.0,0.0,3611,40568,54165,13597
6969,0.0,0.0,0.0,3611,40572,54165,13593
6970,0.0,0.0,0.0,3611,40576,54165,13589
6971,0.0,0.0,0.0,3611,40580,54165,13585
6972,0.0,0.0,0.0,3611,40584,54165,13581
6973,0.0,0.0,0.0,3611,40588,54165,13577
6975,0.0,0.0,0.0,3611,40592,54165,13573
6977,0.0,0.0,0.0,3611,40596,54165,13569
6978,0.0,0.0,0.0,3611,40600,54165,13565
6980,0.0,0.0,0.0,3611,40604,54165,13561
6981,0.0,0.0,0.0,3611,40608,54165,13557
6982,0.0,0.0,0.0,3611,40612,54165,13553
6984,0.0,0.0,0.0,3611,40616,54165,13549
6987,0.0,0.0,0.0,3611,40620,54165,13545
6988,0.0,0.0,0.0,3611,40624,54165,13541
6989,0.0,0.0,0.0,3611,40628,54165,13537
6990,0.0,0.0,0.0,3611,40632,54165,13533
6992,0.0,0.0,0.0,3611,40636,54165,13529
6993,0.0,0.0,0.0,3611,40640,54165,13525
6994,0.0,0.0,0.0,3611,40644,54165,13521
6995,0.0,0.0,0.0,3611,40648,54165,13517
6996,0.0,0.0,0.0,3611,40652,54165,13513
6997,0.0,0.0,0.0,3611,40656,54165,13509
6998,0.0,0.0,0.0,3611,40660,54165,13505
6999,0.0,0.0,0.0,3611,40664,54165,13501
7002,0.0,0.0,0.0,3611,40668,54165,13497
7003,0.0,0.0,0.0,3611,40672,54165,13493
7004,0.0,0.0,0.0,3611,40676,54165,13489
7005,0.0,0.0,0.0,3611,40680,54165,13485
7006,0.0,0.0,0.0,3611,40684,54165,13481
7007,0.0,0.0,0.0,3611,40688,54165,13477
7008,0.0,0.0,0.0,3611,40692,54165,13473
7009,0.0,0.0,0.0,3611,40696,54165,13469
7010,0.0,0.0,0.0,3611,40700,54165,13465
7011,0.0,0.0,0.0,3611,40704,54165,13461
7012,0.0,0.0,0.0,3611,40708,54165,13457
7013,0.0,0.0,0.0,3611,40712,54165,13453
7014,0.0,0.0,0.0,3611,40716,54165,13449
7015,0.0,0.0,0.0,3611,40720,54165,13445
7016,0.0,0.0,0.0,3611,40724,54165,13441
7017,0.0,0.0,0.0,3611,40728,54165,13437
7018,0.0,0.0,0.0,3611,40732,54165,13433
7021,0.0,0.0,0.0,3611,40736,54165,13429
7023,0.0,0.0,0.0,3611,40740,54165,13425
7024,0.0,0.0,0.0,3611,40744,54165,13421
7025,0.0,0.0,0.0,3611,40748,54165,13417
7026,0.0,0.0,0.0,3611,40752,54165,13413
7027,0.0,0.0,0.0,3611,40756,54165,13409
7028,0.0,0.0,0.0,3611,40760,54165,13405
7030,0.0,0.0,0.0,3611,40764,54165,13401
7031,0.0,0.0,0.0,3611,40768,54165,13397
7032,0.0,0.0,0.0,3611,40772,54165,13393
7033,0.0,0.0,0.0,3611,40776,54165,13389
7034,0.0,0.0,0.0,3611,40780,54165,13385
7035,0.0,0.0,0.0,3611,40784,54165,13381
7036,0.0,0.0,0.0,3611,40788,54165,13377
7037,0.0,0.0,0.0,3611,40792,54165,13373
7038,0.0,0.0,0.0,3611,40796,54165,13369
7039,0.0,0.0,0.0,3611,40800,54165,13365
7040,0.0,0.0,0.0,3611,40804,54165,13361
7042,0.0,0.0,0.0,3611,40808,54165,13357
7043,0.0,0.0,0.0,3611,40812,54165,13353
7044,0.0,0.0,0.0,3611,40816,54165,13349
7045,0.0,0.0,0.0,3611,40820,54165,13345
7046,0.0,0.0,0.0,3611,40824,54165,13341
7048,0.0,0.0,0.0,3611,40828,54165,13337
7049,0.0,0.0,0.0,3611,40832,54165,13333
7050,0.0,0.0,0.0,3611,40836,54165,13329
7051,0.0,0.0,0.0,3611,40840,54165,13325
7052,0.0,0.0,0.0,3611,40844,54165,13321
7053,0.0,0.0,0.0,3611,40848,54165,13317
7054,0.0,0.0,0.0,3611,40852,54165,13313
7055,0.0,0.0,0.0,3611,40856,54165,13309
7056,0.0,0.0,0.0,3611,40860,54165,13305
7057,0.0,0.0,0.0,3611,40864,54165,13301
7058,0.0,0.0,0.0,3611,40868,54165,13297
7059,0.0,0.0,0.0,3611,40872,54165,13293
7060,0.0,0.0,0.0,3611,40876,54165,13289
7061,0.0,0.0,0.0,3611,40880,54165,13285
7062,0.0,0.0,0.0,3611,40884,54165,13281
7063,0.0,0.0,0.0,3611,40888,54165,13277
7064,0.0,0.0,0.0,3611,40892,54165,13273
7065,0.0,0.0,0.0,3611,40896,54165,13269
7067,0.0,0.0,0.0,3611,40900,54165,13265
7068,0.0,0.0,0.0,3611,40904,54165,13261
7069,0.0,0.0,0.0,3611,40908,54165,13257
7070,0.0,0.0,0.0,3611,40912,54165,13253
7071,0.0,0.0,0.0,3611,40916,54165,13249
7072,0.0,0.0,0.0,3611,40920,54165,13245
7073,0.0,0.0,0.0,3611,40924,54165,13241
7074,0.0,0.0,0.0,3611,40928,54165,13237
7075,0.0,0.0,0.0,3611,40932,54165,13233
7076,0.0,0.0,0.0,3611,40936,54165,13229
7077,0.0,0.0,0.0,3611,40940,54165,13225
7078,0.0,0.0,0.0,3611,40944,54165,13221
7079,0.0,0.0,0.0,3611,40948,54165,13217
7082,0.0,0.0,0.0,3611,40952,54165,13213
7083,0.0,0.0,0.0,3611,40956,54165,13209
7084,0.0,0.0,0.0,3611,40960,54165,13205
7085,0.0,0.0,0.0,3611,40964,54165,13201
7088,0.0,0.0,0.0,3611,40968,54165,13197
7089,0.0,0.0,0.0,3611,40972,54165,13193
7090,0.0,0.0,0.0,3611,40976,54165,13189
7091,0.0,0.0,0.0,3611,40980,54165,13185
7093,0.0,0.0,0.0,3611,40984,54165,13181
7094,0.0,0.0,0.0,3611,40988,54165,13177
7095,0.0,0.0,0.0,3611,40992,54165,13173
7096,0.0,0.0,0.0,3611,40996,54165,13169
7097,0.0,0.0,0.0,3611,41000,54165,13165
7098,0.0,0.0,0.0,3611,41004,54165,13161
7100,0.0,0.0,0.0,3611,41008,54165,13157
7101,0.0,0.0,0.0,3611,41012,54165,13153
7106,0.0,0.0,0.0,3611,41016,54165,13149
7107,0.0,0.0,0.0,3611,41020,54165,13145
7108,0.0,0.0,0.0,3611,41024,54165,13141
7109,0.0,0.0,0.0,3611,41028,54165,13137
7111,0.0,0.0,0.0,3611,41032,54165,13133
7112,0.0,0.0,0.0,3611,41036,54165,13129
7113,0.0,0.0,0.0,3611,41040,54165,13125
7114,0.0,0.0,0.0,3611,41044,54165,13121
7117,0.0,0.0,0.0,3611,41048,54165,13117
7118,0.0,0.0,0.0,3611,41052,54165,13113
7119,0.0,0.0,0.0,3611,41056,54165,13109
7120,0.0,0.0,0.0,3611,41060,54165,13105
7121,0.0,0.0,0.0,3611,41064,54165,13101
7123,0.0,0.0,0.0,3611,41068,54165,13097
7125,0.0,0.0,0.0,3611,41072,54165,13093
7126,0.0,0.0,0.0,3611,41076,54165,13089
7128,0.0,0.0,0.0,3611,41080,54165,13085
7129,0.0,0.0,0.0,3611,41084,54165,13081
7130,0.0,0.0,0.0,3611,41088,54165,13077
7131,0.0,0.0,0.0,3611,41092,54165,13073
7132,0.0,0.0,0.0,3611,41096,54165,13069
7133,0.0,0.0,0.0,3611,41100,54165,13065
7134,0.0,0.0,0.0,3611,41104,54165,13061
7135,0.0,0.0,0.0,3611,41108,54165,13057
7137,0.0,0.0,0.0,3611,41112,54165,13053
7138,0.0,0.0,0.0,3611,41116,54165,13049
7139,0.0,0.0,0.0,3611,41120,54165,13045
7140,0.0,0.0,0.0,3611,41124,54165,13041
7141,0.0,0.0,0.0,3611,41128,54165,13037
7145,0.0,0.0,0.0,3611,41132,54165,13033
7146,0.0,0.0,0.0,3611,41136,54165,13029
7147,0.0,0.0,0.0,3611,41140,54165,13025
7148,0.0,0.0,0.0,3611,41144,54165,13021
7150,0.0,0.0,0.0,3611,41148,54165,13017
7151,0.0,0.0,0.0,3611,41152,54165,13013
7152,0.0,0.0,0.0,3611,41156,54165,13009
7154,0.0,0.0,0.0,3611,41160,54165,13005
7155,0.0,0.0,0.0,3611,41164,54165,13001
7156,0.0,0.0,0.0,3611,41168,54165,12997
7157,0.0,0.0,0.0,3611,41172,54165,12993
7158,0.0,0.0,0.0,3611,41176,54165,12989
7159,0.0,0.0,0.0,3611,41180,54165,12985
7160,0.0,0.0,0.0,3611,41184,54165,12981
7162,0.0,0.0,0.0,3611,41188,54165,12977
7164,0.0,0.0,0.0,3611,41192,54165,12973
7165,0.0,0.0,0.0,3611,41196,54165,12969
7166,0.0,0.0,0.0,3611,41200,54165,12965
7167,0.0,0.0,0.0,3611,41204,54165,12961
7168,0.0,0.0,0.0,3611,41208,54165,12957
7169,0.0,0.0,0.0,3611,41212,54165,12953
7170,0.0,0.0,0.0,3611,41216,54165,12949
7171,0.0,0.0,0.0,3611,41220,54165,12945
7173,0.0,0.0,0.0,3611,41224,54165,12941
7174,0.0,0.0,0.0,3611,41228,54165,12937
7175,0.0,0.0,0.0,3611,41232,54165,12933
7176,0.0,0.0,0.0,3611,41236,54165,12929
7177,0.0,0.0,0.0,3611,41240,54165,12925
7178,0.0,0.0,0.0,3611,41244,54165,12921
7179,0.0,0.0,0.0,3611,41248,54165,12917
7180,0.0,0.0,0.0,3611,41252,54165,12913
7181,0.0,0.0,0.0,3611,41256,54165,12909
7183,0.0,0.0,0.0,3611,41260,54165,12905
7184,0.0,0.0,0.0,3611,41264,54165,12901
7185,0.0,0.0,0.0,3611,41268,54165,12897
7186,0.0,0.0,0.0,3611,41272,54165,12893
7187,0.0,0.0,0.0,3611,41276,54165,12889
7190,0.0,0.0,0.0,3611,41280,54165,12885
7191,0.0,0.0,0.0,3611,41284,54165,12881
7192,0.0,0.0,0.0,3611,41288,54165,12877
7193,0.0,0.0,0.0,3611,41292,54165,12873
7195,0.0,0.0,0.0,3611,41296,54165,12869
7198,0.0,0.0,0.0,3611,41300,54165,12865
7199,0.0,0.0,0.0,3611,41304,54165,12861
7200,0.0,0.0,0.0,3611,41308,54165,12857
7201,0.0,0.0,0.0,3611,41312,54165,12853
7202,0.0,0.0,0.0,3611,41316,54165,12849
7204,0.0,0.0,0.0,3611,41320,54165,12845
7205,0.0,0.0,0.0,3611,41324,54165,12841
7206,0.0,0.0,0.0,3611,41328,54165,12837
7207,0.0,0.0,0.0,3611,41332,54165,12833
7208,0.0,0.0,0.0,3611,41336,54165,12829
7209,0.0,0.0,0.0,3611,41340,54165,12825
7210,0.0,0.0,0.0,3611,41344,54165,12821
7211,0.0,0.0,0.0,3611,41348,54165,12817
7213,0.0,0.0,0.0,3611,41352,54165,12813
7214,0.0,0.0,0.0,3611,41356,54165,12809
7215,0.0,0.0,0.0,3611,41360,54165,12805
7217,0.0,0.0,0.0,3611,41364,54165,12801
7218,0.0,0.0,0.0,3611,41368,54165,12797
7219,0.0,0.0,0.0,3611,41372,54165,12793
7220,0.0,0.0,0.0,3611,41376,54165,12789
7221,0.0,0.0,0.0,3611,41380,54165,12785
7222,0.0,0.0,0.0,3611,41384,54165,12781
7224,0.0,0.0,0.0,3611,41388,54165,12777
7226,0.0,0.0,0.0,3611,41392,54165,12773
7227,0.0,0.0,0.0,3611,41396,54165,12769
7228,0.0,0.0,0.0,3611,41400,54165,12765
7229,0.0,0.0,0.0,3611,41404,54165,12761
7232,0.0,0.0,0.0,3611,41408,54165,12757
7234,0.0,0.0,0.0,3611,41412,54165,12753
7235,0.0,0.0,0.0,3611,41416,54165,12749
7236,0.0,0.0,0.0,3611,41420,54165,12745
7237,0.0,0.0,0.0,3611,41424,54165,12741
7238,0.0,0.0,0.0,3611,41428,54165,12737
7239,0.0,0.0,0.0,3611,41432,54165,12733
7240,0.0,0.0,0.0,3611,41436,54165,12729
7241,0.0,0.0,0.0,3611,41440,54165,12725
7242,0.0,0.0,0.0,3611,41444,54165,12721
7243,0.0,0.0,0.0,3611,41448,54165,12717
7244,0.0,0.0,0.0,3611,41452,54165,12713
7246,0.0,0.0,0.0,3611,41456,54165,12709
7247,0.0,0.0,0.0,3611,41460,54165,12705
7248,0.0,0.0,0.0,3611,41464,54165,12701
7250,0.0,0.0,0.0,3611,41468,54165,12697
7251,0.0,0.0,0.0,3611,41472,54165,12693
7252,0.0,0.0,0.0,3611,41476,54165,12689
7253,0.0,0.0,0.0,3611,41480,54165,12685
7254,0.0,0.0,0.0,3611,41484,54165,12681
7255,0.0,0.0,0.0,3611,41488,54165,12677
7256,0.0,0.0,0.0,3611,41492,54165,12673
7257,0.0,0.0,0.0,3611,41496,54165,12669
7259,0.0,0.0,0.0,3611,41500,54165,12665
7260,0.0,0.0,0.0,3611,41504,54165,12661
7261,0.0,0.0,0.0,3611,41508,54165,12657
7262,0.0,0.0,0.0,3611,41512,54165,12653
7263,0.0,0.0,0.0,3611,41516,54165,12649
7264,0.0,0.0,0.0,3611,41520,54165,12645
7265,0.0,0.0,0.0,3611,41524,54165,12641
7266,0.0,0.0,0.0,3611,41528,54165,12637
7267,0.0,0.0,0.0,3611,41532,54165,12633
7268,0.0,0.0,0.0,3611,41536,54165,12629
7269,0.0,0.0,0.0,3611,41540,54165,12625
7271,0.0,0.0,0.0,3611,41544,54165,12621
7272,0.0,0.0,0.0,3611,41548,54165,12617
7273,0.0,0.0,0.0,3611,41552,54165,12613
7276,0.0,0.0,0.0,3611,41556,54165,12609
7277,0.0,0.0,0.0,3611,41560,54165,12605
7278,0.0,0.0,0.0,3611,41564,54165,12601
7279,0.0,0.0,0.0,3611,41568,54165,12597
7280,0.0,0.0,0.0,3611,41572,54165,12593
7281,0.0,0.0,0.0,3611,41576,54165,12589
7282,0.0,0.0,0.0,3611,41580,54165,12585
7284,0.0,0.0,0.0,3611,41584,54165,12581
7285,0.0,0.0,0.0,3611,41588,54165,12577
7286,0.0,0.0,0.0,3611,41592,54165,12573
7287,0.0,0.0,0.0,3611,41596,54165,12569
7288,0.0,0.0,0.0,3611,41600,54165,12565
7289,0.0,0.0,0.0,3611,41604,54165,12561
7291,0.0,0.0,0.0,3611,41608,54165,12557
7292,0.0,0.0,0.0,3611,41612,54165,12553
7293,0.0,0.0,0.0,3611,41616,54165,12549
7295,0.0,0.0,0.0,3611,41620,54165,12545
7296,0.0,0.0,0.0,3611,41624,54165,12541
7297,0.0,0.0,0.0,3611,41628,54165,12537
7301,0.0,0.0,0.0,3611,41632,54165,12533
7302,0.0,0.0,0.0,3611,41636,54165,12529
7303,0.0,0.0,0.0,3611,41640,54165,12525
7308,0.0,0.0,0.0,3611,41644,54165,12521
7309,0.0,0.0,0.0,3611,41648,54165,12517
7311,0.0,0.0,0.0,3611,41652,54165,12513
7312,0.0,0.0,0.0,3611,41656,54165,12509
7314,0.0,0.0,0.0,3611,41660,54165,12505
7315,0.0,0.0,0.0,3611,41664,54165,12501
7318,0.0,0.0,0.0,3611,41668,54165,12497
7320,0.0,0.0,0.0,3611,41672,54165,12493
7322,0.0,0.0,0.0,3611,41676,54165,12489
7323,0.0,0.0,0.0,3611,41680,54165,12485
7324,0.0,0.0,0.0,3611,41684,54165,12481
7325,0.0,0.0,0.0,3611,41688,54165,12477
7326,0.0,0.0,0.0,3611,41692,54165,12473
7327,0.0,0.0,0.0,3611,41696,54165,12469
7328,0.0,0.0,0.0,3611,41700,54165,12465
7329,0.0,0.0,0.0,3611,41704,54165,12461
7330,0.0,0.0,0.0,3611,41708,54165,12457
7331,0.0,0.0,0.0,3611,41712,54165,12453
7332,0.0,0.0,0.0,3611,41716,54165,12449
7333,0.0,0.0,0.0,3611,41720,54165,12445
7334,0.0,0.0,0.0,3611,41724,54165,12441
7335,0.0,0.0,0.0,3611,41728,54165,12437
7336,0.0,0.0,0.0,3611,41732,54165,12433
7337,0.0,0.0,0.0,3611,41736,54165,12429
7338,0.0,0.0,0.0,3611,41740,54165,12425
7339,0.0,0.0,0.0,3611,41744,54165,12421
7340,0.0,0.0,0.0,3611,41748,54165,12417
7341,0.0,0.0,0.0,3611,41752,54165,12413
7342,0.0,0.0,0.0,3611,41756,54165,12409
7343,0.0,0.0,0.0,3611,41760,54165,12405
7344,0.0,0.0,0.0,3611,41764,54165,12401
7345,0.0,0.0,0.0,3611,41768,54165,12397
7346,0.0,0.0,0.0,3611,41772,54165,12393
7349,0.0,0.0,0.0,3611,41776,54165,12389
7350,0.0,0.0,0.0,3611,41780,54165,12385
7351,0.0,0.0,0.0,3611,41784,54165,12381
7352,0.0,0.0,0.0,3611,41788,54165,12377
7353,0.0,0.0,0.0,3611,41792,54165,12373
7357,0.0,0.0,0.0,3611,41796,54165,12369
7359,0.0,0.0,0.0,3611,41800,54165,12365
7360,0.0,0.0,0.0,3611,41804,54165,12361
7361,0.0,0.0,0.0,3611,41808,54165,12357
7362,0.0,0.0,0.0,3611,41812,54165,12353
7363,0.0,0.0,0.0,3611,41816,54165,12349
7365,0.0,0.0,0.0,3611,41820,54165,12345
7367,0.0,0.0,0.0,3611,41824,54165,12341
7369,0.0,0.0,0.0,3611,41828,54165,12337
7370,0.0,0.0,0.0,3611,41832,54165,12333
7371,0.0,0.0,0.0,3611,41836,54165,12329
7372,0.0,0.0,0.0,3611,41840,54165,12325
7373,0.0,0.0,0.0,3611,41844,54165,12321
7375,0.0,0.0,0.0,3611,41848,54165,12317
7376,0.0,0.0,0.0,3611,41852,54165,12313
7377,0.0,0.0,0.0,3611,41856,54165,12309
7378,0.0,0.0,0.0,3611,41860,54165,12305
7379,0.0,0.0,0.0,3611,41864,54165,12301
7380,0.0,0.0,0.0,3611,41868,54165,12297
7381,0.0,0.0,0.0,3611,41872,54165,12293
7382,0.0,0.0,0.0,3611,41876,54165,12289
7383,0.0,0.0,0.0,3611,41880,54165,12285
7389,0.0,0.0,0.0,3611,41884,54165,12281
7391,0.0,0.0,0.0,3611,41888,54165,12277
7392,0.0,0.0,0.0,3611,41892,54165,12273
7393,0.0,0.0,0.0,3611,41896,54165,12269
7395,0.0,0.0,0.0,3611,41900,54165,12265
7396,0.0,0.0,0.0,3611,41904,54165,12261
7397,0.0,0.0,0.0,3611,41908,54165,12257
7400,0.0,0.0,0.0,3611,41912,54165,12253
7401,0.0,0.0,0.0,3611,41916,54165,12249
7402,0.0,0.0,0.0,3611,41920,54165,12245
7403,0.0,0.0,0.0,3611,41924,54165,12241
7404,0.0,0.0,0.0,3611,41928,54165,12237
7405,0.0,0.0,0.0,3611,41932,54165,12233
7407,0.0,0.0,0.0,3611,41936,54165,12229
7408,0.0,0.0,0.0,3611,41940,54165,12225
7409,0.0,0.0,0.0,3611,41944,54165,12221
7410,0.0,0.0,0.0,3611,41948,54165,12217
7412,0.0,0.0,0.0,3611,41952,54165,12213
7414,0.0,0.0,0.0,3611,41956,54165,12209
7415,0.0,0.0,0.0,3611,41960,54165,12205
7417,0.0,0.0,0.0,3611,41964,54165,12201
7418,0.0,0.0,0.0,3611,41968,54165,12197
7420,0.0,0.0,0.0,3611,41972,54165,12193
7421,0.0,0.0,0.0,3611,41976,54165,12189
7422,0.0,0.0,0.0,3611,41980,54165,12185
7423,0.0,0.0,0.0,3611,41984,54165,12181
7424,0.0,0.0,0.0,3611,41988,54165,12177
7426,0.0,0.0,0.0,3611,41992,54165,12173
7428,0.0,0.0,0.0,3611,41996,54165,12169
7429,0.0,0.0,0.0,3611,42000,54165,12165
7430,0.0,0.0,0.0,3611,42004,54165,12161
7434,0.0,0.0,0.0,3611,42008,54165,12157
7436,0.0,0.0,0.0,3611,42012,54165,12153
7437,0.0,0.0,0.0,3611,42016,54165,12149
7438,0.0,0.0,0.0,3611,42020,54165,12145
7439,0.0,0.0,0.0,3611,42024,54165,12141
7441,0.0,0.0,0.0,3611,42028,54165,12137
7442,0.0,0.0,0.0,3611,42032,54165,12133
7443,0.0,0.0,0.0,3611,42036,54165,12129
7444,0.0,0.0,0.0,3611,42040,54165,12125
7445,0.0,0.0,0.0,3611,42044,54165,12121
7447,0.0,0.0,0.0,3611,42048,54165,12117
7448,0.0,0.0,0.0,3611,42052,54165,12113
7449,0.0,0.0,0.0,3611,42056,54165,12109
7450,0.0,0.0,0.0,3611,42060,54165,12105
7452,0.0,0.0,0.0,3611,42064,54165,12101
7453,0.0,0.0,0.0,3611,42068,54165,12097
7454,0.0,0.0,0.0,3611,42072,54165,12093
7455,0.0,0.0,0.0,3611,42076,54165,12089
7456,0.0,0.0,0.0,3611,42080,54165,12085
7457,0.0,0.0,0.0,3611,42084,54165,12081
7459,0.0,0.0,0.0,3611,42088,54165,12077
7462,0.0,0.0,0.0,3611,42092,54165,12073
7463,0.0,0.0,0.0,3611,42096,54165,12069
7464,0.0,0.0,0.0,3611,42100,54165,12065
7465,0.0,0.0,0.0,3611,42104,54165,12061
7466,0.0,0.0,0.0,3611,42108,54165,12057
7467,0.0,0.0,0.0,3611,42112,54165,12053
7468,0.0,0.0,0.0,3611,42116,54165,12049
7469,0.0,0.0,0.0,3611,42120,54165,12045
7470,0.0,0.0,0.0,3611,42124,54165,12041
7471,0.0,0.0,0.0,3611,42128,54165,12037
7473,0.0,0.0,0.0,3611,42132,54165,12033
7474,0.0,0.0,0.0,3611,42136,54165,12029
7476,0.0,0.0,0.0,3611,42140,54165,12025
7477,0.0,0.0,0.0,3611,42144,54165,12021
7478,0.0,0.0,0.0,3611,42148,54165,12017
7480,0.0,0.0,0.0,3611,42152,54165,12013
7481,0.0,0.0,0.0,3611,42156,54165,12009
7482,0.0,0.0,0.0,3611,42160,54165,12005
7483,0.0,0.0,0.0,3611,42164,54165,12001
7486,0.0,0.0,0.0,3611,42168,54165,11997
7488,0.0,0.0,0.0,3611,42172,54165,11993
7489,0.0,0.0,0.0,3611,42176,54165,11989
7491,0.0,0.0,0.0,3611,42180,54165,11985
7492,0.0,0.0,0.0,3611,42184,54165,11981
7496,0.0,0.0,0.0,3611,42188,54165,11977
7497,0.0,0.0,0.0,3611,42192,54165,11973
7498,0.0,0.0,0.0,3611,42196,54165,11969
7499,0.0,0.0,0.0,3611,42200,54165,11965
7500,0.0,0.0,0.0,3611,42204,54165,11961
7501,0.0,0.0,0.0,3611,42208,54165,11957
7503,0.0,0.0,0.0,3611,42212,54165,11953
7504,0.0,0.0,0.0,3611,42216,54165,11949
7505,0.0,0.0,0.0,3611,42220,54165,11945
7506,0.0,0.0,0.0,3611,42224,54165,11941
7507,0.0,0.0,0.0,3611,42228,54165,11937
7508,0.0,0.0,0.0,3611,42232,54165,11933
7509,0.0,0.0,0.0,3611,42236,54165,11929
7512,0.0,0.0,0.0,3611,42240,54165,11925
7513,0.0,0.0,0.0,3611,42244,54165,11921
7515,0.0,0.0,0.0,3611,42248,54165,11917
7516,0.0,0.0,0.0,3611,42252,54165,11913
7517,0.0,0.0,0.0,3611,42256,54165,11909
7518,0.0,0.0,0.0,3611,42260,54165,11905
7520,0.0,0.0,0.0,3611,42264,54165,11901
7521,0.0,0.0,0.0,3611,42268,54165,11897
7522,0.0,0.0,0.0,3611,42272,54165,11893
7526,0.0,0.0,0.0,3611,42276,54165,11889
7527,0.0,0.0,0.0,3611,42280,54165,11885
7528,0.0,0.0,0.0,3611,42284,54165,11881
7529,0.0,0.0,0.0,3611,42288,54165,11877
7530,0.0,0.0,0.0,3611,42292,54165,11873
7532,0.0,0.0,0.0,3611,42296,54165,11869
7534,0.0,0.0,0.0,3611,42300,54165,11865
7535,0.0,0.0,0.0,3611,42304,54165,11861
7536,0.0,0.0,0.0,3611,42308,54165,11857
7538,0.0,0.0,0.0,3611,42312,54165,11853
7540,0.0,0.0,0.0,3611,42316,54165,11849
7541,0.0,0.0,0.0,3611,42320,54165,11845
7543,0.0,0.0,0.0,3611,42324,54165,11841
7545,0.0,0.0,0.0,3611,42328,54165,11837
7548,0.0,0.0,0.0,3611,42332,54165,11833
7549,0.0,0.0,0.0,3611,42336,54165,11829
7552,0.0,0.0,0.0,3611,42340,54165,11825
7554,0.0,0.0,0.0,3611,42344,54165,11821
7555,0.0,0.0,0.0,3611,42348,54165,11817
7556,0.0,0.0,0.0,3611,42352,54165,11813
7557,0.0,0.0,0.0,3611,42356,54165,11809
7558,0.0,0.0,0.0,3611,42360,54165,11805
7559,0.0,0.0,0.0,3611,42364,54165,11801
7560,0.0,0.0,0.0,3611,42368,54165,11797
7561,0.0,0.0,0.0,3611,42372,54165,11793
7562,0.0,0.0,0.0,3611,42376,54165,11789
7563,0.0,0.0,0.0,3611,42380,54165,11785
7564,0.0,0.0,0.0,3611,42384,54165,11781
7565,0.0,0.0,0.0,3611,42388,54165,11777
7566,0.0,0.0,0.0,3611,42392,54165,11773
7567,0.0,0.0,0.0,3611,42396,54165,11769
7568,0.0,0.0,0.0,3611,42400,54165,11765
7569,0.0,0.0,0.0,3611,42404,54165,11761
7570,0.0,0.0,0.0,3611,42408,54165,11757
7571,0.0,0.0,0.0,3611,42412,54165,11753
7572,0.0,0.0,0.0,3611,42416,54165,11749
7574,0.0,0.0,0.0,3611,42420,54165,11745
7575,0.0,0.0,0.0,3611,42424,54165,11741
7576,0.0,0.0,0.0,3611,42428,54165,11737
7577,0.0,0.0,0.0,3611,42432,54165,11733
7578,0.0,0.0,0.0,3611,42436,54165,11729
7579,0.0,0.0,0.0,3611,42440,54165,11725
7580,0.0,0.0,0.0,3611,42444,54165,11721
7582,0.0,0.0,0.0,3611,42448,54165,11717
7584,0.0,0.0,0.0,3611,42452,54165,11713
7585,0.0,0.0,0.0,3611,42456,54165,11709
7586,0.0,0.0,0.0,3611,42460,54165,11705
7587,0.0,0.0,0.0,3611,42464,54165,11701
7588,0.0,0.0,0.0,3611,42468,54165,11697
7589,0.0,0.0,0.0,3611,42472,54165,11693
7590,0.0,0.0,0.0,3611,42476,54165,11689
7592,0.0,0.0,0.0,3611,42480,54165,11685
7593,0.0,0.0,0.0,3611,42484,54165,11681
7594,0.0,0.0,0.0,3611,42488,54165,11677
7597,0.0,0.0,0.0,3611,42492,54165,11673
7599,0.0,0.0,0.0,3611,42496,54165,11669
7600,0.0,0.0,0.0,3611,42500,54165,11665
7601,0.0,0.0,0.0,3611,42504,54165,11661
7604,0.0,0.0,0.0,3611,42508,54165,11657
7605,0.0,0.0,0.0,3611,42512,54165,11653
7606,0.0,0.0,0.0,3611,42516,54165,11649
7607,0.0,0.0,0.0,3611,42520,54165,11645
7608,0.0,0.0,0.0,3611,42524,54165,11641
7609,0.0,0.0,0.0,3611,42528,54165,11637
7610,0.0,0.0,0.0,3611,42532,54165,11633
7611,0.0,0.0,0.0,3611,42536,54165,11629
7612,0.0,0.0,0.0,3611,42540,54165,11625
7613,0.0,0.0,0.0,3611,42544,54165,11621
7614,0.0,0.0,0.0,3611,42548,54165,11617
7615,0.0,0.0,0.0,3611,42552,54165,11613
7616,0.0,0.0,0.0,3611,42556,54165,11609
7617,0.0,0.0,0.0,3611,42560,54165,11605
7618,0.0,0.0,0.0,3611,42564,54165,11601
7619,0.0,0.0,0.0,3611,42568,54165,11597
7620,0.0,0.0,0.0,3611,42572,54165,11593
7621,0.0,0.0,0.0,3611,42576,54165,11589
7622,0.0,0.0,0.0,3611,42580,54165,11585
7624,0.0,0.0,0.0,3611,42584,54165,11581
7625,0.0,0.0,0.0,3611,42588,54165,11577
7626,0.0,0.0,0.0,3611,42592,54165,11573
7627,0.0,0.0,0.0,3611,42596,54165,11569
7630,0.0,0.0,0.0,3611,42600,54165,11565
7631,0.0,0.0,0.0,3611,42604,54165,11561
7633,0.0,0.0,0.0,3611,42608,54165,11557
7634,0.0,0.0,0.0,3611,42612,54165,11553
7635,0.0,0.0,0.0,3611,42616,54165,11549
7636,0.0,0.0,0.0,3611,42620,54165,11545
7637,0.0,0.0,0.0,3611,42624,54165,11541
7639,0.0,0.0,0.0,3611,42628,54165,11537
7640,0.0,0.0,0.0,3611,42632,54165,11533
7643,0.0,0.0,0.0,3611,42636,54165,11529
7644,0.0,0.0,0.0,3611,42640,54165,11525
7645,0.0,0.0,0.0,3611,42644,54165,11521
7646,0.0,0.0,0.0,3611,42648,54165,11517
7648,0.0,0.0,0.0,3611,42652,54165,11513
7650,0.0,0.0,0.0,3611,42656,54165,11509
7651,0.0,0.0,0.0,3611,42660,54165,11505
7653,0.0,0.0,0.0,3611,42664,54165,11501
7655,0.0,0.0,0.0,3611,42668,54165,11497
7656,0.0,0.0,0.0,3611,42672,54165,11493
7657,0.0,0.0,0.0,3611,42676,54165,11489
7658,0.0,0.0,0.0,3611,42680,54165,11485
7659,0.0,0.0,0.0,3611,42684,54165,11481
7660,0.0,0.0,0.0,3611,42688,54165,11477
7661,0.0,0.0,0.0,3611,42692,54165,11473
7662,0.0,0.0,0.0,3611,42696,54165,11469
7664,0.0,0.0,0.0,3611,42700,54165,11465
7665,0.0,0.0,0.0,3611,42704,54165,11461
7667,0.0,0.0,0.0,3611,42708,54165,11457
7668,0.0,0.0,0.0,3611,42712,54165,11453
7669,0.0,0.0,0.0,3611,42716,54165,11449
7670,0.0,0.0,0.0,3611,42720,54165,11445
7672,0.0,0.0,0.0,3611,42724,54165,11441
7674,0.0,0.0,0.0,3611,42728,54165,11437
7675,0.0,0.0,0.0,3611,42732,54165,11433
7676,0.0,0.0,0.0,3611,42736,54165,11429
7677,0.0,0.0,0.0,3611,42740,54165,11425
7678,0.0,0.0,0.0,3611,42744,54165,11421
7679,0.0,0.0,0.0,3611,42748,54165,11417
7680,0.0,0.0,0.0,3611,42752,54165,11413
7682,0.0,0.0,0.0,3611,42756,54165,11409
7683,0.0,0.0,0.0,3611,42760,54165,11405
7684,0.0,0.0,0.0,3611,42764,54165,11401
7685,0.0,0.0,0.0,3611,42768,54165,11397
7688,0.0,0.0,0.0,3611,42772,54165,11393
7689,0.0,0.0,0.0,3611,42776,54165,11389
7690,0.0,0.0,0.0,3611,42780,54165,11385
7691,0.0,0.0,0.0,3611,42784,54165,11381
7693,0.0,0.0,0.0,3611,42788,54165,11377
7695,0.0,0.0,0.0,3611,42792,54165,11373
7696,0.0,0.0,0.0,3611,42796,54165,11369
7699,0.0,0.0,0.0,3611,42800,54165,11365
7700,0.0,0.0,0.0,3611,42804,54165,11361
7701,0.0,0.0,0.0,3611,42808,54165,11357
7702,0.0,0.0,0.0,3611,42812,54165,11353
7703,0.0,0.0,0.0,3611,42816,54165,11349
7704,0.0,0.0,0.0,3611,42820,54165,11345
7705,0.0,0.0,0.0,3611,42824,54165,11341
7706,0.0,0.0,0.0,3611,42828,54165,11337
7707,0.0,0.0,0.0,3611,42832,54165,11333
7708,0.0,0.0,0.0,3611,42836,54165,11329
7710,0.0,0.0,0.0,3611,42840,54165,11325
7711,0.0,0.0,0.0,3611,42844,54165,11321
7712,0.0,0.0,0.0,3611,42848,54165,11317
7713,0.0,0.0,0.0,3611,42852,54165,11313
7714,0.0,0.0,0.0,3611,42856,54165,11309
7715,0.0,0.0,0.0,3611,42860,54165,11305
7716,0.0,0.0,0.0,3611,42864,54165,11301
7718,0.0,0.0,0.0,3611,42868,54165,11297
7719,0.0,0.0,0.0,3611,42872,54165,11293
7720,0.0,0.0,0.0,3611,42876,54165,11289
7721,0.0,0.0,0.0,3611,42880,54165,11285
7722,0.0,0.0,0.0,3611,42884,54165,11281
7723,0.0,0.0,0.0,3611,42888,54165,11277
7724,0.0,0.0,0.0,3611,42892,54165,11273
7725,0.0,0.0,0.0,3611,42896,54165,11269
7727,0.0,0.0,0.0,3611,42900,54165,11265
7728,0.0,0.0,0.0,3611,42904,54165,11261
7729,0.0,0.0,0.0,3611,42908,54165,11257
7730,0.0,0.0,0.0,3611,42912,54165,11253
7731,0.0,0.0,0.0,3611,42916,54165,11249
7734,0.0,0.0,0.0,3611,42920,54165,11245
7735,0.0,0.0,0.0,3611,42924,54165,11241
7736,0.0,0.0,0.0,3611,42928,54165,11237
7737,0.0,0.0,0.0,3611,42932,54165,11233
7738,0.0,0.0,0.0,3611,42936,54165,11229
7739,0.0,0.0,0.0,3611,42940,54165,11225
7741,0.0,0.0,0.0,3611,42944,54165,11221
7743,0.0,0.0,0.0,3611,42948,54165,11217
7744,0.0,0.0,0.0,3611,42952,54165,11213
7745,0.0,0.0,0.0,3611,42956,54165,11209
7746,0.0,0.0,0.0,3611,42960,54165,11205
7747,0.0,0.0,0.0,3611,42964,54165,11201
7751,0.0,0.0,0.0,3611,42968,54165,11197
7752,0.0,0.0,0.0,3611,42972,54165,11193
7754,0.0,0.0,0.0,3611,42976,54165,11189
7755,0.0,0.0,0.0,3611,42980,54165,11185
7756,0.0,0.0,0.0,3611,42984,54165,11181
7758,0.0,0.0,0.0,3611,42988,54165,11177
7759,0.0,0.0,0.0,3611,42992,54165,11173
7760,0.0,0.0,0.0,3611,42996,54165,11169
7761,0.0,0.0,0.0,3611,43000,54165,11165
7762,0.0,0.0,0.0,3611,43004,54165,11161
7763,0.0,0.0,0.0,3611,43008,54165,11157
7764,0.0,0.0,0.0,3611,43012,54165,11153
7765,0.0,0.0,0.0,3611,43016,54165,11149
7766,0.0,0.0,0.0,3611,43020,54165,11145
7767,0.0,0.0,0.0,3611,43024,54165,11141
7768,0.0,0.0,0.0,3611,43028,54165,11137
7769,0.0,0.0,0.0,3611,43032,54165,11133
7770,0.0,0.0,0.0,3611,43036,54165,11129
7772,0.0,0.0,0.0,3611,43040,54165,11125
7773,0.0,0.0,0.0,3611,43044,54165,11121
7774,0.0,0.0,0.0,3611,43048,54165,11117
7775,0.0,0.0,0.0,3611,43052,54165,11113
7776,0.0,0.0,0.0,3611,43056,54165,11109
7777,0.0,0.0,0.0,3611,43060,54165,11105
7778,0.0,0.0,0.0,3611,43064,54165,11101
7779,0.0,0.0,0.0,3611,43068,54165,11097
7781,0.0,0.0,0.0,3611,43072,54165,11093
7782,0.0,0.0,0.0,3611,43076,54165,11089
7783,0.0,0.0,0.0,3611,43080,54165,11085
7784,0.0,0.0,0.0,3611,43084,54165,11081
7785,0.0,0.0,0.0,3611,43088,54165,11077
7786,0.0,0.0,0.0,3611,43092,54165,11073
7787,0.0,0.0,0.0,3611,43096,54165,11069
7788,0.0,0.0,0.0,3611,43100,54165,11065
7789,0.0,0.0,0.0,3611,43104,54165,11061
7790,0.0,0.0,0.0,3611,43108,54165,11057
7791,0.0,0.0,0.0,3611,43112,54165,11053
7792,0.0,0.0,0.0,3611,43116,54165,11049
7793,0.0,0.0,0.0,3611,43120,54165,11045
7794,0.0,0.0,0.0,3611,43124,54165,11041
7795,0.0,0.0,0.0,3611,43128,54165,11037
7797,0.0,0.0,0.0,3611,43132,54165,11033
7798,0.0,0.0,0.0,3611,43136,54165,11029
7799,0.0,0.0,0.0,3611,43140,54165,11025
7800,0.0,0.0,0.0,3611,43144,54165,11021
7801,0.0,0.0,0.0,3611,43148,54165,11017
7804,0.0,0.0,0.0,3611,43152,54165,11013
7806,0.0,0.0,0.0,3611,43156,54165,11009
7807,0.0,0.0,0.0,3611,43160,54165,11005
7808,0.0,0.0,0.0,3611,43164,54165,11001
7810,0.0,0.0,0.0,3611,43168,54165,10997
7812,0.0,0.0,0.0,3611,43172,54165,10993
7813,0.0,0.0,0.0,3611,43176,54165,10989
7814,0.0,0.0,0.0,3611,43180,54165,10985
7815,0.0,0.0,0.0,3611,43184,54165,10981
7818,0.0,0.0,0.0,3611,43188,54165,10977
7819,0.0,0.0,0.0,3611,43192,54165,10973
7820,0.0,0.0,0.0,3611,43196,54165,10969
7822,0.0,0.0,0.0,3611,43200,54165,10965
7823,0.0,0.0,0.0,3611,43204,54165,10961
7824,0.0,0.0,0.0,3611,43208,54165,10957
7825,0.0,0.0,0.0,3611,43212,54165,10953
7826,0.0,0.0,0.0,3611,43216,54165,10949
7827,0.0,0.0,0.0,3611,43220,54165,10945
7832,0.0,0.0,0.0,3611,43224,54165,10941
7833,0.0,0.0,0.0,3611,43228,54165,10937
7834,0.0,0.0,0.0,3611,43232,54165,10933
7836,0.0,0.0,0.0,3611,43236,54165,10929
7837,0.0,0.0,0.0,3611,43240,54165,10925
7840,0.0,0.0,0.0,3611,43244,54165,10921
7841,0.0,0.0,0.0,3611,43248,54165,10917
7842,0.0,0.0,0.0,3611,43252,54165,10913
7845,0.0,0.0,0.0,3611,43256,54165,10909
7847,0.0,0.0,0.0,3611,43260,54165,10905
7848,0.0,0.0,0.0,3611,43264,54165,10901
7849,0.0,0.0,0.0,3611,43268,54165,10897
7850,0.0,0.0,0.0,3611,43272,54165,10893
7851,0.0,0.0,0.0,3611,43276,54165,10889
7852,0.0,0.0,0.0,3611,43280,54165,10885
7854,0.0,0.0,0.0,3611,43284,54165,10881
7856,0.0,0.0,0.0,3611,43288,54165,10877
7857,0.0,0.0,0.0,3611,43292,54165,10873
7858,0.0,0.0,0.0,3611,43296,54165,10869
7860,0.0,0.0,0.0,3611,43300,54165,10865
7861,0.0,0.0,0.0,3611,43304,54165,10861
7862,0.0,0.0,0.0,3611,43308,54165,10857
7864,0.0,0.0,0.0,3611,43312,54165,10853
7866,0.0,0.0,0.0,3611,43316,54165,10849
7867,0.0,0.0,0.0,3611,43320,54165,10845
7868,0.0,0.0,0.0,3611,43324,54165,10841
7869,0.0,0.0,0.0,3611,43328,54165,10837
7872,0.0,0.0,0.0,3611,43332,54165,10833
7873,0.0,0.0,0.0,3611,43336,54165,10829
7874,0.0,0.0,0.0,3611,43340,54165,10825
7875,0.0,0.0,0.0,3611,43344,54165,10821
7876,0.0,0.0,0.0,3611,43348,54165,10817
7877,0.0,0.0,0.0,3611,43352,54165,10813
7878,0.0,0.0,0.0,3611,43356,54165,10809
7879,0.0,0.0,0.0,3611,43360,54165,10805
7880,0.0,0.0,0.0,3611,43364,54165,10801
7881,0.0,0.0,0.0,3611,43368,54165,10797
7883,0.0,0.0,0.0,3611,43372,54165,10793
7884,0.0,0.0,0.0,3611,43376,54165,10789
7886,0.0,0.0,0.0,3611,43380,54165,10785
7887,0.0,0.0,0.0,3611,43384,54165,10781
7888,0.0,0.0,0.0,3611,43388,54165,10777
7889,0.0,0.0,0.0,3611,43392,54165,10773
7890,0.0,0.0,0.0,3611,43396,54165,10769
7892,0.0,0.0,0.0,3611,43400,54165,10765
7893,0.0,0.0,0.0,3611,43404,54165,10761
7894,0.0,0.0,0.0,3611,43408,54165,10757
7895,0.0,0.0,0.0,3611,43412,54165,10753
7897,0.0,0.0,0.0,3611,43416,54165,10749
7898,0.0,0.0,0.0,3611,43420,54165,10745
7901,0.0,0.0,0.0,3611,43424,54165,10741
7902,0.0,0.0,0.0,3611,43428,54165,10737
7903,0.0,0.0,0.0,3611,43432,54165,10733
7904,0.0,0.0,0.0,3611,43436,54165,10729
7905,0.0,0.0,0.0,3611,43440,54165,10725
7906,0.0,0.0,0.0,3611,43444,54165,10721
7909,0.0,0.0,0.0,3611,43448,54165,10717
7910,0.0,0.0,0.0,3611,43452,54165,10713
7911,0.0,0.0,0.0,3611,43456,54165,10709
7912,0.0,0.0,0.0,3611,43460,54165,10705
7913,0.0,0.0,0.0,3611,43464,54165,10701
7914,0.0,0.0,0.0,3611,43468,54165,10697
7916,0.0,0.0,0.0,3611,43472,54165,10693
7917,0.0,0.0,0.0,3611,43476,54165,10689
7918,0.0,0.0,0.0,3611,43480,54165,10685
7919,0.0,0.0,0.0,3611,43484,54165,10681
7920,0.0,0.0,0.0,3611,43488,54165,10677
7921,0.0,0.0,0.0,3611,43492,54165,10673
7922,0.0,0.0,0.0,3611,43496,54165,10669
7923,0.0,0.0,0.0,3611,43500,54165,10665
7924,0.0,0.0,0.0,3611,43504,54165,10661
7925,0.0,0.0,0.0,3611,43508,54165,10657
7926,0.0,0.0,0.0,3611,43512,54165,10653
7928,0.0,0.0,0.0,3611,43516,54165,10649
7930,0.0,0.0,0.0,3611,43520,54165,10645
7931,0.0,0.0,0.0,3611,43524,54165,10641
7933,0.0,0.0,0.0,3611,43528,54165,10637
7935,0.0,0.0,0.0,3611,43532,54165,10633
7936,0.0,0.0,0.0,3611,43536,54165,10629
7938,0.0,0.0,0.0,3611,43540,54165,10625
7939,0.0,0.0,0.0,3611,43544,54165,10621
7940,0.0,0.0,0.0,3611,43548,54165,10617
7941,0.0,0.0,0.0,3611,43552,54165,10613
7942,0.0,0.0,0.0,3611,43556,54165,10609
7943,0.0,0.0,0.0,3611,43560,54165,10605
7944,0.0,0.0,0.0,3611,43564,54165,10601
7945,0.0,0.0,0.0,3611,43568,54165,10597
7947,0.0,0.0,0.0,3611,43572,54165,10593
7948,0.0,0.0,0.0,3611,43576,54165,10589
7949,0.0,0.0,0.0,3611,43580,54165,10585
7950,0.0,0.0,0.0,3611,43584,54165,10581
7951,0.0,0.0,0.0,3611,43588,54165,10577
7953,0.0,0.0,0.0,3611,43592,54165,10573
7954,0.0,0.0,0.0,3611,43596,54165,10569
7955,0.0,0.0,0.0,3611,43600,54165,10565
7956,0.0,0.0,0.0,3611,43604,54165,10561
7957,0.0,0.0,0.0,3611,43608,54165,10557
7958,0.0,0.0,0.0,3611,43612,54165,10553
7959,0.0,0.0,0.0,3611,43616,54165,10549
7960,0.0,0.0,0.0,3611,43620,54165,10545
7961,0.0,0.0,0.0,3611,43624,54165,10541
7962,0.0,0.0,0.0,3611,43628,54165,10537
7963,0.0,0.0,0.0,3611,43632,54165,10533
7964,0.0,0.0,0.0,3611,43636,54165,10529
7965,0.0,0.0,0.0,3611,43640,54165,10525
7967,0.0,0.0,0.0,3611,43644,54165,10521
7968,0.0,0.0,0.0,3611,43648,54165,10517
7969,0.0,0.0,0.0,3611,43652,54165,10513
7970,0.0,0.0,0.0,3611,43656,54165,10509
7971,0.0,0.0,0.0,3611,43660,54165,10505
7972,0.0,0.0,0.0,3611,43664,54165,10501
7973,0.0,0.0,0.0,3611,43668,54165,10497
7974,0.0,0.0,0.0,3611,43672,54165,10493
7976,0.0,0.0,0.0,3611,43676,54165,10489
7977,0.0,0.0,0.0,3611,43680,54165,10485
7978,0.0,0.0,0.0,3611,43684,54165,10481
7979,0.0,0.0,0.0,3611,43688,54165,10477
7980,0.0,0.0,0.0,3611,43692,54165,10473
7981,0.0,0.0,0.0,3611,43696,54165,10469
7983,0.0,0.0,0.0,3611,43700,54165,10465
7984,0.0,0.0,0.0,3611,43704,54165,10461
7985,0.0,0.0,0.0,3611,43708,54165,10457
7986,0.0,0.0,0.0,3611,43712,54165,10453
7987,0.0,0.0,0.0,3611,43716,54165,10449
7988,0.0,0.0,0.0,3611,43720,54165,10445
7990,0.0,0.0,0.0,3611,43724,54165,10441
7992,0.0,0.0,0.0,3611,43728,54165,10437
7994,0.0,0.0,0.0,3611,43732,54165,10433
7995,0.0,0.0,0.0,3611,43736,54165,10429
7996,0.0,0.0,0.0,3611,43740,54165,10425
7997,0.0,0.0,0.0,3611,43744,54165,10421
7998,0.0,0.0,0.0,3611,43748,54165,10417
7999,0.0,0.0,0.0,3611,43752,54165,10413
8000,0.0,0.0,0.0,3611,43756,54165,10409
8001,0.0,0.0,0.0,3611,43760,54165,10405
8003,0.0,0.0,0.0,3611,43764,54165,10401
8004,0.0,0.0,0.0,3611,43768,54165,10397
8005,0.0,0.0,0.0,3611,43772,54165,10393
8006,0.0,0.0,0.0,3611,43776,54165,10389
8007,0.0,0.0,0.0,3611,43780,54165,10385
8008,0.0,0.0,0.0,3611,43784,54165,10381
8009,0.0,0.0,0.0,3611,43788,54165,10377
8011,0.0,0.0,0.0,3611,43792,54165,10373
8012,0.0,0.0,0.0,3611,43796,54165,10369
8013,0.0,0.0,0.0,3611,43800,54165,10365
8015,0.0,0.0,0.0,3611,43804,54165,10361
8016,0.0,0.0,0.0,3611,43808,54165,10357
8017,0.0,0.0,0.0,3611,43812,54165,10353
8018,0.0,0.0,0.0,3611,43816,54165,10349
8020,0.0,0.0,0.0,3611,43820,54165,10345
8021,0.0,0.0,0.0,3611,43824,54165,10341
8022,0.0,0.0,0.0,3611,43828,54165,10337
8024,0.0,0.0,0.0,3611,43832,54165,10333
8025,0.0,0.0,0.0,3611,43836,54165,10329
8026,0.0,0.0,0.0,3611,43840,54165,10325
8027,0.0,0.0,0.0,3611,43844,54165,10321
8028,0.0,0.0,0.0,3611,43848,54165,10317
8029,0.0,0.0,0.0,3611,43852,54165,10313
8030,0.0,0.0,0.0,3611,43856,54165,10309
8031,0.0,0.0,0.0,3611,43860,54165,10305
8032,0.0,0.0,0.0,3611,43864,54165,10301
8033,0.0,0.0,0.0,3611,43868,54165,10297
8034,0.0,0.0,0.0,3611,43872,54165,10293
8035,0.0,0.0,0.0,3611,43876,54165,10289
8036,0.0,0.0,0.0,3611,43880,54165,10285
8037,0.0,0.0,0.0,3611,43884,54165,10281
8039,0.0,0.0,0.0,3611,43888,54165,10277
8040,0.0,0.0,0.0,3611,43892,54165,10273
8041,0.0,0.0,0.0,3611,43896,54165,10269
8042,0.0,0.0,0.0,3611,43900,54165,10265
8043,0.0,0.0,0.0,3611,43904,54165,10261
8046,0.0,0.0,0.0,3611,43908,54165,10257
8047,0.0,0.0,0.0,3611,43912,54165,10253
8048,0.0,0.0,0.0,3611,43916,54165,10249
8052,0.0,0.0,0.0,3611,43920,54165,10245
8053,0.0,0.0,0.0,3611,43924,54165,10241
8056,0.0,0.0,0.0,3611,43928,54165,10237
8058,0.0,0.0,0.0,3611,43932,54165,10233
8059,0.0,0.0,0.0,3611,43936,54165,10229
8061,0.0,0.0,0.0,3611,43940,54165,10225
8064,0.0,0.0,0.0,3611,43944,54165,10221
8065,0.0,0.0,0.0,3611,43948,54165,10217
8066,0.0,0.0,0.0,3611,43952,54165,10213
8067,0.0,0.0,0.0,3611,43956,54165,10209
8069,0.0,0.0,0.0,3611,43960,54165,10205
8070,0.0,0.0,0.0,3611,43964,54165,10201
8071,0.0,0.0,0.0,3611,43968,54165,10197
8072,0.0,0.0,0.0,3611,43972,54165,10193
8074,0.0,0.0,0.0,3611,43976,54165,10189
8075,0.0,0.0,0.0,3611,43980,54165,10185
8077,0.0,0.0,0.0,3611,43984,54165,10181
8078,0.0,0.0,0.0,3611,43988,54165,10177
8079,0.0,0.0,0.0,3611,43992,54165,10173
8080,0.0,0.0,0.0,3611,43996,54165,10169
8081,0.0,0.0,0.0,3611,44000,54165,10165
8082,0.0,0.0,0.0,3611,44004,54165,10161
8084,0.0,0.0,0.0,3611,44008,54165,10157
8086,0.0,0.0,0.0,3611,44012,54165,10153
8087,0.0,0.0,0.0,3611,44016,54165,10149
8088,0.0,0.0,0.0,3611,44020,54165,10145
8090,0.0,0.0,0.0,3611,44024,54165,10141
8091,0.0,0.0,0.0,3611,44028,54165,10137
8092,0.0,0.0,0.0,3611,44032,54165,10133
8093,0.0,0.0,0.0,3611,44036,54165,10129
8095,0.0,0.0,0.0,3611,44040,54165,10125
8096,0.0,0.0,0.0,3611,44044,54165,10121
8097,0.0,0.0,0.0,3611,44048,54165,10117
8098,0.0,0.0,0.0,3611,44052,54165,10113
8099,0.0,0.0,0.0,3611,44056,54165,10109
8100,0.0,0.0,0.0,3611,44060,54165,10105
8101,0.0,0.0,0.0,3611,44064,54165,10101
8102,0.0,0.0,0.0,3611,44068,54165,10097
8103,0.0,0.0,0.0,3611,44072,54165,10093
8104,0.0,0.0,0.0,3611,44076,54165,10089
8105,0.0,0.0,0.0,3611,44080,54165,10085
8106,0.0,0.0,0.0,3611,44084,54165,10081
8107,0.0,0.0,0.0,3611,44088,54165,10077
8108,0.0,0.0,0.0,3611,44092,54165,10073
8110,0.0,0.0,0.0,3611,44096,54165,10069
8112,0.0,0.0,0.0,3611,44100,54165,10065
8113,0.0,0.0,0.0,3611,44104,54165,10061
8114,0.0,0.0,0.0,3611,44108,54165,10057
8115,0.0,0.0,0.0,3611,44112,54165,10053
8116,0.0,0.0,0.0,3611,44116,54165,10049
8117,0.0,0.0,0.0,3611,44120,54165,10045
8120,0.0,0.0,0.0,3611,44124,54165,10041
8121,0.0,0.0,0.0,3611,44128,54165,10037
8123,0.0,0.0,0.0,3611,44132,54165,10033
8124,0.0,0.0,0.0,3611,44136,54165,10029
8126,0.0,0.0,0.0,3611,44140,54165,10025
8127,0.0,0.0,0.0,3611,44144,54165,10021
8128,0.0,0.0,0.0,3611,44148,54165,10017
8130,0.0,0.0,0.0,3611,44152,54165,10013
8131,0.0,0.0,0.0,3611,44156,54165,10009
8132,0.0,0.0,0.0,3611,44160,54165,10005
8133,0.0,0.0,0.0,3611,44164,54165,10001
8134,0.0,0.0,0.0,3611,44168,54165,9997
8135,0.0,0.0,0.0,3611,44172,54165,9993
8136,0.0,0.0,0.0,3611,44176,54165,9989
8137,0.0,0.0,0.0,3611,44180,54165,9985
8138,0.0,0.0,0.0,3611,44184,54165,9981
8139,0.0,0.0,0.0,3611,44188,54165,9977
8140,0.0,0.0,0.0,3611,44192,54165,9973
8141,0.0,0.0,0.0,3611,44196,54165,9969
8142,0.0,0.0,0.0,3611,44200,54165,9965
8143,0.0,0.0,0.0,3611,44204,54165,9961
8144,0.0,0.0,0.0,3611,44208,54165,9957
8145,0.0,0.0,0.0,3611,44212,54165,9953
8146,0.0,0.0,0.0,3611,44216,54165,9949
8147,0.0,0.0,0.0,3611,44220,54165,9945
8148,0.0,0.0,0.0,3611,44224,54165,9941
8149,0.0,0.0,0.0,3611,44228,54165,9937
8150,0.0,0.0,0.0,3611,44232,54165,9933
8151,0.0,0.0,0.0,3611,44236,54165,9929
8152,0.0,0.0,0.0,3611,44240,54165,9925
8153,0.0,0.0,0.0,3611,44244,54165,9921
8154,0.0,0.0,0.0,3611,44248,54165,9917
8155,0.0,0.0,0.0,3611,44252,54165,9913
8156,0.0,0.0,0.0,3611,44256,54165,9909
8157,0.0,0.0,0.0,3611,44260,54165,9905
8159,0.0,0.0,0.0,3611,44264,54165,9901
8161,0.0,0.0,0.0,3611,44268,54165,9897
8162,0.0,0.0,0.0,3611,44272,54165,9893
8163,0.0,0.0,0.0,3611,44276,54165,9889
8164,0.0,0.0,0.0,3611,44280,54165,9885
8166,0.0,0.0,0.0,3611,44284,54165,9881
8167,0.0,0.0,0.0,3611,44288,54165,9877
8168,0.0,0.0,0.0,3611,44292,54165,9873
8169,0.0,0.0,0.0,3611,44296,54165,9869
8170,0.0,0.0,0.0,3611,44300,54165,9865
8172,0.0,0.0,0.0,3611,44304,54165,9861
8173,0.0,0.0,0.0,3611,44308,54165,9857
8174,0.0,0.0,0.0,3611,44312,54165,9853
8175,0.0,0.0,0.0,3611,44316,54165,9849
8178,0.0,0.0,0.0,3611,44320,54165,9845
8179,0.0,0.0,0.0,3611,44324,54165,9841
8180,0.0,0.0,0.0,3611,44328,54165,9837
8181,0.0,0.0,0.0,3611,44332,54165,9833
8184,0.0,0.0,0.0,3611,44336,54165,9829
8185,0.0,0.0,0.0,3611,44340,54165,9825
8186,0.0,0.0,0.0,3611,44344,54165,9821
8188,0.0,0.0,0.0,3611,44348,54165,9817
8189,0.0,0.0,0.0,3611,44352,54165,9813
8190,0.0,0.0,0.0,3611,44356,54165,9809
8191,0.0,0.0,0.0,3611,44360,54165,9805
8192,0.0,0.0,0.0,3611,44364,54165,9801
8193,0.0,0.0,0.0,3611,44368,54165,9797
8194,0.0,0.0,0.0,3611,44372,54165,9793
8195,0.0,0.0,0.0,3611,44376,54165,9789
8196,0.0,0.0,0.0,3611,44380,54165,9785
8197,0.0,0.0,0.0,3611,44384,54165,9781
8198,0.0,0.0,0.0,3611,44388,54165,9777
8199,0.0,0.0,0.0,3611,44392,54165,9773
8200,0.0,0.0,0.0,3611,44396,54165,9769
8201,0.0,0.0,0.0,3611,44400,54165,9765
8204,0.0,0.0,0.0,3611,44404,54165,9761
8205,0.0,0.0,0.0,3611,44408,54165,9757
8207,0.0,0.0,0.0,3611,44412,54165,9753
8209,0.0,0.0,0.0,3611,44416,54165,9749
8210,0.0,0.0,0.0,3611,44420,54165,9745
8211,0.0,0.0,0.0,3611,44424,54165,9741
8212,0.0,0.0,0.0,3611,44428,54165,9737
8213,0.0,0.0,0.0,3611,44432,54165,9733
8214,0.0,0.0,0.0,3611,44436,54165,9729
8215,0.0,0.0,0.0,3611,44440,54165,9725
8217,0.0,0.0,0.0,3611,44444,54165,9721
8218,0.0,0.0,0.0,3611,44448,54165,9717
8219,0.0,0.0,0.0,3611,44452,54165,9713
8220,0.0,0.0,0.0,3611,44456,54165,9709
8221,0.0,0.0,0.0,3611,44460,54165,9705
8222,0.0,0.0,0.0,3611,44464,54165,9701
8225,0.0,0.0,0.0,3611,44468,54165,9697
8226,0.0,0.0,0.0,3611,44472,54165,9693
8227,0.0,0.0,0.0,3611,44476,54165,9689
8228,0.0,0.0,0.0,3611,44480,54165,9685
8229,0.0,0.0,0.0,3611,44484,54165,9681
8230,0.0,0.0,0.0,3611,44488,54165,9677
8231,0.0,0.0,0.0,3611,44492,54165,9673
8232,0.0,0.0,0.0,3611,44496,54165,9669
8233,0.0,0.0,0.0,3611,44500,54165,9665
8234,0.0,0.0,0.0,3611,44504,54165,9661
8235,0.0,0.0,0.0,3611,44508,54165,9657
8237,0.0,0.0,0.0,3611,44512,54165,9653
8238,0.0,0.0,0.0,3611,44516,54165,9649
8239,0.0,0.0,0.0,3611,44520,54165,9645
8240,0.0,0.0,0.0,3611,44524,54165,9641
8241,0.0,0.0,0.0,3611,44528,54165,9637
8242,0.0,0.0,0.0,3611,44532,54165,9633
8244,0.0,0.0,0.0,3611,44536,54165,9629
8246,0.0,0.0,0.0,3611,44540,54165,9625
8247,0.0,0.0,0.0,3611,44544,54165,9621
8249,0.0,0.0,0.0,3611,44548,54165,9617
8250,0.0,0.0,0.0,3611,44552,54165,9613
8251,0.0,0.0,0.0,3611,44556,54165,9609
8252,0.0,0.0,0.0,3611,44560,54165,9605
8254,0.0,0.0,0.0,3611,44564,54165,9601
8255,0.0,0.0,0.0,3611,44568,54165,9597
8256,0.0,0.0,0.0,3611,44572,54165,9593
8257,0.0,0.0,0.0,3611,44576,54165,9589
8258,0.0,0.0,0.0,3611,44580,54165,9585
8260,0.0,0.0,0.0,3611,44584,54165,9581
8263,0.0,0.0,0.0,3611,44588,54165,9577
8264,0.0,0.0,0.0,3611,44592,54165,9573
8266,0.0,0.0,0.0,3611,44596,54165,9569
8267,0.0,0.0,0.0,3611,44600,54165,9565
8268,0.0,0.0,0.0,3611,44604,54165,9561
8269,0.0,0.0,0.0,3611,44608,54165,9557
8270,0.0,0.0,0.0,3611,44612,54165,9553
8271,0.0,0.0,0.0,3611,44616,54165,9549
8275,0.0,0.0,0.0,3611,44620,54165,9545
8278,0.0,0.0,0.0,3611,44624,54165,9541
8279,0.0,0.0,0.0,3611,44628,54165,9537
8280,0.0,0.0,0.0,3611,44632,54165,9533
8281,0.0,0.0,0.0,3611,44636,54165,9529
8282,0.0,0.0,0.0,3611,44640,54165,9525
8283,0.0,0.0,0.0,3611,44644,54165,9521
8284,0.0,0.0,0.0,3611,44648,54165,9517
8285,0.0,0.0,0.0,3611,44652,54165,9513
8287,0.0,0.0,0.0,3611,44656,54165,9509
8288,0.0,0.0,0.0,3611,44660,54165,9505
8291,0.0,0.0,0.0,3611,44664,54165,9501
8292,0.0,0.0,0.0,3611,44668,54165,9497
8293,0.0,0.0,0.0,3611,44672,54165,9493
8294,0.0,0.0,0.0,3611,44676,54165,9489
8295,0.0,0.0,0.0,3611,44680,54165,9485
8296,0.0,0.0,0.0,3611,44684,54165,9481
8297,0.0,0.0,0.0,3611,44688,54165,9477
8298,0.0,0.0,0.0,3611,44692,54165,9473
8299,0.0,0.0,0.0,3611,44696,54165,9469
8300,0.0,0.0,0.0,3611,44700,54165,9465
8303,0.0,0.0,0.0,3611,44704,54165,9461
8304,0.0,0.0,0.0,3611,44708,54165,9457
8306,0.0,0.0,0.0,3611,44712,54165,9453
8308,0.0,0.0,0.0,3611,44716,54165,9449
8310,0.0,0.0,0.0,3611,44720,54165,9445
8311,0.0,0.0,0.0,3611,44724,54165,9441
8313,0.0,0.0,0.0,3611,44728,54165,9437
8315,0.0,0.0,0.0,3611,44732,54165,9433
8316,0.0,0.0,0.0,3611,44736,54165,9429
8317,0.0,0.0,0.0,3611,44740,54165,9425
8318,0.0,0.0,0.0,3611,44744,54165,9421
8319,0.0,0.0,0.0,3611,44748,54165,9417
8320,0.0,0.0,0.0,3611,44752,54165,9413
8323,0.0,0.0,0.0,3611,44756,54165,9409
8324,0.0,0.0,0.0,3611,44760,54165,9405
8325,0.0,0.0,0.0,3611,44764,54165,9401
8326,0.0,0.0,0.0,3611,44768,54165,9397
8327,0.0,0.0,0.0,3611,44772,54165,9393
8328,0.0,0.0,0.0,3611,44776,54165,9389
8329,0.0,0.0,0.0,3611,44780,54165,9385
8330,0.0,0.0,0.0,3611,44784,54165,9381
8331,0.0,0.0,0.0,3611,44788,54165,9377
8332,0.0,0.0,0.0,3611,44792,54165,9373
8333,0.0,0.0,0.0,3611,44796,54165,9369
8334,0.0,0.0,0.0,3611,44800,54165,9365
8335,0.0,0.0,0.0,3611,44804,54165,9361
8336,0.0,0.0,0.0,3611,44808,54165,9357
8337,0.0,0.0,0.0,3611,44812,54165,9353
8339,0.0,0.0,0.0,3611,44816,54165,9349
8341,0.0,0.0,0.0,3611,44820,54165,9345
8342,0.0,0.0,0.0,3611,44824,54165,9341
8344,0.0,0.0,0.0,3611,44828,54165,9337
8345,0.0,0.0,0.0,3611,44832,54165,9333
8346,0.0,0.0,0.0,3611,44836,54165,9329
8347,0.0,0.0,0.0,3611,44840,54165,9325
8348,0.0,0.0,0.0,3611,44844,54165,9321
8349,0.0,0.0,0.0,3611,44848,54165,9317
8350,0.0,0.0,0.0,3611,44852,54165,9313
8351,0.0,0.0,0.0,3611,44856,54165,9309
8352,0.0,0.0,0.0,3611,44860,54165,9305
8353,0.0,0.0,0.0,3611,44864,54165,9301
8354,0.0,0.0,0.0,3611,44868,54165,9297
8355,0.0,0.0,0.0,3611,44872,54165,9293
8357,0.0,0.0,0.0,3611,44876,54165,9289
8359,0.0,0.0,0.0,3611,44880,54165,9285
8360,0.0,0.0,0.0,3611,44884,54165,9281
8361,0.0,0.0,0.0,3611,44888,54165,9277
8363,0.0,0.0,0.0,3611,44892,54165,9273
8364,0.0,0.0,0.0,3611,44896,54165,9269
8365,0.0,0.0,0.0,3611,44900,54165,9265
8366,0.0,0.0,0.0,3611,44904,54165,9261
8367,0.0,0.0,0.0,3611,44908,54165,9257
8368,0.0,0.0,0.0,3611,44912,54165,9253
8369,0.0,0.0,0.0,3611,44916,54165,9249
8370,0.0,0.0,0.0,3611,44920,54165,9245
8371,0.0,0.0,0.0,3611,44924,54165,9241
8373,0.0,0.0,0.0,3611,44928,54165,9237
8374,0.0,0.0,0.0,3611,44932,54165,9233
8375,0.0,0.0,0.0,3611,44936,54165,9229
8376,0.0,0.0,0.0,3611,44940,54165,9225
8377,0.0,0.0,0.0,3611,44944,54165,9221
8378,0.0,0.0,0.0,3611,44948,54165,9217
8379,0.0,0.0,0.0,3611,44952,54165,9213
8380,0.0,0.0,0.0,3611,44956,54165,9209
8381,0.0,0.0,0.0,3611,44960,54165,9205
8382,0.0,0.0,0.0,3611,44964,54165,9201
8383,0.0,0.0,0.0,3611,44968,54165,9197
8384,0.0,0.0,0.0,3611,44972,54165,9193
8385,0.0,0.0,0.0,3611,44976,54165,9189
8386,0.0,0.0,0.0,3611,44980,54165,9185
8387,0.0,0.0,0.0,3611,44984,54165,9181
8388,0.0,0.0,0.0,3611,44988,54165,9177
8389,0.0,0.0,0.0,3611,44992,54165,9173
8390,0.0,0.0,0.0,3611,44996,54165,9169
8391,0.0,0.0,0.0,3611,45000,54165,9165
8392,0.0,0.0,0.0,3611,45004,54165,9161
8393,0.0,0.0,0.0,3611,45008,54165,9157
8394,0.0,0.0,0.0,3611,45012,54165,9153
8395,0.0,0.0,0.0,3611,45016,54165,9149
8396,0.0,0.0,0.0,3611,45020,54165,9145
8397,0.0,0.0,0.0,3611,45024,54165,9141
8398,0.0,0.0,0.0,3611,45028,54165,9137
8400,0.0,0.0,0.0,3611,45032,54165,9133
8401,0.0,0.0,0.0,3611,45036,54165,9129
8403,0.0,0.0,0.0,3611,45040,54165,9125
8404,0.0,0.0,0.0,3611,45044,54165,9121
8407,0.0,0.0,0.0,3611,45048,54165,9117
8409,0.0,0.0,0.0,3611,45052,54165,9113
8410,0.0,0.0,0.0,3611,45056,54165,9109
8411,0.0,0.0,0.0,3611,45060,54165,9105
8412,0.0,0.0,0.0,3611,45064,54165,9101
8413,0.0,0.0,0.0,3611,45068,54165,9097
8414,0.0,0.0,0.0,3611,45072,54165,9093
8415,0.0,0.0,0.0,3611,45076,54165,9089
8416,0.0,0.0,0.0,3611,45080,54165,9085
8417,0.0,0.0,0.0,3611,45084,54165,9081
8418,0.0,0.0,0.0,3611,45088,54165,9077
8420,0.0,0.0,0.0,3611,45092,54165,9073
8421,0.0,0.0,0.0,3611,45096,54165,9069
8422,0.0,0.0,0.0,3611,45100,54165,9065
8423,0.0,0.0,0.0,3611,45104,54165,9061
8424,0.0,0.0,0.0,3611,45108,54165,9057
8425,0.0,0.0,0.0,3611,45112,54165,9053
8426,0.0,0.0,0.0,3611,45116,54165,9049
8427,0.0,0.0,0.0,3611,45120,54165,9045
8428,0.0,0.0,0.0,3611,45124,54165,9041
8429,0.0,0.0,0.0,3611,45128,54165,9037
8430,0.0,0.0,0.0,3611,45132,54165,9033
8431,0.0,0.0,0.0,3611,45136,54165,9029
8432,0.0,0.0,0.0,3611,45140,54165,9025
8433,0.0,0.0,0.0,3611,45144,54165,9021
8434,0.0,0.0,0.0,3611,45148,54165,9017
8435,0.0,0.0,0.0,3611,45152,54165,9013
8437,0.0,0.0,0.0,3611,45156,54165,9009
8438,0.0,0.0,0.0,3611,45160,54165,9005
8439,0.0,0.0,0.0,3611,45164,54165,9001
8440,0.0,0.0,0.0,3611,45168,54165,8997
8441,0.0,0.0,0.0,3611,45172,54165,8993
8443,0.0,0.0,0.0,3611,45176,54165,8989
8444,0.0,0.0,0.0,3611,45180,54165,8985
8445,0.0,0.0,0.0,3611,45184,54165,8981
8447,0.0,0.0,0.0,3611,45188,54165,8977
8448,0.0,0.0,0.0,3611,45192,54165,8973
8449,0.0,0.0,0.0,3611,45196,54165,8969
8450,0.0,0.0,0.0,3611,45200,54165,8965
8451,0.0,0.0,0.0,3611,45204,54165,8961
8452,0.0,0.0,0.0,3611,45208,54165,8957
8453,0.0,0.0,0.0,3611,45212,54165,8953
8454,0.0,0.0,0.0,3611,45216,54165,8949
8455,0.0,0.0,0.0,3611,45220,54165,8945
8456,0.0,0.0,0.0,3611,45224,54165,8941
8458,0.0,0.0,0.0,3611,45228,54165,8937
8460,0.0,0.0,0.0,3611,45232,54165,8933
8463,0.0,0.0,0.0,3611,45236,54165,8929
8464,0.0,0.0,0.0,3611,45240,54165,8925
8465,0.0,0.0,0.0,3611,45244,54165,8921
8466,0.0,0.0,0.0,3611,45248,54165,8917
8468,0.0,0.0,0.0,3611,45252,54165,8913
8469,0.0,0.0,0.0,3611,45256,54165,8909
8470,0.0,0.0,0.0,3611,45260,54165,8905
8471,0.0,0.0,0.0,3611,45264,54165,8901
8473,0.0,0.0,0.0,3611,45268,54165,8897
8474,0.0,0.0,0.0,3611,45272,54165,8893
8475,0.0,0.0,0.0,3611,45276,54165,8889
8477,0.0,0.0,0.0,3611,45280,54165,8885
8478,0.0,0.0,0.0,3611,45284,54165,8881
8479,0.0,0.0,0.0,3611,45288,54165,8877
8480,0.0,0.0,0.0,3611,45292,54165,8873
8481,0.0,0.0,0.0,3611,45296,54165,8869
8482,0.0,0.0,0.0,3611,45300,54165,8865
8483,0.0,0.0,0.0,3611,45304,54165,8861
8484,0.0,0.0,0.0,3611,45308,54165,8857
8485,0.0,0.0,0.0,3611,45312,54165,8853
8486,0.0,0.0,0.0,3611,45316,54165,8849
8488,0.0,0.0,0.0,3611,45320,54165,8845
8490,0.0,0.0,0.0,3611,45324,54165,8841
8492,0.0,0.0,0.0,3611,45328,54165,8837
8493,0.0,0.0,0.0,3611,45332,54165,8833
8494,0.0,0.0,0.0,3611,45336,54165,8829
8495,0.0,0.0,0.0,3611,45340,54165,8825
8496,0.0,0.0,0.0,3611,45344,54165,8821
8497,0.0,0.0,0.0,3611,45348,54165,8817
8498,0.0,0.0,0.0,3611,45352,54165,8813
8500,0.0,0.0,0.0,3611,45356,54165,8809
8502,0.0,0.0,0.0,3611,45360,54165,8805
8503,0.0,0.0,0.0,3611,45364,54165,8801
8504,0.0,0.0,0.0,3611,45368,54165,8797
8505,0.0,0.0,0.0,3611,45372,54165,8793
8506,0.0,0.0,0.0,3611,45376,54165,8789
8507,0.0,0.0,0.0,3611,45380,54165,8785
8509,0.0,0.0,0.0,3611,45384,54165,8781
8510,0.0,0.0,0.0,3611,45388,54165,8777
8511,0.0,0.0,0.0,3611,45392,54165,8773
8512,0.0,0.0,0.0,3611,45396,54165,8769
8513,0.0,0.0,0.0,3611,45400,54165,8765
8514,0.0,0.0,0.0,3611,45404,54165,8761
8516,0.0,0.0,0.0,3611,45408,54165,8757
8517,0.0,0.0,0.0,3611,45412,54165,8753
8518,0.0,0.0,0.0,3611,45416,54165,8749
8519,0.0,0.0,0.0,3611,45420,54165,8745
8520,0.0,0.0,0.0,3611,45424,54165,8741
8522,0.0,0.0,0.0,3611,45428,54165,8737
8523,0.0,0.0,0.0,3611,45432,54165,8733
8524,0.0,0.0,0.0,3611,45436,54165,8729
8526,0.0,0.0,0.0,3611,45440,54165,8725
8527,0.0,0.0,0.0,3611,45444,54165,8721
8528,0.0,0.0,0.0,3611,45448,54165,8717
8529,0.0,0.0,0.0,3611,45452,54165,8713
8531,0.0,0.0,0.0,3611,45456,54165,8709
8532,0.0,0.0,0.0,3611,45460,54165,8705
8533,0.0,0.0,0.0,3611,45464,54165,8701
8534,0.0,0.0,0.0,3611,45468,54165,8697
8535,0.0,0.0,0.0,3611,45472,54165,8693
8536,0.0,0.0,0.0,3611,45476,54165,8689
8537,0.0,0.0,0.0,3611,45480,54165,8685
8538,0.0,0.0,0.0,3611,45484,54165,8681
8539,0.0,0.0,0.0,3611,45488,54165,8677
8540,0.0,0.0,0.0,3611,45492,54165,8673
8541,0.0,0.0,0.0,3611,45496,54165,8669
8542,0.0,0.0,0.0,3611,45500,54165,8665
8543,0.0,0.0,0.0,3611,45504,54165,8661
8545,0.0,0.0,0.0,3611,45508,54165,8657
8547,0.0,0.0,0.0,3611,45512,54165,8653
8548,0.0,0.0,0.0,3611,45516,54165,8649
8550,0.0,0.0,0.0,3611,45520,54165,8645
8551,0.0,0.0,0.0,3611,45524,54165,8641
8552,0.0,0.0,0.0,3611,45528,54165,8637
8554,0.0,0.0,0.0,3611,45532,54165,8633
8556,0.0,0.0,0.0,3611,45536,54165,8629
8557,0.0,0.0,0.0,3611,45540,54165,8625
8559,0.0,0.0,0.0,3611,45544,54165,8621
8560,0.0,0.0,0.0,3611,45548,54165,8617
8561,0.0,0.0,0.0,3611,45552,54165,8613
8562,0.0,0.0,0.0,3611,45556,54165,8609
8563,0.0,0.0,0.0,3611,45560,54165,8605
8565,0.0,0.0,0.0,3611,45564,54165,8601
8568,0.0,0.0,0.0,3611,45568,54165,8597
8570,0.0,0.0,0.0,3611,45572,54165,8593
8571,0.0,0.0,0.0,3611,45576,54165,8589
8573,0.0,0.0,0.0,3611,45580,54165,8585
8574,0.0,0.0,0.0,3611,45584,54165,8581
8575,0.0,0.0,0.0,3611,45588,54165,8577
8576,0.0,0.0,0.0,3611,45592,54165,8573
8578,0.0,0.0,0.0,3611,45596,54165,8569
8579,0.0,0.0,0.0,3611,45600,54165,8565
8581,0.0,0.0,0.0,3611,45604,54165,8561
8582,0.0,0.0,0.0,3611,45608,54165,8557
8583,0.0,0.0,0.0,3611,45612,54165,8553
8585,0.0,0.0,0.0,3611,45616,54165,8549
8586,0.0,0.0,0.0,3611,45620,54165,8545
8589,0.0,0.0,0.0,3611,45624,54165,8541
8591,0.0,0.0,0.0,3611,45628,54165,8537
8592,0.0,0.0,0.0,3611,45632,54165,8533
8593,0.0,0.0,0.0,3611,45636,54165,8529
8594,0.0,0.0,0.0,3611,45640,54165,8525
8595,0.0,0.0,0.0,3611,45644,54165,8521
8596,0.0,0.0,0.0,3611,45648,54165,8517
8597,0.0,0.0,0.0,3611,45652,54165,8513
8598,0.0,0.0,0.0,3611,45656,54165,8509
8599,0.0,0.0,0.0,3611,45660,54165,8505
8600,0.0,0.0,0.0,3611,45664,54165,8501
8601,0.0,0.0,0.0,3611,45668,54165,8497
8602,0.0,0.0,0.0,3611,45672,54165,8493
8603,0.0,0.0,0.0,3611,45676,54165,8489
8604,0.0,0.0,0.0,3611,45680,54165,8485
8605,0.0,0.0,0.0,3611,45684,54165,8481
8606,0.0,0.0,0.0,3611,45688,54165,8477
8608,0.0,0.0,0.0,3611,45692,54165,8473
8609,0.0,0.0,0.0,3611,45696,54165,8469
8610,0.0,0.0,0.0,3611,45700,54165,8465
8611,0.0,0.0,0.0,3611,45704,54165,8461
8612,0.0,0.0,0.0,3611,45708,54165,8457
8613,0.0,0.0,0.0,3611,45712,54165,8453
8614,0.0,0.0,0.0,3611,45716,54165,8449
8618,0.0,0.0,0.0,3611,45720,54165,8445
8621,0.0,0.0,0.0,3611,45724,54165,8441
8622,0.0,0.0,0.0,3611,45728,54165,8437
8624,0.0,0.0,0.0,3611,45732,54165,8433
8625,0.0,0.0,0.0,3611,45736,54165,8429
8628,0.0,0.0,0.0,3611,45740,54165,8425
8629,0.0,0.0,0.0,3611,45744,54165,8421
8630,0.0,0.0,0.0,3611,45748,54165,8417
8631,0.0,0.0,0.0,3611,45752,54165,8413
8632,0.0,0.0,0.0,3611,45756,54165,8409
8633,0.0,0.0,0.0,3611,45760,54165,8405
8634,0.0,0.0,0.0,3611,45764,54165,8401
8637,0.0,0.0,0.0,3611,45768,54165,8397
8639,0.0,0.0,0.0,3611,45772,54165,8393
8641,0.0,0.0,0.0,3611,45776,54165,8389
8642,0.0,0.0,0.0,3611,45780,54165,8385
8643,0.0,0.0,0.0,3611,45784,54165,8381
8644,0.0,0.0,0.0,3611,45788,54165,8377
8645,0.0,0.0,0.0,3611,45792,54165,8373
8646,0.0,0.0,0.0,3611,45796,54165,8369
8647,0.0,0.0,0.0,3611,45800,54165,8365
8648,0.0,0.0,0.0,3611,45804,54165,8361
8649,0.0,0.0,0.0,3611,45808,54165,8357
8650,0.0,0.0,0.0,3611,45812,54165,8353
8651,0.0,0.0,0.0,3611,45816,54165,8349
8652,0.0,0.0,0.0,3611,45820,54165,8345
8653,0.0,0.0,0.0,3611,45824,54165,8341
8654,0.0,0.0,0.0,3611,45828,54165,8337
8655,0.0,0.0,0.0,3611,45832,54165,8333
8656,0.0,0.0,0.0,3611,45836,54165,8329
8659,0.0,0.0,0.0,3611,45840,54165,8325
8660,0.0,0.0,0.0,3611,45844,54165,8321
8662,0.0,0.0,0.0,3611,45848,54165,8317
8663,0.0,0.0,0.0,3611,45852,54165,8313
8664,0.0,0.0,0.0,3611,45856,54165,8309
8665,0.0,0.0,0.0,3611,45860,54165,8305
8666,0.0,0.0,0.0,3611,45864,54165,8301
8667,0.0,0.0,0.0,3611,45868,54165,8297
8668,0.0,0.0,0.0,3611,45872,54165,8293
8669,0.0,0.0,0.0,3611,45876,54165,8289
8670,0.0,0.0,0.0,3611,45880,54165,8285
8672,0.0,0.0,0.0,3611,45884,54165,8281
8677,0.0,0.0,0.0,3611,45888,54165,8277
8678,0.0,0.0,0.0,3611,45892,54165,8273
8680,0.0,0.0,0.0,3611,45896,54165,8269
8681,0.0,0.0,0.0,3611,45900,54165,8265
8682,0.0,0.0,0.0,3611,45904,54165,8261
8683,0.0,0.0,0.0,3611,45908,54165,8257
8684,0.0,0.0,0.0,3611,45912,54165,8253
8686,0.0,0.0,0.0,3611,45916,54165,8249
8687,0.0,0.0,0.0,3611,45920,54165,8245
8688,0.0,0.0,0.0,3611,45924,54165,8241
8689,0.0,0.0,0.0,3611,45928,54165,8237
8690,0.0,0.0,0.0,3611,45932,54165,8233
8694,0.0,0.0,0.0,3611,45936,54165,8229
8695,0.0,0.0,0.0,3611,45940,54165,8225
8696,0.0,0.0,0.0,3611,45944,54165,8221
8698,0.0,0.0,0.0,3611,45948,54165,8217
8699,0.0,0.0,0.0,3611,45952,54165,8213
8700,0.0,0.0,0.0,3611,45956,54165,8209
8701,0.0,0.0,0.0,3611,45960,54165,8205
8702,0.0,0.0,0.0,3611,45964,54165,8201
8703,0.0,0.0,0.0,3611,45968,54165,8197
8704,0.0,0.0,0.0,3611,45972,54165,8193
8705,0.0,0.0,0.0,3611,45976,54165,8189
8706,0.0,0.0,0.0,3611,45980,54165,8185
8708,0.0,0.0,0.0,3611,45984,54165,8181
8709,0.0,0.0,0.0,3611,45988,54165,8177
8711,0.0,0.0,0.0,3611,45992,54165,8173
8713,0.0,0.0,0.0,3611,45996,54165,8169
8714,0.0,0.0,0.0,3611,46000,54165,8165
8715,0.0,0.0,0.0,3611,46004,54165,8161
8716,0.0,0.0,0.0,3611,46008,54165,8157
8717,0.0,0.0,0.0,3611,46012,54165,8153
8718,0.0,0.0,0.0,3611,46016,54165,8149
8719,0.0,0.0,0.0,3611,46020,54165,8145
8721,0.0,0.0,0.0,3611,46024,54165,8141
8722,0.0,0.0,0.0,3611,46028,54165,8137
8723,0.0,0.0,0.0,3611,46032,54165,8133
8725,0.0,0.0,0.0,3611,46036,54165,8129
8726,0.0,0.0,0.0,3611,46040,54165,8125
8728,0.0,0.0,0.0,3611,46044,54165,8121
8729,0.0,0.0,0.0,3611,46048,54165,8117
8730,0.0,0.0,0.0,3611,46052,54165,8113
8731,0.0,0.0,0.0,3611,46056,54165,8109
8732,0.0,0.0,0.0,3611,46060,54165,8105
8733,0.0,0.0,0.0,3611,46064,54165,8101
8734,0.0,0.0,0.0,3611,46068,54165,8097
8735,0.0,0.0,0.0,3611,46072,54165,8093
8737,0.0,0.0,0.0,3611,46076,54165,8089
8738,0.0,0.0,0.0,3611,46080,54165,8085
8739,0.0,0.0,0.0,3611,46084,54165,8081
8740,0.0,0.0,0.0,3611,46088,54165,8077
8741,0.0,0.0,0.0,3611,46092,54165,8073
8742,0.0,0.0,0.0,3611,46096,54165,8069
8743,0.0,0.0,0.0,3611,46100,54165,8065
8744,0.0,0.0,0.0,3611,46104,54165,8061
8745,0.0,0.0,0.0,3611,46108,54165,8057
8746,0.0,0.0,0.0,3611,46112,54165,8053
8749,0.0,0.0,0.0,3611,46116,54165,8049
8750,0.0,0.0,0.0,3611,46120,54165,8045
8751,0.0,0.0,0.0,3611,46124,54165,8041
8752,0.0,0.0,0.0,3611,46128,54165,8037
8753,0.0,0.0,0.0,3611,46132,54165,8033
8754,0.0,0.0,0.0,3611,46136,54165,8029
8757,0.0,0.0,0.0,3611,46140,54165,8025
8758,0.0,0.0,0.0,3611,46144,54165,8021
8759,0.0,0.0,0.0,3611,46148,54165,8017
8760,0.0,0.0,0.0,3611,46152,54165,8013
8761,0.0,0.0,0.0,3611,46156,54165,8009
8762,0.0,0.0,0.0,3611,46160,54165,8005
8763,0.0,0.0,0.0,3611,46164,54165,8001
8765,0.0,0.0,0.0,3611,46168,54165,7997
8766,0.0,0.0,0.0,3611,46172,54165,7993
8768,0.0,0.0,0.0,3611,46176,54165,7989
8769,0.0,0.0,0.0,3611,46180,54165,7985
8771,0.0,0.0,0.0,3611,46184,54165,7981
8772,0.0,0.0,0.0,3611,46188,54165,7977
8773,0.0,0.0,0.0,3611,46192,54165,7973
8777,0.0,0.0,0.0,3611,46196,54165,7969
8779,0.0,0.0,0.0,3611,46200,54165,7965
8780,0.0,0.0,0.0,3611,46204,54165,7961
8781,0.0,0.0,0.0,3611,46208,54165,7957
8782,0.0,0.0,0.0,3611,46212,54165,7953
8784,0.0,0.0,0.0,3611,46216,54165,7949
8785,0.0,0.0,0.0,3611,46220,54165,7945
8786,0.0,0.0,0.0,3611,46224,54165,7941
8787,0.0,0.0,0.0,3611,46228,54165,7937
8788,0.0,0.0,0.0,3611,46232,54165,7933
8789,0.0,0.0,0.0,3611,46236,54165,7929
8790,0.0,0.0,0.0,3611,46240,54165,7925
8791,0.0,0.0,0.0,3611,46244,54165,7921
8792,0.0,0.0,0.0,3611,46248,54165,7917
8794,0.0,0.0,0.0,3611,46252,54165,7913
8795,0.0,0.0,0.0,3611,46256,54165,7909
8796,0.0,0.0,0.0,3611,46260,54165,7905
8797,0.0,0.0,0.0,3611,46264,54165,7901
8799,0.0,0.0,0.0,3611,46268,54165,7897
8800,0.0,0.0,0.0,3611,46272,54165,7893
8801,0.0,0.0,0.0,3611,46276,54165,7889
8802,0.0,0.0,0.0,3611,46280,54165,7885
8803,0.0,0.0,0.0,3611,46284,54165,7881
8804,0.0,0.0,0.0,3611,46288,54165,7877
8805,0.0,0.0,0.0,3611,46292,54165,7873
8806,0.0,0.0,0.0,3611,46296,54165,7869
8807,0.0,0.0,0.0,3611,46300,54165,7865
8808,0.0,0.0,0.0,3611,46304,54165,7861
8809,0.0,0.0,0.0,3611,46308,54165,7857
8810,0.0,0.0,0.0,3611,46312,54165,7853
8812,0.0,0.0,0.0,3611,46316,54165,7849
8813,0.0,0.0,0.0,3611,46320,54165,7845
8815,0.0,0.0,0.0,3611,46324,54165,7841
8816,0.0,0.0,0.0,3611,46328,54165,7837
8817,0.0,0.0,0.0,3611,46332,54165,7833
8819,0.0,0.0,0.0,3611,46336,54165,7829
8821,0.0,0.0,0.0,3611,46340,54165,7825
8822,0.0,0.0,0.0,3611,46344,54165,7821
8823,0.0,0.0,0.0,3611,46348,54165,7817
8825,0.0,0.0,0.0,3611,46352,54165,7813
8827,0.0,0.0,0.0,3611,46356,54165,7809
8828,0.0,0.0,0.0,3611,46360,54165,7805
8829,0.0,0.0,0.0,3611,46364,54165,7801
8830,0.0,0.0,0.0,3611,46368,54165,7797
8832,0.0,0.0,0.0,3611,46372,54165,7793
8835,0.0,0.0,0.0,3611,46376,54165,7789
8836,0.0,0.0,0.0,3611,46380,54165,7785
8837,0.0,0.0,0.0,3611,46384,54165,7781
8839,0.0,0.0,0.0,3611,46388,54165,7777
8840,0.0,0.0,0.0,3611,46392,54165,7773
8841,0.0,0.0,0.0,3611,46396,54165,7769
8842,0.0,0.0,0.0,3611,46400,54165,7765
8843,0.0,0.0,0.0,3611,46404,54165,7761
8844,0.0,0.0,0.0,3611,46408,54165,7757
8846,0.0,0.0,0.0,3611,46412,54165,7753
8848,0.0,0.0,0.0,3611,46416,54165,7749
8849,0.0,0.0,0.0,3611,46420,54165,7745
8850,0.0,0.0,0.0,3611,46424,54165,7741
8851,0.0,0.0,0.0,3611,46428,54165,7737
8852,0.0,0.0,0.0,3611,46432,54165,7733
8853,0.0,0.0,0.0,3611,46436,54165,7729
8855,0.0,0.0,0.0,3611,46440,54165,7725
8856,0.0,0.0,0.0,3611,46444,54165,7721
8857,0.0,0.0,0.0,3611,46448,54165,7717
8858,0.0,0.0,0.0,3611,46452,54165,7713
8860,0.0,0.0,0.0,3611,46456,54165,7709
8862,0.0,0.0,0.0,3611,46460,54165,7705
8864,0.0,0.0,0.0,3611,46464,54165,7701
8865,0.0,0.0,0.0,3611,46468,54165,7697
8866,0.0,0.0,0.0,3611,46472,54165,7693
8867,0.0,0.0,0.0,3611,46476,54165,7689
8868,0.0,0.0,0.0,3611,46480,54165,7685
8869,0.0,0.0,0.0,3611,46484,54165,7681
8870,0.0,0.0,0.0,3611,46488,54165,7677
8871,0.0,0.0,0.0,3611,46492,54165,7673
8872,0.0,0.0,0.0,3611,46496,54165,7669
8873,0.0,0.0,0.0,3611,46500,54165,7665
8874,0.0,0.0,0.0,3611,46504,54165,7661
8876,0.0,0.0,0.0,3611,46508,54165,7657
8877,0.0,0.0,0.0,3611,46512,54165,7653
8878,0.0,0.0,0.0,3611,46516,54165,7649
8879,0.0,0.0,0.0,3611,46520,54165,7645
8880,0.0,0.0,0.0,3611,46524,54165,7641
8881,0.0,0.0,0.0,3611,46528,54165,7637
8882,0.0,0.0,0.0,3611,46532,54165,7633
8883,0.0,0.0,0.0,3611,46536,54165,7629
8885,0.0,0.0,0.0,3611,46540,54165,7625
8887,0.0,0.0,0.0,3611,46544,54165,7621
8888,0.0,0.0,0.0,3611,46548,54165,7617
8889,0.0,0.0,0.0,3611,46552,54165,7613
8890,0.0,0.0,0.0,3611,46556,54165,7609
8892,0.0,0.0,0.0,3611,46560,54165,7605
8893,0.0,0.0,0.0,3611,46564,54165,7601
8896,0.0,0.0,0.0,3611,46568,54165,7597
8897,0.0,0.0,0.0,3611,46572,54165,7593
8898,0.0,0.0,0.0,3611,46576,54165,7589
8899,0.0,0.0,0.0,3611,46580,54165,7585
8900,0.0,0.0,0.0,3611,46584,54165,7581
8901,0.0,0.0,0.0,3611,46588,54165,7577
8902,0.0,0.0,0.0,3611,46592,54165,7573
8903,0.0,0.0,0.0,3611,46596,54165,7569
8904,0.0,0.0,0.0,3611,46600,54165,7565
8906,0.0,0.0,0.0,3611,46604,54165,7561
8907,0.0,0.0,0.0,3611,46608,54165,7557
8909,0.0,0.0,0.0,3611,46612,54165,7553
8910,0.0,0.0,0.0,3611,46616,54165,7549
8911,0.0,0.0,0.0,3611,46620,54165,7545
8913,0.0,0.0,0.0,3611,46624,54165,7541
8915,0.0,0.0,0.0,3611,46628,54165,7537
8916,0.0,0.0,0.0,3611,46632,54165,7533
8917,0.0,0.0,0.0,3611,46636,54165,7529
8920,0.0,0.0,0.0,3611,46640,54165,7525
8921,0.0,0.0,0.0,3611,46644,54165,7521
8922,0.0,0.0,0.0,3611,46648,54165,7517
8923,0.0,0.0,0.0,3611,46652,54165,7513
8924,0.0,0.0,0.0,3611,46656,54165,7509
8925,0.0,0.0,0.0,3611,46660,54165,7505
8927,0.0,0.0,0.0,3611,46664,54165,7501
8928,0.0,0.0,0.0,3611,46668,54165,7497
8929,0.0,0.0,0.0,3611,46672,54165,7493
8932,0.0,0.0,0.0,3611,46676,54165,7489
8933,0.0,0.0,0.0,3611,46680,54165,7485
8935,0.0,0.0,0.0,3611,46684,54165,7481
8936,0.0,0.0,0.0,3611,46688,54165,7477
8937,0.0,0.0,0.0,3611,46692,54165,7473
8938,0.0,0.0,0.0,3611,46696,54165,7469
8939,0.0,0.0,0.0,3611,46700,54165,7465
8940,0.0,0.0,0.0,3611,46704,54165,7461
8941,0.0,0.0,0.0,3611,46708,54165,7457
8942,0.0,0.0,0.0,3611,46712,54165,7453
8943,0.0,0.0,0.0,3611,46716,54165,7449
8944,0.0,0.0,0.0,3611,46720,54165,7445
8946,0.0,0.0,0.0,3611,46724,54165,7441
8947,0.0,0.0,0.0,3611,46728,54165,7437
8948,0.0,0.0,0.0,3611,46732,54165,7433
8949,0.0,0.0,0.0,3611,46736,54165,7429
8950,0.0,0.0,0.0,3611,46740,54165,7425
8951,0.0,0.0,0.0,3611,46744,54165,7421
8952,0.0,0.0,0.0,3611,46748,54165,7417
8953,0.0,0.0,0.0,3611,46752,54165,7413
8954,0.0,0.0,0.0,3611,46756,54165,7409
8955,0.0,0.0,0.0,3611,46760,54165,7405
8956,0.0,0.0,0.0,3611,46764,54165,7401
8957,0.0,0.0,0.0,3611,46768,54165,7397
8958,0.0,0.0,0.0,3611,46772,54165,7393
8960,0.0,0.0,0.0,3611,46776,54165,7389
8961,0.0,0.0,0.0,3611,46780,54165,7385
8962,0.0,0.0,0.0,3611,46784,54165,7381
8963,0.0,0.0,0.0,3611,46788,54165,7377
8964,0.0,0.0,0.0,3611,46792,54165,7373
8965,0.0,0.0,0.0,3611,46796,54165,7369
8966,0.0,0.0,0.0,3611,46800,54165,7365
8967,0.0,0.0,0.0,3611,46804,54165,7361
8968,0.0,0.0,0.0,3611,46808,54165,7357
8969,0.0,0.0,0.0,3611,46812,54165,7353
8970,0.0,0.0,0.0,3611,46816,54165,7349
8972,0.0,0.0,0.0,3611,46820,54165,7345
8973,0.0,0.0,0.0,3611,46824,54165,7341
8974,0.0,0.0,0.0,3611,46828,54165,7337
8975,0.0,0.0,0.0,3611,46832,54165,7333
8976,0.0,0.0,0.0,3611,46836,54165,7329
8978,0.0,0.0,0.0,3611,46840,54165,7325
8979,0.0,0.0,0.0,3611,46844,54165,7321
8981,0.0,0.0,0.0,3611,46848,54165,7317
8982,0.0,0.0,0.0,3611,46852,54165,7313
8983,0.0,0.0,0.0,3611,46856,54165,7309
8984,0.0,0.0,0.0,3611,46860,54165,7305
8985,0.0,0.0,0.0,3611,46864,54165,7301
8986,0.0,0.0,0.0,3611,46868,54165,7297
8988,0.0,0.0,0.0,3611,46872,54165,7293
8989,0.0,0.0,0.0,3611,46876,54165,7289
8990,0.0,0.0,0.0,3611,46880,54165,7285
8991,0.0,0.0,0.0,3611,46884,54165,7281
8993,0.0,0.0,0.0,3611,46888,54165,7277
8994,0.0,0.0,0.0,3611,46892,54165,7273
8995,0.0,0.0,0.0,3611,46896,54165,7269
8996,0.0,0.0,0.0,3611,46900,54165,7265
8997,0.0,0.0,0.0,3611,46904,54165,7261
8998,0.0,0.0,0.0,3611,46908,54165,7257
8999,0.0,0.0,0.0,3611,46912,54165,7253
9000,0.0,0.0,0.0,3611,46916,54165,7249
9002,0.0,0.0,0.0,3611,46920,54165,7245
9004,0.0,0.0,0.0,3611,46924,54165,7241
9005,0.0,0.0,0.0,3611,46928,54165,7237
9006,0.0,0.0,0.0,3611,46932,54165,7233
9007,0.0,0.0,0.0,3611,46936,54165,7229
9008,0.0,0.0,0.0,3611,46940,54165,7225
9009,0.0,0.0,0.0,3611,46944,54165,7221
9010,0.0,0.0,0.0,3611,46948,54165,7217
9012,0.0,0.0,0.0,3611,46952,54165,7213
9013,0.0,0.0,0.0,3611,46956,54165,7209
9014,0.0,0.0,0.0,3611,46960,54165,7205
9015,0.0,0.0,0.0,3611,46964,54165,7201
9016,0.0,0.0,0.0,3611,46968,54165,7197
9018,0.0,0.0,0.0,3611,46972,54165,7193
9019,0.0,0.0,0.0,3611,46976,54165,7189
9026,0.0,0.0,0.0,3611,46980,54165,7185
9027,0.0,0.0,0.0,3611,46984,54165,7181
9029,0.0,0.0,0.0,3611,46988,54165,7177
9030,0.0,0.0,0.0,3611,46992,54165,7173
9031,0.0,0.0,0.0,3611,46996,54165,7169
9032,0.0,0.0,0.0,3611,47000,54165,7165
9033,0.0,0.0,0.0,3611,47004,54165,7161
9034,0.0,0.0,0.0,3611,47008,54165,7157
9038,0.0,0.0,0.0,3611,47012,54165,7153
9039,0.0,0.0,0.0,3611,47016,54165,7149
9040,0.0,0.0,0.0,3611,47020,54165,7145
9041,0.0,0.0,0.0,3611,47024,54165,7141
9042,0.0,0.0,0.0,3611,47028,54165,7137
9044,0.0,0.0,0.0,3611,47032,54165,7133
9047,0.0,0.0,0.0,3611,47036,54165,7129
9048,0.0,0.0,0.0,3611,47040,54165,7125
9049,0.0,0.0,0.0,3611,47044,54165,7121
9050,0.0,0.0,0.0,3611,47048,54165,7117
9051,0.0,0.0,0.0,3611,47052,54165,7113
9052,0.0,0.0,0.0,3611,47056,54165,7109
9053,0.0,0.0,0.0,3611,47060,54165,7105
9054,0.0,0.0,0.0,3611,47064,54165,7101
9055,0.0,0.0,0.0,3611,47068,54165,7097
9056,0.0,0.0,0.0,3611,47072,54165,7093
9057,0.0,0.0,0.0,3611,47076,54165,7089
9058,0.0,0.0,0.0,3611,47080,54165,7085
9059,0.0,0.0,0.0,3611,47084,54165,7081
9060,0.0,0.0,0.0,3611,47088,54165,7077
9066,0.0,0.0,0.0,3611,47092,54165,7073
9068,0.0,0.0,0.0,3611,47096,54165,7069
9069,0.0,0.0,0.0,3611,47100,54165,7065
9071,0.0,0.0,0.0,3611,47104,54165,7061
9072,0.0,0.0,0.0,3611,47108,54165,7057
9073,0.0,0.0,0.0,3611,47112,54165,7053
9074,0.0,0.0,0.0,3611,47116,54165,7049
9075,0.0,0.0,0.0,3611,47120,54165,7045
9076,0.0,0.0,0.0,3611,47124,54165,7041
9077,0.0,0.0,0.0,3611,47128,54165,7037
9078,0.0,0.0,0.0,3611,47132,54165,7033
9079,0.0,0.0,0.0,3611,47136,54165,7029
9081,0.0,0.0,0.0,3611,47140,54165,7025
9082,0.0,0.0,0.0,3611,47144,54165,7021
9083,0.0,0.0,0.0,3611,47148,54165,7017
9085,0.0,0.0,0.0,3611,47152,54165,7013
9086,0.0,0.0,0.0,3611,47156,54165,7009
9087,0.0,0.0,0.0,3611,47160,54165,7005
9089,0.0,0.0,0.0,3611,47164,54165,7001
9091,0.0,0.0,0.0,3611,47168,54165,6997
9094,0.0,0.0,0.0,3611,47172,54165,6993
9095,0.0,0.0,0.0,3611,47176,54165,6989
9096,0.0,0.0,0.0,3611,47180,54165,6985
9097,0.0,0.0,0.0,3611,47184,54165,6981
9098,0.0,0.0,0.0,3611,47188,54165,6977
9099,0.0,0.0,0.0,3611,47192,54165,6973
9100,0.0,0.0,0.0,3611,47196,54165,6969
9101,0.0,0.0,0.0,3611,47200,54165,6965
9102,0.0,0.0,0.0,3611,47204,54165,6961
9103,0.0,0.0,0.0,3611,47208,54165,6957
9104,0.0,0.0,0.0,3611,47212,54165,6953
9105,0.0,0.0,0.0,3611,47216,54165,6949
9106,0.0,0.0,0.0,3611,47220,54165,6945
9110,0.0,0.0,0.0,3611,47224,54165,6941
9113,0.0,0.0,0.0,3611,47228,54165,6937
9115,0.0,0.0,0.0,3611,47232,54165,6933
9117,0.0,0.0,0.0,3611,47236,54165,6929
9118,0.0,0.0,0.0,3611,47240,54165,6925
9119,0.0,0.0,0.0,3611,47244,54165,6921
9120,0.0,0.0,0.0,3611,47248,54165,6917
9122,0.0,0.0,0.0,3611,47252,54165,6913
9123,0.0,0.0,0.0,3611,47256,54165,6909
9124,0.0,0.0,0.0,3611,47260,54165,6905
9125,0.0,0.0,0.0,3611,47264,54165,6901
9127,0.0,0.0,0.0,3611,47268,54165,6897
9128,0.0,0.0,0.0,3611,47272,54165,6893
9129,0.0,0.0,0.0,3611,47276,54165,6889
9131,0.0,0.0,0.0,3611,47280,54165,6885
9132,0.0,0.0,0.0,3611,47284,54165,6881
9134,0.0,0.0,0.0,3611,47288,54165,6877
9137,0.0,0.0,0.0,3611,47292,54165,6873
9138,0.0,0.0,0.0,3611,47296,54165,6869
9140,0.0,0.0,0.0,3611,47300,54165,6865
9141,0.0,0.0,0.0,3611,47304,54165,6861
9143,0.0,0.0,0.0,3611,47308,54165,6857
9144,0.0,0.0,0.0,3611,47312,54165,6853
9145,0.0,0.0,0.0,3611,47316,54165,6849
9146,0.0,0.0,0.0,3611,47320,54165,6845
9147,0.0,0.0,0.0,3611,47324,54165,6841
9148,0.0,0.0,0.0,3611,47328,54165,6837
9149,0.0,0.0,0.0,3611,47332,54165,6833
9151,0.0,0.0,0.0,3611,47336,54165,6829
9152,0.0,0.0,0.0,3611,47340,54165,6825
9154,0.0,0.0,0.0,3611,47344,54165,6821
9155,0.0,0.0,0.0,3611,47348,54165,6817
9156,0.0,0.0,0.0,3611,47352,54165,6813
9158,0.0,0.0,0.0,3611,47356,54165,6809
9162,0.0,0.0,0.0,3611,47360,54165,6805
9163,0.0,0.0,0.0,3611,47364,54165,6801
9164,0.0,0.0,0.0,3611,47368,54165,6797
9165,0.0,0.0,0.0,3611,47372,54165,6793
9166,0.0,0.0,0.0,3611,47376,54165,6789
9167,0.0,0.0,0.0,3611,47380,54165,6785
9168,0.0,0.0,0.0,3611,47384,54165,6781
9169,0.0,0.0,0.0,3611,47388,54165,6777
9170,0.0,0.0,0.0,3611,47392,54165,6773
9171,0.0,0.0,0.0,3611,47396,54165,6769
9172,0.0,0.0,0.0,3611,47400,54165,6765
9174,0.0,0.0,0.0,3611,47404,54165,6761
9176,0.0,0.0,0.0,3611,47408,54165,6757
9177,0.0,0.0,0.0,3611,47412,54165,6753
9178,0.0,0.0,0.0,3611,47416,54165,6749
9179,0.0,0.0,0.0,3611,47420,54165,6745
9181,0.0,0.0,0.0,3611,47424,54165,6741
9182,0.0,0.0,0.0,3611,47428,54165,6737
9183,0.0,0.0,0.0,3611,47432,54165,6733
9184,0.0,0.0,0.0,3611,47436,54165,6729
9186,0.0,0.0,0.0,3611,47440,54165,6725
9188,0.0,0.0,0.0,3611,47444,54165,6721
9189,0.0,0.0,0.0,3611,47448,54165,6717
9190,0.0,0.0,0.0,3611,47452,54165,6713
9191,0.0,0.0,0.0,3611,47456,54165,6709
9192,0.0,0.0,0.0,3611,47460,54165,6705
9193,0.0,0.0,0.0,3611,47464,54165,6701
9194,0.0,0.0,0.0,3611,47468,54165,6697
9195,0.0,0.0,0.0,3611,47472,54165,6693
9196,0.0,0.0,0.0,3611,47476,54165,6689
9197,0.0,0.0,0.0,3611,47480,54165,6685
9198,0.0,0.0,0.0,3611,47484,54165,6681
9201,0.0,0.0,0.0,3611,47488,54165,6677
9203,0.0,0.0,0.0,3611,47492,54165,6673
9204,0.0,0.0,0.0,3611,47496,54165,6669
9205,0.0,0.0,0.0,3611,47500,54165,6665
9206,0.0,0.0,0.0,3611,47504,54165,6661
9207,0.0,0.0,0.0,3611,47508,54165,6657
9208,0.0,0.0,0.0,3611,47512,54165,6653
9209,0.0,0.0,0.0,3611,47516,54165,6649
9210,0.0,0.0,0.0,3611,47520,54165,6645
9211,0.0,0.0,0.0,3611,47524,54165,6641
9213,0.0,0.0,0.0,3611,47528,54165,6637
9215,0.0,0.0,0.0,3611,47532,54165,6633
9216,0.0,0.0,0.0,3611,47536,54165,6629
9217,0.0,0.0,0.0,3611,47540,54165,6625
9218,0.0,0.0,0.0,3611,47544,54165,6621
9220,0.0,0.0,0.0,3611,47548,54165,6617
9221,0.0,0.0,0.0,3611,47552,54165,6613
9222,0.0,0.0,0.0,3611,47556,54165,6609
9224,0.0,0.0,0.0,3611,47560,54165,6605
9225,0.0,0.0,0.0,3611,47564,54165,6601
9226,0.0,0.0,0.0,3611,47568,54165,6597
9227,0.0,0.0,0.0,3611,47572,54165,6593
9228,0.0,0.0,0.0,3611,47576,54165,6589
9229,0.0,0.0,0.0,3611,47580,54165,6585
9230,0.0,0.0,0.0,3611,47584,54165,6581
9231,0.0,0.0,0.0,3611,47588,54165,6577
9233,0.0,0.0,0.0,3611,47592,54165,6573
9234,0.0,0.0,0.0,3611,47596,54165,6569
9235,0.0,0.0,0.0,3611,47600,54165,6565
9238,0.0,0.0,0.0,3611,47604,54165,6561
9239,0.0,0.0,0.0,3611,47608,54165,6557
9241,0.0,0.0,0.0,3611,47612,54165,6553
9242,0.0,0.0,0.0,3611,47616,54165,6549
9244,0.0,0.0,0.0,3611,47620,54165,6545
9245,0.0,0.0,0.0,3611,47624,54165,6541
9246,0.0,0.0,0.0,3611,47628,54165,6537
9247,0.0,0.0,0.0,3611,47632,54165,6533
9248,0.0,0.0,0.0,3611,47636,54165,6529
9251,0.0,0.0,0.0,3611,47640,54165,6525
9252,0.0,0.0,0.0,3611,47644,54165,6521
9253,0.0,0.0,0.0,3611,47648,54165,6517
9254,0.0,0.0,0.0,3611,47652,54165,6513
9255,0.0,0.0,0.0,3611,47656,54165,6509
9256,0.0,0.0,0.0,3611,47660,54165,6505
9259,0.0,0.0,0.0,3611,47664,54165,6501
9262,0.0,0.0,0.0,3611,47668,54165,6497
9263,0.0,0.0,0.0,3611,47672,54165,6493
9264,0.0,0.0,0.0,3611,47676,54165,6489
9265,0.0,0.0,0.0,3611,47680,54165,6485
9266,0.0,0.0,0.0,3611,47684,54165,6481
9271,0.0,0.0,0.0,3611,47688,54165,6477
9272,0.0,0.0,0.0,3611,47692,54165,6473
9273,0.0,0.0,0.0,3611,47696,54165,6469
9274,0.0,0.0,0.0,3611,47700,54165,6465
9275,0.0,0.0,0.0,3611,47704,54165,6461
9276,0.0,0.0,0.0,3611,47708,54165,6457
9277,0.0,0.0,0.0,3611,47712,54165,6453
9279,0.0,0.0,0.0,3611,47716,54165,6449
9280,0.0,0.0,0.0,3611,47720,54165,6445
9281,0.0,0.0,0.0,3611,47724,54165,6441
9282,0.0,0.0,0.0,3611,47728,54165,6437
9284,0.0,0.0,0.0,3611,47732,54165,6433
9285,0.0,0.0,0.0,3611,47736,54165,6429
9288,0.0,0.0,0.0,3611,47740,54165,6425
9289,0.0,0.0,0.0,3611,47744,54165,6421
9290,0.0,0.0,0.0,3611,47748,54165,6417
9292,0.0,0.0,0.0,3611,47752,54165,6413
9296,0.0,0.0,0.0,3611,47756,54165,6409
9297,0.0,0.0,0.0,3611,47760,54165,6405
9298,0.0,0.0,0.0,3611,47764,54165,6401
9299,0.0,0.0,0.0,3611,47768,54165,6397
9300,0.0,0.0,0.0,3611,47772,54165,6393
9301,0.0,0.0,0.0,3611,47776,54165,6389
9302,0.0,0.0,0.0,3611,47780,54165,6385
9304,0.0,0.0,0.0,3611,47784,54165,6381
9305,0.0,0.0,0.0,3611,47788,54165,6377
9307,0.0,0.0,0.0,3611,47792,54165,6373
9309,0.0,0.0,0.0,3611,47796,54165,6369
9311,0.0,0.0,0.0,3611,47800,54165,6365
9312,0.0,0.0,0.0,3611,47804,54165,6361
9313,0.0,0.0,0.0,3611,47808,54165,6357
9314,0.0,0.0,0.0,3611,47812,54165,6353
9316,0.0,0.0,0.0,3611,47816,54165,6349
9317,0.0,0.0,0.0,3611,47820,54165,6345
9318,0.0,0.0,0.0,3611,47824,54165,6341
9320,0.0,0.0,0.0,3611,47828,54165,6337
9321,0.0,0.0,0.0,3611,47832,54165,6333
9322,0.0,0.0,0.0,3611,47836,54165,6329
9323,0.0,0.0,0.0,3611,47840,54165,6325
9324,0.0,0.0,0.0,3611,47844,54165,6321
9325,0.0,0.0,0.0,3611,47848,54165,6317
9330,0.0,0.0,0.0,3611,47852,54165,6313
9332,0.0,0.0,0.0,3611,47856,54165,6309
9335,0.0,0.0,0.0,3611,47860,54165,6305
9336,0.0,0.0,0.0,3611,47864,54165,6301
9338,0.0,0.0,0.0,3611,47868,54165,6297
9342,0.0,0.0,0.0,3611,47872,54165,6293
9343,0.0,0.0,0.0,3611,47876,54165,6289
9345,0.0,0.0,0.0,3611,47880,54165,6285
9346,0.0,0.0,0.0,3611,47884,54165,6281
9347,0.0,0.0,0.0,3611,47888,54165,6277
9349,0.0,0.0,0.0,3611,47892,54165,6273
9351,0.0,0.0,0.0,3611,47896,54165,6269
9352,0.0,0.0,0.0,3611,47900,54165,6265
9354,0.0,0.0,0.0,3611,47904,54165,6261
9355,0.0,0.0,0.0,3611,47908,54165,6257
9356,0.0,0.0,0.0,3611,47912,54165,6253
9357,0.0,0.0,0.0,3611,47916,54165,6249
9358,0.0,0.0,0.0,3611,47920,54165,6245
9359,0.0,0.0,0.0,3611,47924,54165,6241
9360,0.0,0.0,0.0,3611,47928,54165,6237
9361,0.0,0.0,0.0,3611,47932,54165,6233
9362,0.0,0.0,0.0,3611,47936,54165,6229
9363,0.0,0.0,0.0,3611,47940,54165,6225
9364,0.0,0.0,0.0,3611,47944,54165,6221
9365,0.0,0.0,0.0,3611,47948,54165,6217
9366,0.0,0.0,0.0,3611,47952,54165,6213
9367,0.0,0.0,0.0,3611,47956,54165,6209
9368,0.0,0.0,0.0,3611,47960,54165,6205
9369,0.0,0.0,0.0,3611,47964,54165,6201
9370,0.0,0.0,0.0,3611,47968,54165,6197
9371,0.0,0.0,0.0,3611,47972,54165,6193
9373,0.0,0.0,0.0,3611,47976,54165,6189
9374,0.0,0.0,0.0,3611,47980,54165,6185
9375,0.0,0.0,0.0,3611,47984,54165,6181
9377,0.0,0.0,0.0,3611,47988,54165,6177
9379,0.0,0.0,0.0,3611,47992,54165,6173
9380,0.0,0.0,0.0,3611,47996,54165,6169
9381,0.0,0.0,0.0,3611,48000,54165,6165
9382,0.0,0.0,0.0,3611,48004,54165,6161
9383,0.0,0.0,0.0,3611,48008,54165,6157
9384,0.0,0.0,0.0,3611,48012,54165,6153
9386,0.0,0.0,0.0,3611,48016,54165,6149
9387,0.0,0.0,0.0,3611,48020,54165,6145
9388,0.0,0.0,0.0,3611,48024,54165,6141
9389,0.0,0.0,0.0,3611,48028,54165,6137
9390,0.0,0.0,0.0,3611,48032,54165,6133
9392,0.0,0.0,0.0,3611,48036,54165,6129
9393,0.0,0.0,0.0,3611,48040,54165,6125
9396,0.0,0.0,0.0,3611,48044,54165,6121
9397,0.0,0.0,0.0,3611,48048,54165,6117
9398,0.0,0.0,0.0,3611,48052,54165,6113
9400,0.0,0.0,0.0,3611,48056,54165,6109
9401,0.0,0.0,0.0,3611,48060,54165,6105
9402,0.0,0.0,0.0,3611,48064,54165,6101
9403,0.0,0.0,0.0,3611,48068,54165,6097
9408,0.0,0.0,0.0,3611,48072,54165,6093
9409,0.0,0.0,0.0,3611,48076,54165,6089
9410,0.0,0.0,0.0,3611,48080,54165,6085
9413,0.0,0.0,0.0,3611,48084,54165,6081
9418,0.0,0.0,0.0,3611,48088,54165,6077
9420,0.0,0.0,0.0,3611,48092,54165,6073
9421,0.0,0.0,0.0,3611,48096,54165,6069
9422,0.0,0.0,0.0,3611,48100,54165,6065
9423,0.0,0.0,0.0,3611,48104,54165,6061
9424,0.0,0.0,0.0,3611,48108,54165,6057
9425,0.0,0.0,0.0,3611,48112,54165,6053
9426,0.0,0.0,0.0,3611,48116,54165,6049
9428,0.0,0.0,0.0,3611,48120,54165,6045
9430,0.0,0.0,0.0,3611,48124,54165,6041
9431,0.0,0.0,0.0,3611,48128,54165,6037
9432,0.0,0.0,0.0,3611,48132,54165,6033
9433,0.0,0.0,0.0,3611,48136,54165,6029
9434,0.0,0.0,0.0,3611,48140,54165,6025
9435,0.0,0.0,0.0,3611,48144,54165,6021
9436,0.0,0.0,0.0,3611,48148,54165,6017
9437,0.0,0.0,0.0,3611,48152,54165,6013
9440,0.0,0.0,0.0,3611,48156,54165,6009
9442,0.0,0.0,0.0,3611,48160,54165,6005
9443,0.0,0.0,0.0,3611,48164,54165,6001
9444,0.0,0.0,0.0,3611,48168,54165,5997
9445,0.0,0.0,0.0,3611,48172,54165,5993
9446,0.0,0.0,0.0,3611,48176,54165,5989
9448,0.0,0.0,0.0,3611,48180,54165,5985
9449,0.0,0.0,0.0,3611,48184,54165,5981
9450,0.0,0.0,0.0,3611,48188,54165,5977
9451,0.0,0.0,0.0,3611,48192,54165,5973
9452,0.0,0.0,0.0,3611,48196,54165,5969
9453,0.0,0.0,0.0,3611,48200,54165,5965
9454,0.0,0.0,0.0,3611,48204,54165,5961
9455,0.0,0.0,0.0,3611,48208,54165,5957
9456,0.0,0.0,0.0,3611,48212,54165,5953
9457,0.0,0.0,0.0,3611,48216,54165,5949
9458,0.0,0.0,0.0,3611,48220,54165,5945
9459,0.0,0.0,0.0,3611,48224,54165,5941
9460,0.0,0.0,0.0,3611,48228,54165,5937
9461,0.0,0.0,0.0,3611,48232,54165,5933
9462,0.0,0.0,0.0,3611,48236,54165,5929
9464,0.0,0.0,0.0,3611,48240,54165,5925
9466,0.0,0.0,0.0,3611,48244,54165,5921
9467,0.0,0.0,0.0,3611,48248,54165,5917
9468,0.0,0.0,0.0,3611,48252,54165,5913
9470,0.0,0.0,0.0,3611,48256,54165,5909
9471,0.0,0.0,0.0,3611,48260,54165,5905
9472,0.0,0.0,0.0,3611,48264,54165,5901
9473,0.0,0.0,0.0,3611,48268,54165,5897
9474,0.0,0.0,0.0,3611,48272,54165,5893
9475,0.0,0.0,0.0,3611,48276,54165,5889
9476,0.0,0.0,0.0,3611,48280,54165,5885
9477,0.0,0.0,0.0,3611,48284,54165,5881
9478,0.0,0.0,0.0,3611,48288,54165,5877
9480,0.0,0.0,0.0,3611,48292,54165,5873
9481,0.0,0.0,0.0,3611,48296,54165,5869
9483,0.0,0.0,0.0,3611,48300,54165,5865
9484,0.0,0.0,0.0,3611,48304,54165,5861
9485,0.0,0.0,0.0,3611,48308,54165,5857
9486,0.0,0.0,0.0,3611,48312,54165,5853
9487,0.0,0.0,0.0,3611,48316,54165,5849
9488,0.0,0.0,0.0,3611,48320,54165,5845
9489,0.0,0.0,0.0,3611,48324,54165,5841
9490,0.0,0.0,0.0,3611,48328,54165,5837
9491,0.0,0.0,0.0,3611,48332,54165,5833
9493,0.0,0.0,0.0,3611,48336,54165,5829
9494,0.0,0.0,0.0,3611,48340,54165,5825
9496,0.0,0.0,0.0,3611,48344,54165,5821
9497,0.0,0.0,0.0,3611,48348,54165,5817
9498,0.0,0.0,0.0,3611,48352,54165,5813
9499,0.0,0.0,0.0,3611,48356,54165,5809
9500,0.0,0.0,0.0,3611,48360,54165,5805
9502,0.0,0.0,0.0,3611,48364,54165,5801
9503,0.0,0.0,0.0,3611,48368,54165,5797
9504,0.0,0.0,0.0,3611,48372,54165,5793
9505,0.0,0.0,0.0,3611,48376,54165,5789
9506,0.0,0.0,0.0,3611,48380,54165,5785
9507,0.0,0.0,0.0,3611,48384,54165,5781
9510,0.0,0.0,0.0,3611,48388,54165,5777
9511,0.0,0.0,0.0,3611,48392,54165,5773
9512,0.0,0.0,0.0,3611,48396,54165,5769
9513,0.0,0.0,0.0,3611,48400,54165,5765
9514,0.0,0.0,0.0,3611,48404,54165,5761
9516,0.0,0.0,0.0,3611,48408,54165,5757
9517,0.0,0.0,0.0,3611,48412,54165,5753
9519,0.0,0.0,0.0,3611,48416,54165,5749
9520,0.0,0.0,0.0,3611,48420,54165,5745
9521,0.0,0.0,0.0,3611,48424,54165,5741
9522,0.0,0.0,0.0,3611,48428,54165,5737
9523,0.0,0.0,0.0,3611,48432,54165,5733
9524,0.0,0.0,0.0,3611,48436,54165,5729
9526,0.0,0.0,0.0,3611,48440,54165,5725
9527,0.0,0.0,0.0,3611,48444,54165,5721
9528,0.0,0.0,0.0,3611,48448,54165,5717
9529,0.0,0.0,0.0,3611,48452,54165,5713
9530,0.0,0.0,0.0,3611,48456,54165,5709
9532,0.0,0.0,0.0,3611,48460,54165,5705
9533,0.0,0.0,0.0,3611,48464,54165,5701
9534,0.0,0.0,0.0,3611,48468,54165,5697
9535,0.0,0.0,0.0,3611,48472,54165,5693
9536,0.0,0.0,0.0,3611,48476,54165,5689
9538,0.0,0.0,0.0,3611,48480,54165,5685
9539,0.0,0.0,0.0,3611,48484,54165,5681
9541,0.0,0.0,0.0,3611,48488,54165,5677
9543,0.0,0.0,0.0,3611,48492,54165,5673
9544,0.0,0.0,0.0,3611,48496,54165,5669
9545,0.0,0.0,0.0,3611,48500,54165,5665
9546,0.0,0.0,0.0,3611,48504,54165,5661
9547,0.0,0.0,0.0,3611,48508,54165,5657
9549,0.0,0.0,0.0,3611,48512,54165,5653
9550,0.0,0.0,0.0,3611,48516,54165,5649
9551,0.0,0.0,0.0,3611,48520,54165,5645
9553,0.0,0.0,0.0,3611,48524,54165,5641
9554,0.0,0.0,0.0,3611,48528,54165,5637
9555,0.0,0.0,0.0,3611,48532,54165,5633
9556,0.0,0.0,0.0,3611,48536,54165,5629
9557,0.0,0.0,0.0,3611,48540,54165,5625
9558,0.0,0.0,0.0,3611,48544,54165,5621
9559,0.0,0.0,0.0,3611,48548,54165,5617
9561,0.0,0.0,0.0,3611,48552,54165,5613
9562,0.0,0.0,0.0,3611,48556,54165,5609
9563,0.0,0.0,0.0,3611,48560,54165,5605
9564,0.0,0.0,0.0,3611,48564,54165,5601
9565,0.0,0.0,0.0,3611,48568,54165,5597
9566,0.0,0.0,0.0,3611,48572,54165,5593
9567,0.0,0.0,0.0,3611,48576,54165,5589
9568,0.0,0.0,0.0,3611,48580,54165,5585
9569,0.0,0.0,0.0,3611,48584,54165,5581
9570,0.0,0.0,0.0,3611,48588,54165,5577
9572,0.0,0.0,0.0,3611,48592,54165,5573
9573,0.0,0.0,0.0,3611,48596,54165,5569
9574,0.0,0.0,0.0,3611,48600,54165,5565
9575,0.0,0.0,0.0,3611,48604,54165,5561
9576,0.0,0.0,0.0,3611,48608,54165,5557
9577,0.0,0.0,0.0,3611,48612,54165,5553
9581,0.0,0.0,0.0,3611,48616,54165,5549
9582,0.0,0.0,0.0,3611,48620,54165,5545
9583,0.0,0.0,0.0,3611,48624,54165,5541
9584,0.0,0.0,0.0,3611,48628,54165,5537
9585,0.0,0.0,0.0,3611,48632,54165,5533
9587,0.0,0.0,0.0,3611,48636,54165,5529
9588,0.0,0.0,0.0,3611,48640,54165,5525
9590,0.0,0.0,0.0,3611,48644,54165,5521
9591,0.0,0.0,0.0,3611,48648,54165,5517
9592,0.0,0.0,0.0,3611,48652,54165,5513
9593,0.0,0.0,0.0,3611,48656,54165,5509
9594,0.0,0.0,0.0,3611,48660,54165,5505
9595,0.0,0.0,0.0,3611,48664,54165,5501
9596,0.0,0.0,0.0,3611,48668,54165,5497
9597,0.0,0.0,0.0,3611,48672,54165,5493
9598,0.0,0.0,0.0,3611,48676,54165,5489
9599,0.0,0.0,0.0,3611,48680,54165,5485
9600,0.0,0.0,0.0,3611,48684,54165,5481
9601,0.0,0.0,0.0,3611,48688,54165,5477
9602,0.0,0.0,0.0,3611,48692,54165,5473
9603,0.0,0.0,0.0,3611,48696,54165,5469
9604,0.0,0.0,0.0,3611,48700,54165,5465
9605,0.0,0.0,0.0,3611,48704,54165,5461
9608,0.0,0.0,0.0,3611,48708,54165,5457
9609,0.0,0.0,0.0,3611,48712,54165,5453
9610,0.0,0.0,0.0,3611,48716,54165,5449
9611,0.0,0.0,0.0,3611,48720,54165,5445
9612,0.0,0.0,0.0,3611,48724,54165,5441
9614,0.0,0.0,0.0,3611,48728,54165,5437
9615,0.0,0.0,0.0,3611,48732,54165,5433
9616,0.0,0.0,0.0,3611,48736,54165,5429
9618,0.0,0.0,0.0,3611,48740,54165,5425
9619,0.0,0.0,0.0,3611,48744,54165,5421
9620,0.0,0.0,0.0,3611,48748,54165,5417
9621,0.0,0.0,0.0,3611,48752,54165,5413
9622,0.0,0.0,0.0,3611,48756,54165,5409
9623,0.0,0.0,0.0,3611,48760,54165,5405
9624,0.0,0.0,0.0,3611,48764,54165,5401
9625,0.0,0.0,0.0,3611,48768,54165,5397
9628,0.0,0.0,0.0,3611,48772,54165,5393
9629,0.0,0.0,0.0,3611,48776,54165,5389
9630,0.0,0.0,0.0,3611,48780,54165,5385
9631,0.0,0.0,0.0,3611,48784,54165,5381
9632,0.0,0.0,0.0,3611,48788,54165,5377
9633,0.0,0.0,0.0,3611,48792,54165,5373
9634,0.0,0.0,0.0,3611,48796,54165,5369
9635,0.0,0.0,0.0,3611,48800,54165,5365
9637,0.0,0.0,0.0,3611,48804,54165,5361
9639,0.0,0.0,0.0,3611,48808,54165,5357
9640,0.0,0.0,0.0,3611,48812,54165,5353
9641,0.0,0.0,0.0,3611,48816,54165,5349
9642,0.0,0.0,0.0,3611,48820,54165,5345
9643,0.0,0.0,0.0,3611,48824,54165,5341
9644,0.0,0.0,0.0,3611,48828,54165,5337
9645,0.0,0.0,0.0,3611,48832,54165,5333
9646,0.0,0.0,0.0,3611,48836,54165,5329
9647,0.0,0.0,0.0,3611,48840,54165,5325
9648,0.0,0.0,0.0,3611,48844,54165,5321
9649,0.0,0.0,0.0,3611,48848,54165,5317
9651,0.0,0.0,0.0,3611,48852,54165,5313
9653,0.0,0.0,0.0,3611,48856,54165,5309
9655,0.0,0.0,0.0,3611,48860,54165,5305
9656,0.0,0.0,0.0,3611,48864,54165,5301
9657,0.0,0.0,0.0,3611,48868,54165,5297
9659,0.0,0.0,0.0,3611,48872,54165,5293
9660,0.0,0.0,0.0,3611,48876,54165,5289
9661,0.0,0.0,0.0,3611,48880,54165,5285
9662,0.0,0.0,0.0,3611,48884,54165,5281
9663,0.0,0.0,0.0,3611,48888,54165,5277
9664,0.0,0.0,0.0,3611,48892,54165,5273
9665,0.0,0.0,0.0,3611,48896,54165,5269
9666,0.0,0.0,0.0,3611,48900,54165,5265
9671,0.0,0.0,0.0,3611,48904,54165,5261
9673,0.0,0.0,0.0,3611,48908,54165,5257
9674,0.0,0.0,0.0,3611,48912,54165,5253
9675,0.0,0.0,0.0,3611,48916,54165,5249
9676,0.0,0.0,0.0,3611,48920,54165,5245
9677,0.0,0.0,0.0,3611,48924,54165,5241
9678,0.0,0.0,0.0,3611,48928,54165,5237
9679,0.0,0.0,0.0,3611,48932,54165,5233
9680,0.0,0.0,0.0,3611,48936,54165,5229
9682,0.0,0.0,0.0,3611,48940,54165,5225
9683,0.0,0.0,0.0,3611,48944,54165,5221
9684,0.0,0.0,0.0,3611,48948,54165,5217
9685,0.0,0.0,0.0,3611,48952,54165,5213
9686,0.0,0.0,0.0,3611,48956,54165,5209
9688,0.0,0.0,0.0,3611,48960,54165,5205
9689,0.0,0.0,0.0,3611,48964,54165,5201
9690,0.0,0.0,0.0,3611,48968,54165,5197
9691,0.0,0.0,0.0,3611,48972,54165,5193
9692,0.0,0.0,0.0,3611,48976,54165,5189
9693,0.0,0.0,0.0,3611,48980,54165,5185
9694,0.0,0.0,0.0,3611,48984,54165,5181
9695,0.0,0.0,0.0,3611,48988,54165,5177
9696,0.0,0.0,0.0,3611,48992,54165,5173
9698,0.0,0.0,0.0,3611,48996,54165,5169
9699,0.0,0.0,0.0,3611,49000,54165,5165
9700,0.0,0.0,0.0,3611,49004,54165,5161
9701,0.0,0.0,0.0,3611,49008,54165,5157
9704,0.0,0.0,0.0,3611,49012,54165,5153
9705,0.0,0.0,0.0,3611,49016,54165,5149
9706,0.0,0.0,0.0,3611,49020,54165,5145
9707,0.0,0.0,0.0,3611,49024,54165,5141
9709,0.0,0.0,0.0,3611,49028,54165,5137
9710,0.0,0.0,0.0,3611,49032,54165,5133
9711,0.0,0.0,0.0,3611,49036,54165,5129
9712,0.0,0.0,0.0,3611,49040,54165,5125
9713,0.0,0.0,0.0,3611,49044,54165,5121
9714,0.0,0.0,0.0,3611,49048,54165,5117
9715,0.0,0.0,0.0,3611,49052,54165,5113
9717,0.0,0.0,0.0,3611,49056,54165,5109
9718,0.0,0.0,0.0,3611,49060,54165,5105
9720,0.0,0.0,0.0,3611,49064,54165,5101
9721,0.0,0.0,0.0,3611,49068,54165,5097
9722,0.0,0.0,0.0,3611,49072,54165,5093
9723,0.0,0.0,0.0,3611,49076,54165,5089
9724,0.0,0.0,0.0,3611,49080,54165,5085
9725,0.0,0.0,0.0,3611,49084,54165,5081
9726,0.0,0.0,0.0,3611,49088,54165,5077
9727,0.0,0.0,0.0,3611,49092,54165,5073
9728,0.0,0.0,0.0,3611,49096,54165,5069
9729,0.0,0.0,0.0,3611,49100,54165,5065
9730,0.0,0.0,0.0,3611,49104,54165,5061
9731,0.0,0.0,0.0,3611,49108,54165,5057
9732,0.0,0.0,0.0,3611,49112,54165,5053
9733,0.0,0.0,0.0,3611,49116,54165,5049
9734,0.0,0.0,0.0,3611,49120,54165,5045
9735,0.0,0.0,0.0,3611,49124,54165,5041
9737,0.0,0.0,0.0,3611,49128,54165,5037
9738,0.0,0.0,0.0,3611,49132,54165,5033
9739,0.0,0.0,0.0,3611,49136,54165,5029
9740,0.0,0.0,0.0,3611,49140,54165,5025
9744,0.0,0.0,0.0,3611,49144,54165,5021
9745,0.0,0.0,0.0,3611,49148,54165,5017
9746,0.0,0.0,0.0,3611,49152,54165,5013
9747,0.0,0.0,0.0,3611,49156,54165,5009
9748,0.0,0.0,0.0,3611,49160,54165,5005
9750,0.0,0.0,0.0,3611,49164,54165,5001
9751,0.0,0.0,0.0,3611,49168,54165,4997
9752,0.0,0.0,0.0,3611,49172,54165,4993
9754,0.0,0.0,0.0,3611,49176,54165,4989
9756,0.0,0.0,0.0,3611,49180,54165,4985
9757,0.0,0.0,0.0,3611,49184,54165,4981
9759,0.0,0.0,0.0,3611,49188,54165,4977
9760,0.0,0.0,0.0,3611,49192,54165,4973
9761,0.0,0.0,0.0,3611,49196,54165,4969
9763,0.0,0.0,0.0,3611,49200,54165,4965
9764,0.0,0.0,0.0,3611,49204,54165,4961
9765,0.0,0.0,0.0,3611,49208,54165,4957
9766,0.0,0.0,0.0,3611,49212,54165,4953
9768,0.0,0.0,0.0,3611,49216,54165,4949
9769,0.0,0.0,0.0,3611,49220,54165,4945
9770,0.0,0.0,0.0,3611,49224,54165,4941
9771,0.0,0.0,0.0,3611,49228,54165,4937
9772,0.0,0.0,0.0,3611,49232,54165,4933
9773,0.0,0.0,0.0,3611,49236,54165,4929
9774,0.0,0.0,0.0,3611,49240,54165,4925
9775,0.0,0.0,0.0,3611,49244,54165,4921
9776,0.0,0.0,0.0,3611,49248,54165,4917
9777,0.0,0.0,0.0,3611,49252,54165,4913
9779,0.0,0.0,0.0,3611,49256,54165,4909
9780,0.0,0.0,0.0,3611,49260,54165,4905
9781,0.0,0.0,0.0,3611,49264,54165,4901
9786,0.0,0.0,0.0,3611,49268,54165,4897
9788,0.0,0.0,0.0,3611,49272,54165,4893
9789,0.0,0.0,0.0,3611,49276,54165,4889
9790,0.0,0.0,0.0,3611,49280,54165,4885
9792,0.0,0.0,0.0,3611,49284,54165,4881
9793,0.0,0.0,0.0,3611,49288,54165,4877
9794,0.0,0.0,0.0,3611,49292,54165,4873
9795,0.0,0.0,0.0,3611,49296,54165,4869
9796,0.0,0.0,0.0,3611,49300,54165,4865
9797,0.0,0.0,0.0,3611,49304,54165,4861
9800,0.0,0.0,0.0,3611,49308,54165,4857
9801,0.0,0.0,0.0,3611,49312,54165,4853
9802,0.0,0.0,0.0,3611,49316,54165,4849
9803,0.0,0.0,0.0,3611,49320,54165,4845
9804,0.0,0.0,0.0,3611,49324,54165,4841
9805,0.0,0.0,0.0,3611,49328,54165,4837
9806,0.0,0.0,0.0,3611,49332,54165,4833
9807,0.0,0.0,0.0,3611,49336,54165,4829
9808,0.0,0.0,0.0,3611,49340,54165,4825
9809,0.0,0.0,0.0,3611,49344,54165,4821
9810,0.0,0.0,0.0,3611,49348,54165,4817
9811,0.0,0.0,0.0,3611,49352,54165,4813
9812,0.0,0.0,0.0,3611,49356,54165,4809
9813,0.0,0.0,0.0,3611,49360,54165,4805
9814,0.0,0.0,0.0,3611,49364,54165,4801
9816,0.0,0.0,0.0,3611,49368,54165,4797
9817,0.0,0.0,0.0,3611,49372,54165,4793
9819,0.0,0.0,0.0,3611,49376,54165,4789
9820,0.0,0.0,0.0,3611,49380,54165,4785
9821,0.0,0.0,0.0,3611,49384,54165,4781
9823,0.0,0.0,0.0,3611,49388,54165,4777
9824,0.0,0.0,0.0,3611,49392,54165,4773
9825,0.0,0.0,0.0,3611,49396,54165,4769
9826,0.0,0.0,0.0,3611,49400,54165,4765
9828,0.0,0.0,0.0,3611,49404,54165,4761
9829,0.0,0.0,0.0,3611,49408,54165,4757
9830,0.0,0.0,0.0,3611,49412,54165,4753
9832,0.0,0.0,0.0,3611,49416,54165,4749
9833,0.0,0.0,0.0,3611,49420,54165,4745
9834,0.0,0.0,0.0,3611,49424,54165,4741
9835,0.0,0.0,0.0,3611,49428,54165,4737
9837,0.0,0.0,0.0,3611,49432,54165,4733
9838,0.0,0.0,0.0,3611,49436,54165,4729
9839,0.0,0.0,0.0,3611,49440,54165,4725
9841,0.0,0.0,0.0,3611,49444,54165,4721
9842,0.0,0.0,0.0,3611,49448,54165,4717
9843,0.0,0.0,0.0,3611,49452,54165,4713
9844,0.0,0.0,0.0,3611,49456,54165,4709
9846,0.0,0.0,0.0,3611,49460,54165,4705
9847,0.0,0.0,0.0,3611,49464,54165,4701
9848,0.0,0.0,0.0,3611,49468,54165,4697
9849,0.0,0.0,0.0,3611,49472,54165,4693
9850,0.0,0.0,0.0,3611,49476,54165,4689
9851,0.0,0.0,0.0,3611,49480,54165,4685
9852,0.0,0.0,0.0,3611,49484,54165,4681
9854,0.0,0.0,0.0,3611,49488,54165,4677
9856,0.0,0.0,0.0,3611,49492,54165,4673
9857,0.0,0.0,0.0,3611,49496,54165,4669
9858,0.0,0.0,0.0,3611,49500,54165,4665
9859,0.0,0.0,0.0,3611,49504,54165,4661
9860,0.0,0.0,0.0,3611,49508,54165,4657
9862,0.0,0.0,0.0,3611,49512,54165,4653
9863,0.0,0.0,0.0,3611,49516,54165,4649
9864,0.0,0.0,0.0,3611,49520,54165,4645
9866,0.0,0.0,0.0,3611,49524,54165,4641
9868,0.0,0.0,0.0,3611,49528,54165,4637
9869,0.0,0.0,0.0,3611,49532,54165,4633
9871,0.0,0.0,0.0,3611,49536,54165,4629
9873,0.0,0.0,0.0,3611,49540,54165,4625
9874,0.0,0.0,0.0,3611,49544,54165,4621
9875,0.0,0.0,0.0,3611,49548,54165,4617
9876,0.0,0.0,0.0,3611,49552,54165,4613
9877,0.0,0.0,0.0,3611,49556,54165,4609
9883,0.0,0.0,0.0,3611,49560,54165,4605
9886,0.0,0.0,0.0,3611,49564,54165,4601
9887,0.0,0.0,0.0,3611,49568,54165,4597
9889,0.0,0.0,0.0,3611,49572,54165,4593
9890,0.0,0.0,0.0,3611,49576,54165,4589
9891,0.0,0.0,0.0,3611,49580,54165,4585
9893,0.0,0.0,0.0,3611,49584,54165,4581
9894,0.0,0.0,0.0,3611,49588,54165,4577
9895,0.0,0.0,0.0,3611,49592,54165,4573
9896,0.0,0.0,0.0,3611,49596,54165,4569
9897,0.0,0.0,0.0,3611,49600,54165,4565
9898,0.0,0.0,0.0,3611,49604,54165,4561
9899,0.0,0.0,0.0,3611,49608,54165,4557
9900,0.0,0.0,0.0,3611,49612,54165,4553
9901,0.0,0.0,0.0,3611,49616,54165,4549
9902,0.0,0.0,0.0,3611,49620,54165,4545
9903,0.0,0.0,0.0,3611,49624,54165,4541
9904,0.0,0.0,0.0,3611,49628,54165,4537
9905,0.0,0.0,0.0,3611,49632,54165,4533
9906,0.0,0.0,0.0,3611,49636,54165,4529
9908,0.0,0.0,0.0,3611,49640,54165,4525
9909,0.0,0.0,0.0,3611,49644,54165,4521
9910,0.0,0.0,0.0,3611,49648,54165,4517
9911,0.0,0.0,0.0,3611,49652,54165,4513
9913,0.0,0.0,0.0,3611,49656,54165,4509
9914,0.0,0.0,0.0,3611,49660,54165,4505
9915,0.0,0.0,0.0,3611,49664,54165,4501
9916,0.0,0.0,0.0,3611,49668,54165,4497
9919,0.0,0.0,0.0,3611,49672,54165,4493
9920,0.0,0.0,0.0,3611,49676,54165,4489
9921,0.0,0.0,0.0,3611,49680,54165,4485
9922,0.0,0.0,0.0,3611,49684,54165,4481
9924,0.0,0.0,0.0,3611,49688,54165,4477
9925,0.0,0.0,0.0,3611,49692,54165,4473
9927,0.0,0.0,0.0,3611,49696,54165,4469
9928,0.0,0.0,0.0,3611,49700,54165,4465
9931,0.0,0.0,0.0,3611,49704,54165,4461
9932,0.0,0.0,0.0,3611,49708,54165,4457
9933,0.0,0.0,0.0,3611,49712,54165,4453
9934,0.0,0.0,0.0,3611,49716,54165,4449
9935,0.0,0.0,0.0,3611,49720,54165,4445
9936,0.0,0.0,0.0,3611,49724,54165,4441
9937,0.0,0.0,0.0,3611,49728,54165,4437
9938,0.0,0.0,0.0,3611,49732,54165,4433
9939,0.0,0.0,0.0,3611,49736,54165,4429
9941,0.0,0.0,0.0,3611,49740,54165,4425
9942,0.0,0.0,0.0,3611,49744,54165,4421
9943,0.0,0.0,0.0,3611,49748,54165,4417
9944,0.0,0.0,0.0,3611,49752,54165,4413
9945,0.0,0.0,0.0,3611,49756,54165,4409
9946,0.0,0.0,0.0,3611,49760,54165,4405
9947,0.0,0.0,0.0,3611,49764,54165,4401
9948,0.0,0.0,0.0,3611,49768,54165,4397
9949,0.0,0.0,0.0,3611,49772,54165,4393
9951,0.0,0.0,0.0,3611,49776,54165,4389
9952,0.0,0.0,0.0,3611,49780,54165,4385
9953,0.0,0.0,0.0,3611,49784,54165,4381
9955,0.0,0.0,0.0,3611,49788,54165,4377
9956,0.0,0.0,0.0,3611,49792,54165,4373
9957,0.0,0.0,0.0,3611,49796,54165,4369
9959,0.0,0.0,0.0,3611,49800,54165,4365
9960,0.0,0.0,0.0,3611,49804,54165,4361
9961,0.0,0.0,0.0,3611,49808,54165,4357
9962,0.0,0.0,0.0,3611,49812,54165,4353
9963,0.0,0.0,0.0,3611,49816,54165,4349
9964,0.0,0.0,0.0,3611,49820,54165,4345
9965,0.0,0.0,0.0,3611,49824,54165,4341
9966,0.0,0.0,0.0,3611,49828,54165,4337
9969,0.0,0.0,0.0,3611,49832,54165,4333
9970,0.0,0.0,0.0,3611,49836,54165,4329
9971,0.0,0.0,0.0,3611,49840,54165,4325
9972,0.0,0.0,0.0,3611,49844,54165,4321
9973,0.0,0.0,0.0,3611,49848,54165,4317
9974,0.0,0.0,0.0,3611,49852,54165,4313
9975,0.0,0.0,0.0,3611,49856,54165,4309
9976,0.0,0.0,0.0,3611,49860,54165,4305
9977,0.0,0.0,0.0,3611,49864,54165,4301
9978,0.0,0.0,0.0,3611,49868,54165,4297
9979,0.0,0.0,0.0,3611,49872,54165,4293
9981,0.0,0.0,0.0,3611,49876,54165,4289
9985,0.0,0.0,0.0,3611,49880,54165,4285
9986,0.0,0.0,0.0,3611,49884,54165,4281
9987,0.0,0.0,0.0,3611,49888,54165,4277
9988,0.0,0.0,0.0,3611,49892,54165,4273
9989,0.0,0.0,0.0,3611,49896,54165,4269
9991,0.0,0.0,0.0,3611,49900,54165,4265
9992,0.0,0.0,0.0,3611,49904,54165,4261
9993,0.0,0.0,0.0,3611,49908,54165,4257
9994,0.0,0.0,0.0,3611,49912,54165,4253
9996,0.0,0.0,0.0,3611,49916,54165,4249
9997,0.0,0.0,0.0,3611,49920,54165,4245
9998,0.0,0.0,0.0,3611,49924,54165,4241
9999,0.0,0.0,0.0,3611,49928,54165,4237
10000,0.0,0.0,0.0,3611,49932,54165,4233
10001,0.0,0.0,0.0,3611,49936,54165,4229
10002,0.0,0.0,0.0,3611,49940,54165,4225
10006,0.0,0.0,0.0,3611,49944,54165,4221
10007,0.0,0.0,0.0,3611,49948,54165,4217
10008,0.0,0.0,0.0,3611,49952,54165,4213
10009,0.0,0.0,0.0,3611,49956,54165,4209
10010,0.0,0.0,0.0,3611,49960,54165,4205
10011,0.0,0.0,0.0,3611,49964,54165,4201
10013,0.0,0.0,0.0,3611,49968,54165,4197
10014,0.0,0.0,0.0,3611,49972,54165,4193
10017,0.0,0.0,0.0,3611,49976,54165,4189
10019,0.0,0.0,0.0,3611,49980,54165,4185
10020,0.0,0.0,0.0,3611,49984,54165,4181
10021,0.0,0.0,0.0,3611,49988,54165,4177
10022,0.0,0.0,0.0,3611,49992,54165,4173
10023,0.0,0.0,0.0,3611,49996,54165,4169
10024,0.0,0.0,0.0,3611,50000,54165,4165
10026,0.0,0.0,0.0,3611,50004,54165,4161
10027,0.0,0.0,0.0,3611,50008,54165,4157
10028,0.0,0.0,0.0,3611,50012,54165,4153
10029,0.0,0.0,0.0,3611,50016,54165,4149
10031,0.0,0.0,0.0,3611,50020,54165,4145
10032,0.0,0.0,0.0,3611,50024,54165,4141
10033,0.0,0.0,0.0,3611,50028,54165,4137
10034,0.0,0.0,0.0,3611,50032,54165,4133
10035,0.0,0.0,0.0,3611,50036,54165,4129
10037,0.0,0.0,0.0,3611,50040,54165,4125
10038,0.0,0.0,0.0,3611,50044,54165,4121
10039,0.0,0.0,0.0,3611,50048,54165,4117
10042,0.0,0.0,0.0,3611,50052,54165,4113
10043,0.0,0.0,0.0,3611,50056,54165,4109
10044,0.0,0.0,0.0,3611,50060,54165,4105
10045,0.0,0.0,0.0,3611,50064,54165,4101
10047,0.0,0.0,0.0,3611,50068,54165,4097
10048,0.0,0.0,0.0,3611,50072,54165,4093
10050,0.0,0.0,0.0,3611,50076,54165,4089
10051,0.0,0.0,0.0,3611,50080,54165,4085
10052,0.0,0.0,0.0,3611,50084,54165,4081
10053,0.0,0.0,0.0,3611,50088,54165,4077
10054,0.0,0.0,0.0,3611,50092,54165,4073
10055,0.0,0.0,0.0,3611,50096,54165,4069
10056,0.0,0.0,0.0,3611,50100,54165,4065
10057,0.0,0.0,0.0,3611,50104,54165,4061
10058,0.0,0.0,0.0,3611,50108,54165,4057
10059,0.0,0.0,0.0,3611,50112,54165,4053
10060,0.0,0.0,0.0,3611,50116,54165,4049
10061,0.0,0.0,0.0,3611,50120,54165,4045
10062,0.0,0.0,0.0,3611,50124,54165,4041
10063,0.0,0.0,0.0,3611,50128,54165,4037
10064,0.0,0.0,0.0,3611,50132,54165,4033
10065,0.0,0.0,0.0,3611,50136,54165,4029
10066,0.0,0.0,0.0,3611,50140,54165,4025
10067,0.0,0.0,0.0,3611,50144,54165,4021
10068,0.0,0.0,0.0,3611,50148,54165,4017
10069,0.0,0.0,0.0,3611,50152,54165,4013
10070,0.0,0.0,0.0,3611,50156,54165,4009
10071,0.0,0.0,0.0,3611,50160,54165,4005
10072,0.0,0.0,0.0,3611,50164,54165,4001
10073,0.0,0.0,0.0,3611,50168,54165,3997
10074,0.0,0.0,0.0,3611,50172,54165,3993
10075,0.0,0.0,0.0,3611,50176,54165,3989
10076,0.0,0.0,0.0,3611,50180,54165,3985
10079,0.0,0.0,0.0,3611,50184,54165,3981
10080,0.0,0.0,0.0,3611,50188,54165,3977
10081,0.0,0.0,0.0,3611,50192,54165,3973
10082,0.0,0.0,0.0,3611,50196,54165,3969
10083,0.0,0.0,0.0,3611,50200,54165,3965
10084,0.0,0.0,0.0,3611,50204,54165,3961
10085,0.0,0.0,0.0,3611,50208,54165,3957
10086,0.0,0.0,0.0,3611,50212,54165,3953
10087,0.0,0.0,0.0,3611,50216,54165,3949
10088,0.0,0.0,0.0,3611,50220,54165,3945
10090,0.0,0.0,0.0,3611,50224,54165,3941
10092,0.0,0.0,0.0,3611,50228,54165,3937
10093,0.0,0.0,0.0,3611,50232,54165,3933
10094,0.0,0.0,0.0,3611,50236,54165,3929
10095,0.0,0.0,0.0,3611,50240,54165,3925
10096,0.0,0.0,0.0,3611,50244,54165,3921
10097,0.0,0.0,0.0,3611,50248,54165,3917
10098,0.0,0.0,0.0,3611,50252,54165,3913
10099,0.0,0.0,0.0,3611,50256,54165,3909
10100,0.0,0.0,0.0,3611,50260,54165,3905
10101,0.0,0.0,0.0,3611,50264,54165,3901
10102,0.0,0.0,0.0,3611,50268,54165,3897
10103,0.0,0.0,0.0,3611,50272,54165,3893
10104,0.0,0.0,0.0,3611,50276,54165,3889
10106,0.0,0.0,0.0,3611,50280,54165,3885
10107,0.0,0.0,0.0,3611,50284,54165,3881
10108,0.0,0.0,0.0,3611,50288,54165,3877
10109,0.0,0.0,0.0,3611,50292,54165,3873
10112,0.0,0.0,0.0,3611,50296,54165,3869
10114,0.0,0.0,0.0,3611,50300,54165,3865
10115,0.0,0.0,0.0,3611,50304,54165,3861
10116,0.0,0.0,0.0,3611,50308,54165,3857
10117,0.0,0.0,0.0,3611,50312,54165,3853
10118,0.0,0.0,0.0,3611,50316,54165,3849
10119,0.0,0.0,0.0,3611,50320,54165,3845
10120,0.0,0.0,0.0,3611,50324,54165,3841
10121,0.0,0.0,0.0,3611,50328,54165,3837
10122,0.0,0.0,0.0,3611,50332,54165,3833
10124,0.0,0.0,0.0,3611,50336,54165,3829
10126,0.0,0.0,0.0,3611,50340,54165,3825
10128,0.0,0.0,0.0,3611,50344,54165,3821
10130,0.0,0.0,0.0,3611,50348,54165,3817
10131,0.0,0.0,0.0,3611,50352,54165,3813
10132,0.0,0.0,0.0,3611,50356,54165,3809
10133,0.0,0.0,0.0,3611,50360,54165,3805
10134,0.0,0.0,0.0,3611,50364,54165,3801
10135,0.0,0.0,0.0,3611,50368,54165,3797
10136,0.0,0.0,0.0,3611,50372,54165,3793
10137,0.0,0.0,0.0,3611,50376,54165,3789
10138,0.0,0.0,0.0,3611,50380,54165,3785
10141,0.0,0.0,0.0,3611,50384,54165,3781
10142,0.0,0.0,0.0,3611,50388,54165,3777
10145,0.0,0.0,0.0,3611,50392,54165,3773
10146,0.0,0.0,0.0,3611,50396,54165,3769
10147,0.0,0.0,0.0,3611,50400,54165,3765
10148,0.0,0.0,0.0,3611,50404,54165,3761
10149,0.0,0.0,0.0,3611,50408,54165,3757
10150,0.0,0.0,0.0,3611,50412,54165,3753
10151,0.0,0.0,0.0,3611,50416,54165,3749
10153,0.0,0.0,0.0,3611,50420,54165,3745
10155,0.0,0.0,0.0,3611,50424,54165,3741
10156,0.0,0.0,0.0,3611,50428,54165,3737
10157,0.0,0.0,0.0,3611,50432,54165,3733
10158,0.0,0.0,0.0,3611,50436,54165,3729
10159,0.0,0.0,0.0,3611,50440,54165,3725
10160,0.0,0.0,0.0,3611,50444,54165,3721
10161,0.0,0.0,0.0,3611,50448,54165,3717
10162,0.0,0.0,0.0,3611,50452,54165,3713
10164,0.0,0.0,0.0,3611,50456,54165,3709
10165,0.0,0.0,0.0,3611,50460,54165,3705
10166,0.0,0.0,0.0,3611,50464,54165,3701
10167,0.0,0.0,0.0,3611,50468,54165,3697
10168,0.0,0.0,0.0,3611,50472,54165,3693
10169,0.0,0.0,0.0,3611,50476,54165,3689
10170,0.0,0.0,0.0,3611,50480,54165,3685
10171,0.0,0.0,0.0,3611,50484,54165,3681
10172,0.0,0.0,0.0,3611,50488,54165,3677
10173,0.0,0.0,0.0,3611,50492,54165,3673
10175,0.0,0.0,0.0,3611,50496,54165,3669
10176,0.0,0.0,0.0,3611,50500,54165,3665
10177,0.0,0.0,0.0,3611,50504,54165,3661
10178,0.0,0.0,0.0,3611,50508,54165,3657
10179,0.0,0.0,0.0,3611,50512,54165,3653
10180,0.0,0.0,0.0,3611,50516,54165,3649
10181,0.0,0.0,0.0,3611,50520,54165,3645
10183,0.0,0.0,0.0,3611,50524,54165,3641
10186,0.0,0.0,0.0,3611,50528,54165,3637
10187,0.0,0.0,0.0,3611,50532,54165,3633
10190,0.0,0.0,0.0,3611,50536,54165,3629
10192,0.0,0.0,0.0,3611,50540,54165,3625
10193,0.0,0.0,0.0,3611,50544,54165,3621
10195,0.0,0.0,0.0,3611,50548,54165,3617
10196,0.0,0.0,0.0,3611,50552,54165,3613
10197,0.0,0.0,0.0,3611,50556,54165,3609
10198,0.0,0.0,0.0,3611,50560,54165,3605
10200,0.0,0.0,0.0,3611,50564,54165,3601
10201,0.0,0.0,0.0,3611,50568,54165,3597
10202,0.0,0.0,0.0,3611,50572,54165,3593
10203,0.0,0.0,0.0,3611,50576,54165,3589
10204,0.0,0.0,0.0,3611,50580,54165,3585
10205,0.0,0.0,0.0,3611,50584,54165,3581
10206,0.0,0.0,0.0,3611,50588,54165,3577
10209,0.0,0.0,0.0,3611,50592,54165,3573
10210,0.0,0.0,0.0,3611,50596,54165,3569
10212,0.0,0.0,0.0,3611,50600,54165,3565
10214,0.0,0.0,0.0,3611,50604,54165,3561
10215,0.0,0.0,0.0,3611,50608,54165,3557
10216,0.0,0.0,0.0,3611,50612,54165,3553
10217,0.0,0.0,0.0,3611,50616,54165,3549
10218,0.0,0.0,0.0,3611,50620,54165,3545
10219,0.0,0.0,0.0,3611,50624,54165,3541
10220,0.0,0.0,0.0,3611,50628,54165,3537
10221,0.0,0.0,0.0,3611,50632,54165,3533
10222,0.0,0.0,0.0,3611,50636,54165,3529
10223,0.0,0.0,0.0,3611,50640,54165,3525
10224,0.0,0.0,0.0,3611,50644,54165,3521
10225,0.0,0.0,0.0,3611,50648,54165,3517
10226,0.0,0.0,0.0,3611,50652,54165,3513
10228,0.0,0.0,0.0,3611,50656,54165,3509
10229,0.0,0.0,0.0,3611,50660,54165,3505
10231,0.0,0.0,0.0,3611,50664,54165,3501
10232,0.0,0.0,0.0,3611,50668,54165,3497
10233,0.0,0.0,0.0,3611,50672,54165,3493
10235,0.0,0.0,0.0,3611,50676,54165,3489
10236,0.0,0.0,0.0,3611,50680,54165,3485
10237,0.0,0.0,0.0,3611,50684,54165,3481
10238,0.0,0.0,0.0,3611,50688,54165,3477
10239,0.0,0.0,0.0,3611,50692,54165,3473
10241,0.0,0.0,0.0,3611,50696,54165,3469
10242,0.0,0.0,0.0,3611,50700,54165,3465
10243,0.0,0.0,0.0,3611,50704,54165,3461
10244,0.0,0.0,0.0,3611,50708,54165,3457
10246,0.0,0.0,0.0,3611,50712,54165,3453
10247,0.0,0.0,0.0,3611,50716,54165,3449
10249,0.0,0.0,0.0,3611,50720,54165,3445
10253,0.0,0.0,0.0,3611,50724,54165,3441
10254,0.0,0.0,0.0,3611,50728,54165,3437
10255,0.0,0.0,0.0,3611,50732,54165,3433
10256,0.0,0.0,0.0,3611,50736,54165,3429
10258,0.0,0.0,0.0,3611,50740,54165,3425
10259,0.0,0.0,0.0,3611,50744,54165,3421
10261,0.0,0.0,0.0,3611,50748,54165,3417
10262,0.0,0.0,0.0,3611,50752,54165,3413
10263,0.0,0.0,0.0,3611,50756,54165,3409
10264,0.0,0.0,0.0,3611,50760,54165,3405
10265,0.0,0.0,0.0,3611,50764,54165,3401
10266,0.0,0.0,0.0,3611,50768,54165,3397
10267,0.0,0.0,0.0,3611,50772,54165,3393
10268,0.0,0.0,0.0,3611,50776,54165,3389
10269,0.0,0.0,0.0,3611,50780,54165,3385
10270,0.0,0.0,0.0,3611,50784,54165,3381
10271,0.0,0.0,0.0,3611,50788,54165,3377
10272,0.0,0.0,0.0,3611,50792,54165,3373
10273,0.0,0.0,0.0,3611,50796,54165,3369
10274,0.0,0.0,0.0,3611,50800,54165,3365
10275,0.0,0.0,0.0,3611,50804,54165,3361
10276,0.0,0.0,0.0,3611,50808,54165,3357
10279,0.0,0.0,0.0,3611,50812,54165,3353
10280,0.0,0.0,0.0,3611,50816,54165,3349
10281,0.0,0.0,0.0,3611,50820,54165,3345
10282,0.0,0.0,0.0,3611,50824,54165,3341
10284,0.0,0.0,0.0,3611,50828,54165,3337
10285,0.0,0.0,0.0,3611,50832,54165,3333
10286,0.0,0.0,0.0,3611,50836,54165,3329
10287,0.0,0.0,0.0,3611,50840,54165,3325
10288,0.0,0.0,0.0,3611,50844,54165,3321
10289,0.0,0.0,0.0,3611,50848,54165,3317
10290,0.0,0.0,0.0,3611,50852,54165,3313
10291,0.0,0.0,0.0,3611,50856,54165,3309
10292,0.0,0.0,0.0,3611,50860,54165,3305
10294,0.0,0.0,0.0,3611,50864,54165,3301
10295,0.0,0.0,0.0,3611,50868,54165,3297
10297,0.0,0.0,0.0,3611,50872,54165,3293
10298,0.0,0.0,0.0,3611,50876,54165,3289
10299,0.0,0.0,0.0,3611,50880,54165,3285
10300,0.0,0.0,0.0,3611,50884,54165,3281
10301,0.0,0.0,0.0,3611,50888,54165,3277
10302,0.0,0.0,0.0,3611,50892,54165,3273
10303,0.0,0.0,0.0,3611,50896,54165,3269
10305,0.0,0.0,0.0,3611,50900,54165,3265
10307,0.0,0.0,0.0,3611,50904,54165,3261
10308,0.0,0.0,0.0,3611,50908,54165,3257
10309,0.0,0.0,0.0,3611,50912,54165,3253
10310,0.0,0.0,0.0,3611,50916,54165,3249
10311,0.0,0.0,0.0,3611,50920,54165,3245
10313,0.0,0.0,0.0,3611,50924,54165,3241
10314,0.0,0.0,0.0,3611,50928,54165,3237
10315,0.0,0.0,0.0,3611,50932,54165,3233
10316,0.0,0.0,0.0,3611,50936,54165,3229
10318,0.0,0.0,0.0,3611,50940,54165,3225
10320,0.0,0.0,0.0,3611,50944,54165,3221
10321,0.0,0.0,0.0,3611,50948,54165,3217
10322,0.0,0.0,0.0,3611,50952,54165,3213
10323,0.0,0.0,0.0,3611,50956,54165,3209
10324,0.0,0.0,0.0,3611,50960,54165,3205
10325,0.0,0.0,0.0,3611,50964,54165,3201
10326,0.0,0.0,0.0,3611,50968,54165,3197
10327,0.0,0.0,0.0,3611,50972,54165,3193
10329,0.0,0.0,0.0,3611,50976,54165,3189
10330,0.0,0.0,0.0,3611,50980,54165,3185
10331,0.0,0.0,0.0,3611,50984,54165,3181
10332,0.0,0.0,0.0,3611,50988,54165,3177
10333,0.0,0.0,0.0,3611,50992,54165,3173
10334,0.0,0.0,0.0,3611,50996,54165,3169
10335,0.0,0.0,0.0,3611,51000,54165,3165
10336,0.0,0.0,0.0,3611,51004,54165,3161
10337,0.0,0.0,0.0,3611,51008,54165,3157
10338,0.0,0.0,0.0,3611,51012,54165,3153
10339,0.0,0.0,0.0,3611,51016,54165,3149
10340,0.0,0.0,0.0,3611,51020,54165,3145
10341,0.0,0.0,0.0,3611,51024,54165,3141
10342,0.0,0.0,0.0,3611,51028,54165,3137
10343,0.0,0.0,0.0,3611,51032,54165,3133
10344,0.0,0.0,0.0,3611,51036,54165,3129
10345,0.0,0.0,0.0,3611,51040,54165,3125
10346,0.0,0.0,0.0,3611,51044,54165,3121
10347,0.0,0.0,0.0,3611,51048,54165,3117
10348,0.0,0.0,0.0,3611,51052,54165,3113
10350,0.0,0.0,0.0,3611,51056,54165,3109
10351,0.0,0.0,0.0,3611,51060,54165,3105
10352,0.0,0.0,0.0,3611,51064,54165,3101
10353,0.0,0.0,0.0,3611,51068,54165,3097
10354,0.0,0.0,0.0,3611,51072,54165,3093
10355,0.0,0.0,0.0,3611,51076,54165,3089
10356,0.0,0.0,0.0,3611,51080,54165,3085
10357,0.0,0.0,0.0,3611,51084,54165,3081
10359,0.0,0.0,0.0,3611,51088,54165,3077
10360,0.0,0.0,0.0,3611,51092,54165,3073
10361,0.0,0.0,0.0,3611,51096,54165,3069
10362,0.0,0.0,0.0,3611,51100,54165,3065
10363,0.0,0.0,0.0,3611,51104,54165,3061
10364,0.0,0.0,0.0,3611,51108,54165,3057
10365,0.0,0.0,0.0,3611,51112,54165,3053
10366,0.0,0.0,0.0,3611,51116,54165,3049
10367,0.0,0.0,0.0,3611,51120,54165,3045
10369,0.0,0.0,0.0,3611,51124,54165,3041
10373,0.0,0.0,0.0,3611,51128,54165,3037
10374,0.0,0.0,0.0,3611,51132,54165,3033
10379,0.0,0.0,0.0,3611,51136,54165,3029
10380,0.0,0.0,0.0,3611,51140,54165,3025
10381,0.0,0.0,0.0,3611,51144,54165,3021
10382,0.0,0.0,0.0,3611,51148,54165,3017
10383,0.0,0.0,0.0,3611,51152,54165,3013
10384,0.0,0.0,0.0,3611,51156,54165,3009
10385,0.0,0.0,0.0,3611,51160,54165,3005
10386,0.0,0.0,0.0,3611,51164,54165,3001
10387,0.0,0.0,0.0,3611,51168,54165,2997
10389,0.0,0.0,0.0,3611,51172,54165,2993
10391,0.0,0.0,0.0,3611,51176,54165,2989
10392,0.0,0.0,0.0,3611,51180,54165,2985
10393,0.0,0.0,0.0,3611,51184,54165,2981
10395,0.0,0.0,0.0,3611,51188,54165,2977
10397,0.0,0.0,0.0,3611,51192,54165,2973
10399,0.0,0.0,0.0,3611,51196,54165,2969
10400,0.0,0.0,0.0,3611,51200,54165,2965
10402,0.0,0.0,0.0,3611,51204,54165,2961
10403,0.0,0.0,0.0,3611,51208,54165,2957
10404,0.0,0.0,0.0,3611,51212,54165,2953
10405,0.0,0.0,0.0,3611,51216,54165,2949
10406,0.0,0.0,0.0,3611,51220,54165,2945
10407,0.0,0.0,0.0,3611,51224,54165,2941
10408,0.0,0.0,0.0,3611,51228,54165,2937
10409,0.0,0.0,0.0,3611,51232,54165,2933
10411,0.0,0.0,0.0,3611,51236,54165,2929
10412,0.0,0.0,0.0,3611,51240,54165,2925
10413,0.0,0.0,0.0,3611,51244,54165,2921
10414,0.0,0.0,0.0,3611,51248,54165,2917
10415,0.0,0.0,0.0,3611,51252,54165,2913
10416,0.0,0.0,0.0,3611,51256,54165,2909
10420,0.0,0.0,0.0,3611,51260,54165,2905
10421,0.0,0.0,0.0,3611,51264,54165,2901
10422,0.0,0.0,0.0,3611,51268,54165,2897
10426,0.0,0.0,0.0,3611,51272,54165,2893
10427,0.0,0.0,0.0,3611,51276,54165,2889
10428,0.0,0.0,0.0,3611,51280,54165,2885
10431,0.0,0.0,0.0,3611,51284,54165,2881
10432,0.0,0.0,0.0,3611,51288,54165,2877
10433,0.0,0.0,0.0,3611,51292,54165,2873
10434,0.0,0.0,0.0,3611,51296,54165,2869
10436,0.0,0.0,0.0,3611,51300,54165,2865
10437,0.0,0.0,0.0,3611,51304,54165,2861
10439,0.0,0.0,0.0,3611,51308,54165,2857
10440,0.0,0.0,0.0,3611,51312,54165,2853
10441,0.0,0.0,0.0,3611,51316,54165,2849
10442,0.0,0.0,0.0,3611,51320,54165,2845
10443,0.0,0.0,0.0,3611,51324,54165,2841
10444,0.0,0.0,0.0,3611,51328,54165,2837
10446,0.0,0.0,0.0,3611,51332,54165,2833
10447,0.0,0.0,0.0,3611,51336,54165,2829
10448,0.0,0.0,0.0,3611,51340,54165,2825
10449,0.0,0.0,0.0,3611,51344,54165,2821
10450,0.0,0.0,0.0,3611,51348,54165,2817
10451,0.0,0.0,0.0,3611,51352,54165,2813
10453,0.0,0.0,0.0,3611,51356,54165,2809
10454,0.0,0.0,0.0,3611,51360,54165,2805
10455,0.0,0.0,0.0,3611,51364,54165,2801
10456,0.0,0.0,0.0,3611,51368,54165,2797
10458,0.0,0.0,0.0,3611,51372,54165,2793
10459,0.0,0.0,0.0,3611,51376,54165,2789
10460,0.0,0.0,0.0,3611,51380,54165,2785
10462,0.0,0.0,0.0,3611,51384,54165,2781
10464,0.0,0.0,0.0,3611,51388,54165,2777
10465,0.0,0.0,0.0,3611,51392,54165,2773
10466,0.0,0.0,0.0,3611,51396,54165,2769
10467,0.0,0.0,0.0,3611,51400,54165,2765
10468,0.0,0.0,0.0,3611,51404,54165,2761
10469,0.0,0.0,0.0,3611,51408,54165,2757
10470,0.0,0.0,0.0,3611,51412,54165,2753
10471,0.0,0.0,0.0,3611,51416,54165,2749
10472,0.0,0.0,0.0,3611,51420,54165,2745
10475,0.0,0.0,0.0,3611,51424,54165,2741
10476,0.0,0.0,0.0,3611,51428,54165,2737
10479,0.0,0.0,0.0,3611,51432,54165,2733
10480,0.0,0.0,0.0,3611,51436,54165,2729
10482,0.0,0.0,0.0,3611,51440,54165,2725
10483,0.0,0.0,0.0,3611,51444,54165,2721
10484,0.0,0.0,0.0,3611,51448,54165,2717
10485,0.0,0.0,0.0,3611,51452,54165,2713
10486,0.0,0.0,0.0,3611,51456,54165,2709
10489,0.0,0.0,0.0,3611,51460,54165,2705
10490,0.0,0.0,0.0,3611,51464,54165,2701
10492,0.0,0.0,0.0,3611,51468,54165,2697
10494,0.0,0.0,0.0,3611,51472,54165,2693
10495,0.0,0.0,0.0,3611,51476,54165,2689
10496,0.0,0.0,0.0,3611,51480,54165,2685
10497,0.0,0.0,0.0,3611,51484,54165,2681
10499,0.0,0.0,0.0,3611,51488,54165,2677
10500,0.0,0.0,0.0,3611,51492,54165,2673
10501,0.0,0.0,0.0,3611,51496,54165,2669
10503,0.0,0.0,0.0,3611,51500,54165,2665
10504,0.0,0.0,0.0,3611,51504,54165,2661
10505,0.0,0.0,0.0,3611,51508,54165,2657
10506,0.0,0.0,0.0,3611,51512,54165,2653
10507,0.0,0.0,0.0,3611,51516,54165,2649
10508,0.0,0.0,0.0,3611,51520,54165,2645
10509,0.0,0.0,0.0,3611,51524,54165,2641
10510,0.0,0.0,0.0,3611,51528,54165,2637
10511,0.0,0.0,0.0,3611,51532,54165,2633
10512,0.0,0.0,0.0,3611,51536,54165,2629
10513,0.0,0.0,0.0,3611,51540,54165,2625
10514,0.0,0.0,0.0,3611,51544,54165,2621
10515,0.0,0.0,0.0,3611,51548,54165,2617
10516,0.0,0.0,0.0,3611,51552,54165,2613
10517,0.0,0.0,0.0,3611,51556,54165,2609
10518,0.0,0.0,0.0,3611,51560,54165,2605
10519,0.0,0.0,0.0,3611,51564,54165,2601
10520,0.0,0.0,0.0,3611,51568,54165,2597
10521,0.0,0.0,0.0,3611,51572,54165,2593
10522,0.0,0.0,0.0,3611,51576,54165,2589
10523,0.0,0.0,0.0,3611,51580,54165,2585
10524,0.0,0.0,0.0,3611,51584,54165,2581
10525,0.0,0.0,0.0,3611,51588,54165,2577
10526,0.0,0.0,0.0,3611,51592,54165,2573
10527,0.0,0.0,0.0,3611,51596,54165,2569
10528,0.0,0.0,0.0,3611,51600,54165,2565
10529,0.0,0.0,0.0,3611,51604,54165,2561
10531,0.0,0.0,0.0,3611,51608,54165,2557
10532,0.0,0.0,0.0,3611,51612,54165,2553
10533,0.0,0.0,0.0,3611,51616,54165,2549
10534,0.0,0.0,0.0,3611,51620,54165,2545
10535,0.0,0.0,0.0,3611,51624,54165,2541
10536,0.0,0.0,0.0,3611,51628,54165,2537
10537,0.0,0.0,0.0,3611,51632,54165,2533
10539,0.0,0.0,0.0,3611,51636,54165,2529
10540,0.0,0.0,0.0,3611,51640,54165,2525
10541,0.0,0.0,0.0,3611,51644,54165,2521
10542,0.0,0.0,0.0,3611,51648,54165,2517
10543,0.0,0.0,0.0,3611,51652,54165,2513
10545,0.0,0.0,0.0,3611,51656,54165,2509
10546,0.0,0.0,0.0,3611,51660,54165,2505
10548,0.0,0.0,0.0,3611,51664,54165,2501
10549,0.0,0.0,0.0,3611,51668,54165,2497
10550,0.0,0.0,0.0,3611,51672,54165,2493
10551,0.0,0.0,0.0,3611,51676,54165,2489
10552,0.0,0.0,0.0,3611,51680,54165,2485
10553,0.0,0.0,0.0,3611,51684,54165,2481
10554,0.0,0.0,0.0,3611,51688,54165,2477
10555,0.0,0.0,0.0,3611,51692,54165,2473
10556,0.0,0.0,0.0,3611,51696,54165,2469
10557,0.0,0.0,0.0,3611,51700,54165,2465
10558,0.0,0.0,0.0,3611,51704,54165,2461
10559,0.0,0.0,0.0,3611,51708,54165,2457
10560,0.0,0.0,0.0,3611,51712,54165,2453
10561,0.0,0.0,0.0,3611,51716,54165,2449
10562,0.0,0.0,0.0,3611,51720,54165,2445
10563,0.0,0.0,0.0,3611,51724,54165,2441
10564,0.0,0.0,0.0,3611,51728,54165,2437
10565,0.0,0.0,0.0,3611,51732,54165,2433
10566,0.0,0.0,0.0,3611,51736,54165,2429
10567,0.0,0.0,0.0,3611,51740,54165,2425
10568,0.0,0.0,0.0,3611,51744,54165,2421
10569,0.0,0.0,0.0,3611,51748,54165,2417
10570,0.0,0.0,0.0,3611,51752,54165,2413
10571,0.0,0.0,0.0,3611,51756,54165,2409
10573,0.0,0.0,0.0,3611,51760,54165,2405
10577,0.0,0.0,0.0,3611,51764,54165,2401
10578,0.0,0.0,0.0,3611,51768,54165,2397
10579,0.0,0.0,0.0,3611,51772,54165,2393
10580,0.0,0.0,0.0,3611,51776,54165,2389
10581,0.0,0.0,0.0,3611,51780,54165,2385
10583,0.0,0.0,0.0,3611,51784,54165,2381
10585,0.0,0.0,0.0,3611,51788,54165,2377
10586,0.0,0.0,0.0,3611,51792,54165,2373
10587,0.0,0.0,0.0,3611,51796,54165,2369
10588,0.0,0.0,0.0,3611,51800,54165,2365
10589,0.0,0.0,0.0,3611,51804,54165,2361
10590,0.0,0.0,0.0,3611,51808,54165,2357
10592,0.0,0.0,0.0,3611,51812,54165,2353
10594,0.0,0.0,0.0,3611,51816,54165,2349
10595,0.0,0.0,0.0,3611,51820,54165,2345
10597,0.0,0.0,0.0,3611,51824,54165,2341
10598,0.0,0.0,0.0,3611,51828,54165,2337
10599,0.0,0.0,0.0,3611,51832,54165,2333
10600,0.0,0.0,0.0,3611,51836,54165,2329
10601,0.0,0.0,0.0,3611,51840,54165,2325
10602,0.0,0.0,0.0,3611,51844,54165,2321
10603,0.0,0.0,0.0,3611,51848,54165,2317
10604,0.0,0.0,0.0,3611,51852,54165,2313
10605,0.0,0.0,0.0,3611,51856,54165,2309
10606,0.0,0.0,0.0,3611,51860,54165,2305
10609,0.0,0.0,0.0,3611,51864,54165,2301
10610,0.0,0.0,0.0,3611,51868,54165,2297
10611,0.0,0.0,0.0,3611,51872,54165,2293
10612,0.0,0.0,0.0,3611,51876,54165,2289
10613,0.0,0.0,0.0,3611,51880,54165,2285
10614,0.0,0.0,0.0,3611,51884,54165,2281
10616,0.0,0.0,0.0,3611,51888,54165,2277
10617,0.0,0.0,0.0,3611,51892,54165,2273
10618,0.0,0.0,0.0,3611,51896,54165,2269
10619,0.0,0.0,0.0,3611,51900,54165,2265
10620,0.0,0.0,0.0,3611,51904,54165,2261
10621,0.0,0.0,0.0,3611,51908,54165,2257
10622,0.0,0.0,0.0,3611,51912,54165,2253
10623,0.0,0.0,0.0,3611,51916,54165,2249
10624,0.0,0.0,0.0,3611,51920,54165,2245
10625,0.0,0.0,0.0,3611,51924,54165,2241
10626,0.0,0.0,0.0,3611,51928,54165,2237
10627,0.0,0.0,0.0,3611,51932,54165,2233
10628,0.0,0.0,0.0,3611,51936,54165,2229
10629,0.0,0.0,0.0,3611,51940,54165,2225
10630,0.0,0.0,0.0,3611,51944,54165,2221
10631,0.0,0.0,0.0,3611,51948,54165,2217
10632,0.0,0.0,0.0,3611,51952,54165,2213
10633,0.0,0.0,0.0,3611,51956,54165,2209
10634,0.0,0.0,0.0,3611,51960,54165,2205
10635,0.0,0.0,0.0,3611,51964,54165,2201
10638,0.0,0.0,0.0,3611,51968,54165,2197
10640,0.0,0.0,0.0,3611,51972,54165,2193
10642,0.0,0.0,0.0,3611,51976,54165,2189
10643,0.0,0.0,0.0,3611,51980,54165,2185
10645,0.0,0.0,0.0,3611,51984,54165,2181
10648,0.0,0.0,0.0,3611,51988,54165,2177
10650,0.0,0.0,0.0,3611,51992,54165,2173
10651,0.0,0.0,0.0,3611,51996,54165,2169
10652,0.0,0.0,0.0,3611,52000,54165,2165
10653,0.0,0.0,0.0,3611,52004,54165,2161
10654,0.0,0.0,0.0,3611,52008,54165,2157
10655,0.0,0.0,0.0,3611,52012,54165,2153
10656,0.0,0.0,0.0,3611,52016,54165,2149
10657,0.0,0.0,0.0,3611,52020,54165,2145
10658,0.0,0.0,0.0,3611,52024,54165,2141
10659,0.0,0.0,0.0,3611,52028,54165,2137
10660,0.0,0.0,0.0,3611,52032,54165,2133
10663,0.0,0.0,0.0,3611,52036,54165,2129
10664,0.0,0.0,0.0,3611,52040,54165,2125
10665,0.0,0.0,0.0,3611,52044,54165,2121
10667,0.0,0.0,0.0,3611,52048,54165,2117
10668,0.0,0.0,0.0,3611,52052,54165,2113
10669,0.0,0.0,0.0,3611,52056,54165,2109
10670,0.0,0.0,0.0,3611,52060,54165,2105
10671,0.0,0.0,0.0,3611,52064,54165,2101
10674,0.0,0.0,0.0,3611,52068,54165,2097
10675,0.0,0.0,0.0,3611,52072,54165,2093
10676,0.0,0.0,0.0,3611,52076,54165,2089
10677,0.0,0.0,0.0,3611,52080,54165,2085
10678,0.0,0.0,0.0,3611,52084,54165,2081
10679,0.0,0.0,0.0,3611,52088,54165,2077
10681,0.0,0.0,0.0,3611,52092,54165,2073
10683,0.0,0.0,0.0,3611,52096,54165,2069
10684,0.0,0.0,0.0,3611,52100,54165,2065
10686,0.0,0.0,0.0,3611,52104,54165,2061
10687,0.0,0.0,0.0,3611,52108,54165,2057
10688,0.0,0.0,0.0,3611,52112,54165,2053
10689,0.0,0.0,0.0,3611,52116,54165,2049
10690,0.0,0.0,0.0,3611,52120,54165,2045
10691,0.0,0.0,0.0,3611,52124,54165,2041
10692,0.0,0.0,0.0,3611,52128,54165,2037
10693,0.0,0.0,0.0,3611,52132,54165,2033
10694,0.0,0.0,0.0,3611,52136,54165,2029
10695,0.0,0.0,0.0,3611,52140,54165,2025
10696,0.0,0.0,0.0,3611,52144,54165,2021
10697,0.0,0.0,0.0,3611,52148,54165,2017
10698,0.0,0.0,0.0,3611,52152,54165,2013
10700,0.0,0.0,0.0,3611,52156,54165,2009
10701,0.0,0.0,0.0,3611,52160,54165,2005
10706,0.0,0.0,0.0,3611,52164,54165,2001
10707,0.0,0.0,0.0,3611,52168,54165,1997
10708,0.0,0.0,0.0,3611,52172,54165,1993
10709,0.0,0.0,0.0,3611,52176,54165,1989
10711,0.0,0.0,0.0,3611,52180,54165,1985
10712,0.0,0.0,0.0,3611,52184,54165,1981
10713,0.0,0.0,0.0,3611,52188,54165,1977
10716,0.0,0.0,0.0,3611,52192,54165,1973
10717,0.0,0.0,0.0,3611,52196,54165,1969
10718,0.0,0.0,0.0,3611,52200,54165,1965
10719,0.0,0.0,0.0,3611,52204,54165,1961
10720,0.0,0.0,0.0,3611,52208,54165,1957
10722,0.0,0.0,0.0,3611,52212,54165,1953
10723,0.0,0.0,0.0,3611,52216,54165,1949
10725,0.0,0.0,0.0,3611,52220,54165,1945
10726,0.0,0.0,0.0,3611,52224,54165,1941
10727,0.0,0.0,0.0,3611,52228,54165,1937
10728,0.0,0.0,0.0,3611,52232,54165,1933
10729,0.0,0.0,0.0,3611,52236,54165,1929
10731,0.0,0.0,0.0,3611,52240,54165,1925
10733,0.0,0.0,0.0,3611,52244,54165,1921
10734,0.0,0.0,0.0,3611,52248,54165,1917
10735,0.0,0.0,0.0,3611,52252,54165,1913
10736,0.0,0.0,0.0,3611,52256,54165,1909
10737,0.0,0.0,0.0,3611,52260,54165,1905
10738,0.0,0.0,0.0,3611,52264,54165,1901
10739,0.0,0.0,0.0,3611,52268,54165,1897
10740,0.0,0.0,0.0,3611,52272,54165,1893
10741,0.0,0.0,0.0,3611,52276,54165,1889
10742,0.0,0.0,0.0,3611,52280,54165,1885
10743,0.0,0.0,0.0,3611,52284,54165,1881
10744,0.0,0.0,0.0,3611,52288,54165,1877
10745,0.0,0.0,0.0,3611,52292,54165,1873
10746,0.0,0.0,0.0,3611,52296,54165,1869
10747,0.0,0.0,0.0,3611,52300,54165,1865
10748,0.0,0.0,0.0,3611,52304,54165,1861
10749,0.0,0.0,0.0,3611,52308,54165,1857
10751,0.0,0.0,0.0,3611,52312,54165,1853
10752,0.0,0.0,0.0,3611,52316,54165,1849
10753,0.0,0.0,0.0,3611,52320,54165,1845
10755,0.0,0.0,0.0,3611,52324,54165,1841
10756,0.0,0.0,0.0,3611,52328,54165,1837
10757,0.0,0.0,0.0,3611,52332,54165,1833
10759,0.0,0.0,0.0,3611,52336,54165,1829
10760,0.0,0.0,0.0,3611,52340,54165,1825
10762,0.0,0.0,0.0,3611,52344,54165,1821
10763,0.0,0.0,0.0,3611,52348,54165,1817
10764,0.0,0.0,0.0,3611,52352,54165,1813
10765,0.0,0.0,0.0,3611,52356,54165,1809
10766,0.0,0.0,0.0,3611,52360,54165,1805
10767,0.0,0.0,0.0,3611,52364,54165,1801
10769,0.0,0.0,0.0,3611,52368,54165,1797
10770,0.0,0.0,0.0,3611,52372,54165,1793
10772,0.0,0.0,0.0,3611,52376,54165,1789
10773,0.0,0.0,0.0,3611,52380,54165,1785
10775,0.0,0.0,0.0,3611,52384,54165,1781
10776,0.0,0.0,0.0,3611,52388,54165,1777
10777,0.0,0.0,0.0,3611,52392,54165,1773
10778,0.0,0.0,0.0,3611,52396,54165,1769
10779,0.0,0.0,0.0,3611,52400,54165,1765
10780,0.0,0.0,0.0,3611,52404,54165,1761
10784,0.0,0.0,0.0,3611,52408,54165,1757
10785,0.0,0.0,0.0,3611,52412,54165,1753
10786,0.0,0.0,0.0,3611,52416,54165,1749
10788,0.0,0.0,0.0,3611,52420,54165,1745
10789,0.0,0.0,0.0,3611,52424,54165,1741
10790,0.0,0.0,0.0,3611,52428,54165,1737
10791,0.0,0.0,0.0,3611,52432,54165,1733
10792,0.0,0.0,0.0,3611,52436,54165,1729
10794,0.0,0.0,0.0,3611,52440,54165,1725
10795,0.0,0.0,0.0,3611,52444,54165,1721
10796,0.0,0.0,0.0,3611,52448,54165,1717
10797,0.0,0.0,0.0,3611,52452,54165,1713
10798,0.0,0.0,0.0,3611,52456,54165,1709
10799,0.0,0.0,0.0,3611,52460,54165,1705
10801,0.0,0.0,0.0,3611,52464,54165,1701
10802,0.0,0.0,0.0,3611,52468,54165,1697
10803,0.0,0.0,0.0,3611,52472,54165,1693
10804,0.0,0.0,0.0,3611,52476,54165,1689
10805,0.0,0.0,0.0,3611,52480,54165,1685
10807,0.0,0.0,0.0,3611,52484,54165,1681
10808,0.0,0.0,0.0,3611,52488,54165,1677
10809,0.0,0.0,0.0,3611,52492,54165,1673
10811,0.0,0.0,0.0,3611,52496,54165,1669
10812,0.0,0.0,0.0,3611,52500,54165,1665
10813,0.0,0.0,0.0,3611,52504,54165,1661
10814,0.0,0.0,0.0,3611,52508,54165,1657
10816,0.0,0.0,0.0,3611,52512,54165,1653
10817,0.0,0.0,0.0,3611,52516,54165,1649
10818,0.0,0.0,0.0,3611,52520,54165,1645
10822,0.0,0.0,0.0,3611,52524,54165,1641
10823,0.0,0.0,0.0,3611,52528,54165,1637
10824,0.0,0.0,0.0,3611,52532,54165,1633
10826,0.0,0.0,0.0,3611,52536,54165,1629
10827,0.0,0.0,0.0,3611,52540,54165,1625
10828,0.0,0.0,0.0,3611,52544,54165,1621
10829,0.0,0.0,0.0,3611,52548,54165,1617
10830,0.0,0.0,0.0,3611,52552,54165,1613
10831,0.0,0.0,0.0,3611,52556,54165,1609
10832,0.0,0.0,0.0,3611,52560,54165,1605
10833,0.0,0.0,0.0,3611,52564,54165,1601
10834,0.0,0.0,0.0,3611,52568,54165,1597
10835,0.0,0.0,0.0,3611,52572,54165,1593
10836,0.0,0.0,0.0,3611,52576,54165,1589
10837,0.0,0.0,0.0,3611,52580,54165,1585
10838,0.0,0.0,0.0,3611,52584,54165,1581
10839,0.0,0.0,0.0,3611,52588,54165,1577
10842,0.0,0.0,0.0,3611,52592,54165,1573
10843,0.0,0.0,0.0,3611,52596,54165,1569
10844,0.0,0.0,0.0,3611,52600,54165,1565
10846,0.0,0.0,0.0,3611,52604,54165,1561
10847,0.0,0.0,0.0,3611,52608,54165,1557
10849,0.0,0.0,0.0,3611,52612,54165,1553
10851,0.0,0.0,0.0,3611,52616,54165,1549
10852,0.0,0.0,0.0,3611,52620,54165,1545
10853,0.0,0.0,0.0,3611,52624,54165,1541
10854,0.0,0.0,0.0,3611,52628,54165,1537
10855,0.0,0.0,0.0,3611,52632,54165,1533
10857,0.0,0.0,0.0,3611,52636,54165,1529
10858,0.0,0.0,0.0,3611,52640,54165,1525
10859,0.0,0.0,0.0,3611,52644,54165,1521
10860,0.0,0.0,0.0,3611,52648,54165,1517
10861,0.0,0.0,0.0,3611,52652,54165,1513
10862,0.0,0.0,0.0,3611,52656,54165,1509
10863,0.0,0.0,0.0,3611,52660,54165,1505
10864,0.0,0.0,0.0,3611,52664,54165,1501
10865,0.0,0.0,0.0,3611,52668,54165,1497
10866,0.0,0.0,0.0,3611,52672,54165,1493
10867,0.0,0.0,0.0,3611,52676,54165,1489
10868,0.0,0.0,0.0,3611,52680,54165,1485
10869,0.0,0.0,0.0,3611,52684,54165,1481
10872,0.0,0.0,0.0,3611,52688,54165,1477
10873,0.0,0.0,0.0,3611,52692,54165,1473
10874,0.0,0.0,0.0,3611,52696,54165,1469
10875,0.0,0.0,0.0,3611,52700,54165,1465
10876,0.0,0.0,0.0,3611,52704,54165,1461
10879,0.0,0.0,0.0,3611,52708,54165,1457
10880,0.0,0.0,0.0,3611,52712,54165,1453
10882,0.0,0.0,0.0,3611,52716,54165,1449
10883,0.0,0.0,0.0,3611,52720,54165,1445
10884,0.0,0.0,0.0,3611,52724,54165,1441
10885,0.0,0.0,0.0,3611,52728,54165,1437
10886,0.0,0.0,0.0,3611,52732,54165,1433
10888,0.0,0.0,0.0,3611,52736,54165,1429
10890,0.0,0.0,0.0,3611,52740,54165,1425
10891,0.0,0.0,0.0,3611,52744,54165,1421
10892,0.0,0.0,0.0,3611,52748,54165,1417
10893,0.0,0.0,0.0,3611,52752,54165,1413
10894,0.0,0.0,0.0,3611,52756,54165,1409
10896,0.0,0.0,0.0,3611,52760,54165,1405
10897,0.0,0.0,0.0,3611,52764,54165,1401
10898,0.0,0.0,0.0,3611,52768,54165,1397
10899,0.0,0.0,0.0,3611,52772,54165,1393
10900,0.0,0.0,0.0,3611,52776,54165,1389
10901,0.0,0.0,0.0,3611,52780,54165,1385
10902,0.0,0.0,0.0,3611,52784,54165,1381
10904,0.0,0.0,0.0,3611,52788,54165,1377
10905,0.0,0.0,0.0,3611,52792,54165,1373
10907,0.0,0.0,0.0,3611,52796,54165,1369
10909,0.0,0.0,0.0,3611,52800,54165,1365
10911,0.0,0.0,0.0,3611,52804,54165,1361
10912,0.0,0.0,0.0,3611,52808,54165,1357
10913,0.0,0.0,0.0,3611,52812,54165,1353
10914,0.0,0.0,0.0,3611,52816,54165,1349
10915,0.0,0.0,0.0,3611,52820,54165,1345
10916,0.0,0.0,0.0,3611,52824,54165,1341
10917,0.0,0.0,0.0,3611,52828,54165,1337
10918,0.0,0.0,0.0,3611,52832,54165,1333
10920,0.0,0.0,0.0,3611,52836,54165,1329
10921,0.0,0.0,0.0,3611,52840,54165,1325
10922,0.0,0.0,0.0,3611,52844,54165,1321
10923,0.0,0.0,0.0,3611,52848,54165,1317
10924,0.0,0.0,0.0,3611,52852,54165,1313
10926,0.0,0.0,0.0,3611,52856,54165,1309
10927,0.0,0.0,0.0,3611,52860,54165,1305
10928,0.0,0.0,0.0,3611,52864,54165,1301
10929,0.0,0.0,0.0,3611,52868,54165,1297
10930,0.0,0.0,0.0,3611,52872,54165,1293
10931,0.0,0.0,0.0,3611,52876,54165,1289
10932,0.0,0.0,0.0,3611,52880,54165,1285
10933,0.0,0.0,0.0,3611,52884,54165,1281
10934,0.0,0.0,0.0,3611,52888,54165,1277
10935,0.0,0.0,0.0,3611,52892,54165,1273
10936,0.0,0.0,0.0,3611,52896,54165,1269
10937,0.0,0.0,0.0,3611,52900,54165,1265
10938,0.0,0.0,0.0,3611,52904,54165,1261
10939,0.0,0.0,0.0,3611,52908,54165,1257
10941,0.0,0.0,0.0,3611,52912,54165,1253
10942,0.0,0.0,0.0,3611,52916,54165,1249
10943,0.0,0.0,0.0,3611,52920,54165,1245
10944,0.0,0.0,0.0,3611,52924,54165,1241
10945,0.0,0.0,0.0,3611,52928,54165,1237
10946,0.0,0.0,0.0,3611,52932,54165,1233
10947,0.0,0.0,0.0,3611,52936,54165,1229
10948,0.0,0.0,0.0,3611,52940,54165,1225
10950,0.0,0.0,0.0,3611,52944,54165,1221
10952,0.0,0.0,0.0,3611,52948,54165,1217
10953,0.0,0.0,0.0,3611,52952,54165,1213
10954,0.0,0.0,0.0,3611,52956,54165,1209
10955,0.0,0.0,0.0,3611,52960,54165,1205
10956,0.0,0.0,0.0,3611,52964,54165,1201
10957,0.0,0.0,0.0,3611,52968,54165,1197
10958,0.0,0.0,0.0,3611,52972,54165,1193
10959,0.0,0.0,0.0,3611,52976,54165,1189
10960,0.0,0.0,0.0,3611,52980,54165,1185
10961,0.0,0.0,0.0,3611,52984,54165,1181
10962,0.0,0.0,0.0,3611,52988,54165,1177
10964,0.0,0.0,0.0,3611,52992,54165,1173
10965,0.0,0.0,0.0,3611,52996,54165,1169
10967,0.0,0.0,0.0,3611,53000,54165,1165
10969,0.0,0.0,0.0,3611,53004,54165,1161
10970,0.0,0.0,0.0,3611,53008,54165,1157
10972,0.0,0.0,0.0,3611,53012,54165,1153
10973,0.0,0.0,0.0,3611,53016,54165,1149
10974,0.0,0.0,0.0,3611,53020,54165,1145
10975,0.0,0.0,0.0,3611,53024,54165,1141
10976,0.0,0.0,0.0,3611,53028,54165,1137
10978,0.0,0.0,0.0,3611,53032,54165,1133
10979,0.0,0.0,0.0,3611,53036,54165,1129
10981,0.0,0.0,0.0,3611,53040,54165,1125
10983,0.0,0.0,0.0,3611,53044,54165,1121
10984,0.0,0.0,0.0,3611,53048,54165,1117
10985,0.0,0.0,0.0,3611,53052,54165,1113
10986,0.0,0.0,0.0,3611,53056,54165,1109
10987,0.0,0.0,0.0,3611,53060,54165,1105
10988,0.0,0.0,0.0,3611,53064,54165,1101
10989,0.0,0.0,0.0,3611,53068,54165,1097
10990,0.0,0.0,0.0,3611,53072,54165,1093
10992,0.0,0.0,0.0,3611,53076,54165,1089
10993,0.0,0.0,0.0,3611,53080,54165,1085
10994,0.0,0.0,0.0,3611,53084,54165,1081
10995,0.0,0.0,0.0,3611,53088,54165,1077
10996,0.0,0.0,0.0,3611,53092,54165,1073
10997,0.0,0.0,0.0,3611,53096,54165,1069
10998,0.0,0.0,0.0,3611,53100,54165,1065
10999,0.0,0.0,0.0,3611,53104,54165,1061
11001,0.0,0.0,0.0,3611,53108,54165,1057
11002,0.0,0.0,0.0,3611,53112,54165,1053
11003,0.0,0.0,0.0,3611,53116,54165,1049
11004,0.0,0.0,0.0,3611,53120,54165,1045
11006,0.0,0.0,0.0,3611,53124,54165,1041
11007,0.0,0.0,0.0,3611,53128,54165,1037
11009,0.0,0.0,0.0,3611,53132,54165,1033
11010,0.0,0.0,0.0,3611,53136,54165,1029
11011,0.0,0.0,0.0,3611,53140,54165,1025
11012,0.0,0.0,0.0,3611,53144,54165,1021
11013,0.0,0.0,0.0,3611,53148,54165,1017
11014,0.0,0.0,0.0,3611,53152,54165,1013
11015,0.0,0.0,0.0,3611,53156,54165,1009
11017,0.0,0.0,0.0,3611,53160,54165,1005
11018,0.0,0.0,0.0,3611,53164,54165,1001
11019,0.0,0.0,0.0,3611,53168,54165,997
11020,0.0,0.0,0.0,3611,53172,54165,993
11021,0.0,0.0,0.0,3611,53176,54165,989
11023,0.0,0.0,0.0,3611,53180,54165,985
11024,0.0,0.0,0.0,3611,53184,54165,981
11025,0.0,0.0,0.0,3611,53188,54165,977
11026,0.0,0.0,0.0,3611,53192,54165,973
11027,0.0,0.0,0.0,3611,53196,54165,969
11028,0.0,0.0,0.0,3611,53200,54165,965
11029,0.0,0.0,0.0,3611,53204,54165,961
11030,0.0,0.0,0.0,3611,53208,54165,957
11031,0.0,0.0,0.0,3611,53212,54165,953
11032,0.0,0.0,0.0,3611,53216,54165,949
11034,0.0,0.0,0.0,3611,53220,54165,945
11036,0.0,0.0,0.0,3611,53224,54165,941
11037,0.0,0.0,0.0,3611,53228,54165,937
11038,0.0,0.0,0.0,3611,53232,54165,933
11039,0.0,0.0,0.0,3611,53236,54165,929
11040,0.0,0.0,0.0,3611,53240,54165,925
11041,0.0,0.0,0.0,3611,53244,54165,921
11042,0.0,0.0,0.0,3611,53248,54165,917
11043,0.0,0.0,0.0,3611,53252,54165,913
11044,0.0,0.0,0.0,3611,53256,54165,909
11045,0.0,0.0,0.0,3611,53260,54165,905
11046,0.0,0.0,0.0,3611,53264,54165,901
11049,0.0,0.0,0.0,3611,53268,54165,897
11050,0.0,0.0,0.0,3611,53272,54165,893
11051,0.0,0.0,0.0,3611,53276,54165,889
11053,0.0,0.0,0.0,3611,53280,54165,885
11055,0.0,0.0,0.0,3611,53284,54165,881
11057,0.0,0.0,0.0,3611,53288,54165,877
11058,0.0,0.0,0.0,3611,53292,54165,873
11059,0.0,0.0,0.0,3611,53296,54165,869
11060,0.0,0.0,0.0,3611,53300,54165,865
11062,0.0,0.0,0.0,3611,53304,54165,861
11063,0.0,0.0,0.0,3611,53308,54165,857
11064,0.0,0.0,0.0,3611,53312,54165,853
11066,0.0,0.0,0.0,3611,53316,54165,849
11067,0.0,0.0,0.0,3611,53320,54165,845
11068,0.0,0.0,0.0,3611,53324,54165,841
11069,0.0,0.0,0.0,3611,53328,54165,837
11070,0.0,0.0,0.0,3611,53332,54165,833
11071,0.0,0.0,0.0,3611,53336,54165,829
11072,0.0,0.0,0.0,3611,53340,54165,825
11074,0.0,0.0,0.0,3611,53344,54165,821
11075,0.0,0.0,0.0,3611,53348,54165,817
11076,0.0,0.0,0.0,3611,53352,54165,813
11077,0.0,0.0,0.0,3611,53356,54165,809
11078,0.0,0.0,0.0,3611,53360,54165,805
11079,0.0,0.0,0.0,3611,53364,54165,801
11081,0.0,0.0,0.0,3611,53368,54165,797
11083,0.0,0.0,0.0,3611,53372,54165,793
11084,0.0,0.0,0.0,3611,53376,54165,789
11087,0.0,0.0,0.0,3611,53380,54165,785
11088,0.0,0.0,0.0,3611,53384,54165,781
11089,0.0,0.0,0.0,3611,53388,54165,777
11090,0.0,0.0,0.0,3611,53392,54165,773
11091,0.0,0.0,0.0,3611,53396,54165,769
11092,0.0,0.0,0.0,3611,53400,54165,765
11093,0.0,0.0,0.0,3611,53404,54165,761
11094,0.0,0.0,0.0,3611,53408,54165,757
11095,0.0,0.0,0.0,3611,53412,54165,753
11096,0.0,0.0,0.0,3611,53416,54165,749
11098,0.0,0.0,0.0,3611,53420,54165,745
11099,0.0,0.0,0.0,3611,53424,54165,741
11100,0.0,0.0,0.0,3611,53428,54165,737
11102,0.0,0.0,0.0,3611,53432,54165,733
11103,0.0,0.0,0.0,3611,53436,54165,729
11104,0.0,0.0,0.0,3611,53440,54165,725
11106,0.0,0.0,0.0,3611,53444,54165,721
11107,0.0,0.0,0.0,3611,53448,54165,717
11108,0.0,0.0,0.0,3611,53452,54165,713
11109,0.0,0.0,0.0,3611,53456,54165,709
11110,0.0,0.0,0.0,3611,53460,54165,705
11111,0.0,0.0,0.0,3611,53464,54165,701
11112,0.0,0.0,0.0,3611,53468,54165,697
11113,0.0,0.0,0.0,3611,53472,54165,693
11114,0.0,0.0,0.0,3611,53476,54165,689
11115,0.0,0.0,0.0,3611,53480,54165,685
11116,0.0,0.0,0.0,3611,53484,54165,681
11117,0.0,0.0,0.0,3611,53488,54165,677
11118,0.0,0.0,0.0,3611,53492,54165,673
11119,0.0,0.0,0.0,3611,53496,54165,669
11121,0.0,0.0,0.0,3611,53500,54165,665
11123,0.0,0.0,0.0,3611,53504,54165,661
11124,0.0,0.0,0.0,3611,53508,54165,657
11125,0.0,0.0,0.0,3611,53512,54165,653
11126,0.0,0.0,0.0,3611,53516,54165,649
11127,0.0,0.0,0.0,3611,53520,54165,645
11128,0.0,0.0,0.0,3611,53524,54165,641
11129,0.0,0.0,0.0,3611,53528,54165,637
11130,0.0,0.0,0.0,3611,53532,54165,633
11132,0.0,0.0,0.0,3611,53536,54165,629
11133,0.0,0.0,0.0,3611,53540,54165,625
11134,0.0,0.0,0.0,3611,53544,54165,621
11135,0.0,0.0,0.0,3611,53548,54165,617
11136,0.0,0.0,0.0,3611,53552,54165,613
11137,0.0,0.0,0.0,3611,53556,54165,609
11138,0.0,0.0,0.0,3611,53560,54165,605
11139,0.0,0.0,0.0,3611,53564,54165,601
11141,0.0,0.0,0.0,3611,53568,54165,597
11143,0.0,0.0,0.0,3611,53572,54165,593
11144,0.0,0.0,0.0,3611,53576,54165,589
11145,0.0,0.0,0.0,3611,53580,54165,585
11148,0.0,0.0,0.0,3611,53584,54165,581
11149,0.0,0.0,0.0,3611,53588,54165,577
11150,0.0,0.0,0.0,3611,53592,54165,573
11151,0.0,0.0,0.0,3611,53596,54165,569
11152,0.0,0.0,0.0,3611,53600,54165,565
11154,0.0,0.0,0.0,3611,53604,54165,561
11156,0.0,0.0,0.0,3611,53608,54165,557
11157,0.0,0.0,0.0,3611,53612,54165,553
11158,0.0,0.0,0.0,3611,53616,54165,549
11159,0.0,0.0,0.0,3611,53620,54165,545
11160,0.0,0.0,0.0,3611,53624,54165,541
11161,0.0,0.0,0.0,3611,53628,54165,537
11162,0.0,0.0,0.0,3611,53632,54165,533
11163,0.0,0.0,0.0,3611,53636,54165,529
11166,0.0,0.0,0.0,3611,53640,54165,525
11167,0.0,0.0,0.0,3611,53644,54165,521
11169,0.0,0.0,0.0,3611,53648,54165,517
11170,0.0,0.0,0.0,3611,53652,54165,513
11171,0.0,0.0,0.0,3611,53656,54165,509
11172,0.0,0.0,0.0,3611,53660,54165,505
11175,0.0,0.0,0.0,3611,53664,54165,501
11176,0.0,0.0,0.0,3611,53668,54165,497
11178,0.0,0.0,0.0,3611,53672,54165,493
11180,0.0,0.0,0.0,3611,53676,54165,489
11181,0.0,0.0,0.0,3611,53680,54165,485
11183,0.0,0.0,0.0,3611,53684,54165,481
11184,0.0,0.0,0.0,3611,53688,54165,477
11186,0.0,0.0,0.0,3611,53692,54165,473
11190,0.0,0.0,0.0,3611,53696,54165,469
11191,0.0,0.0,0.0,3611,53700,54165,465
11192,0.0,0.0,0.0,3611,53704,54165,461
11193,0.0,0.0,0.0,3611,53708,54165,457
11194,0.0,0.0,0.0,3611,53712,54165,453
11195,0.0,0.0,0.0,3611,53716,54165,449
11197,0.0,0.0,0.0,3611,53720,54165,445
11198,0.0,0.0,0.0,3611,53724,54165,441
11201,0.0,0.0,0.0,3611,53728,54165,437
11205,0.0,0.0,0.0,3611,53732,54165,433
11206,0.0,0.0,0.0,3611,53736,54165,429
11208,0.0,0.0,0.0,3611,53740,54165,425
11209,0.0,0.0,0.0,3611,53744,54165,421
11210,0.0,0.0,0.0,3611,53748,54165,417
11211,0.0,0.0,0.0,3611,53752,54165,413
11212,0.0,0.0,0.0,3611,53756,54165,409
11213,0.0,0.0,0.0,3611,53760,54165,405
11214,0.0,0.0,0.0,3611,53764,54165,401
11215,0.0,0.0,0.0,3611,53768,54165,397
11216,0.0,0.0,0.0,3611,53772,54165,393
11217,0.0,0.0,0.0,3611,53776,54165,389
11218,0.0,0.0,0.0,3611,53780,54165,385
11219,0.0,0.0,0.0,3611,53784,54165,381
11222,0.0,0.0,0.0,3611,53788,54165,377
11223,0.0,0.0,0.0,3611,53792,54165,373
11224,0.0,0.0,0.0,3611,53796,54165,369
11225,0.0,0.0,0.0,3611,53800,54165,365
11227,0.0,0.0,0.0,3611,53804,54165,361
11228,0.0,0.0,0.0,3611,53808,54165,357
11231,0.0,0.0,0.0,3611,53812,54165,353
11232,0.0,0.0,0.0,3611,53816,54165,349
11233,0.0,0.0,0.0,3611,53820,54165,345
11234,0.0,0.0,0.0,3611,53824,54165,341
11236,0.0,0.0,0.0,3611,53828,54165,337
11237,0.0,0.0,0.0,3611,53832,54165,333
11238,0.0,0.0,0.0,3611,53836,54165,329
11239,0.0,0.0,0.0,3611,53840,54165,325
11240,0.0,0.0,0.0,3611,53844,54165,321
11241,0.0,0.0,0.0,3611,53848,54165,317
11242,0.0,0.0,0.0,3611,53852,54165,313
11243,0.0,0.0,0.0,3611,53856,54165,309
11244,0.0,0.0,0.0,3611,53860,54165,305
11247,0.0,0.0,0.0,3611,53864,54165,301
11248,0.0,0.0,0.0,3611,53868,54165,297
11250,0.0,0.0,0.0,3611,53872,54165,293
11251,0.0,0.0,0.0,3611,53876,54165,289
11252,0.0,0.0,0.0,3611,53880,54165,285
11253,0.0,0.0,0.0,3611,53884,54165,281
11254,0.0,0.0,0.0,3611,53888,54165,277
11255,0.0,0.0,0.0,3611,53892,54165,273
11256,0.0,0.0,0.0,3611,53896,54165,269
11257,0.0,0.0,0.0,3611,53900,54165,265
11259,0.0,0.0,0.0,3611,53904,54165,261
11260,0.0,0.0,0.0,3611,53908,54165,257
11261,0.0,0.0,0.0,3611,53912,54165,253
11263,0.0,0.0,0.0,3611,53916,54165,249
11264,0.0,0.0,0.0,3611,53920,54165,245
11266,0.0,0.0,0.0,3611,53924,54165,241
11267,0.0,0.0,0.0,3611,53928,54165,237
11269,0.0,0.0,0.0,3611,53932,54165,233
11271,0.0,0.0,0.0,3611,53936,54165,229
11273,0.0,0.0,0.0,3611,53940,54165,225
11274,0.0,0.0,0.0,3611,53944,54165,221
11275,0.0,0.0,0.0,3611,53948,54165,217
11276,0.0,0.0,0.0,3611,53952,54165,213
11279,0.0,0.0,0.0,3611,53956,54165,209
11280,0.0,0.0,0.0,3611,53960,54165,205
11282,0.0,0.0,0.0,3611,53964,54165,201
11283,0.0,0.0,0.0,3611,53968,54165,197
11285,0.0,0.0,0.0,3611,53972,54165,193
11286,0.0,0.0,0.0,3611,53976,54165,189
11287,0.0,0.0,0.0,3611,53980,54165,185
11288,0.0,0.0,0.0,3611,53984,54165,181
11289,0.0,0.0,0.0,3611,53988,54165,177
11290,0.0,0.0,0.0,3611,53992,54165,173
11293,0.0,0.0,0.0,3611,53996,54165,169
11294,0.0,0.0,0.0,3611,54000,54165,165
11295,0.0,0.0,0.0,3611,54004,54165,161
11298,0.0,0.0,0.0,3611,54008,54165,157
11299,0.0,0.0,0.0,3611,54012,54165,153
11300,0.0,0.0,0.0,3611,54016,54165,149
11301,0.0,0.0,0.0,3611,54020,54165,145
11302,0.0,0.0,0.0,3611,54024,54165,141
11304,0.0,0.0,0.0,3611,54028,54165,137
11306,0.0,0.0,0.0,3611,54032,54165,133
11307,0.0,0.0,0.0,3611,54036,54165,129
11308,0.0,0.0,0.0,3611,54040,54165,125
11309,0.0,0.0,0.0,3611,54044,54165,121
11310,0.0,0.0,0.0,3611,54048,54165,117
11311,0.0,0.0,0.0,3611,54052,54165,113
11312,0.0,0.0,0.0,3611,54056,54165,109
11313,0.0,0.0,0.0,3611,54060,54165,105
11314,0.0,0.0,0.0,3611,54064,54165,101
11315,0.0,0.0,0.0,3611,54068,54165,97
11316,0.0,0.0,0.0,3611,54072,54165,93
11317,0.0,0.0,0.0,3611,54076,54165,89
11318,0.0,0.0,0.0,3611,54080,54165,85
11319,0.0,0.0,0.0,3611,54084,54165,81
11320,0.0,0.0,0.0,3611,54088,54165,77
11321,0.0,0.0,0.0,3611,54092,54165,73
11322,0.0,0.0,0.0,3611,54096,54165,69
11323,0.0,0.0,0.0,3611,54100,54165,65
11324,0.0,0.0,0.0,3611,54104,54165,61
11325,0.0,0.0,0.0,3611,54108,54165,57
11326,0.0,0.0,0.0,3611,54112,54165,53
11328,0.0,0.0,0.0,3611,54116,54165,49
11329,0.0,0.0,0.0,3611,54120,54165,45
11330,0.0,0.0,0.0,3611,54124,54165,41
11331,0.0,0.0,0.0,3611,54128,54165,37
11332,0.0,0.0,0.0,3611,54132,54165,33
11333,0.0,0.0,0.0,3611,54136,54165,29
11334,0.0,0.0,0.0,3611,54140,54165,25
11336,0.0,0.0,0.0,3611,54144,54165,21
11338,0.0,0.0,0.0,3611,54148,54165,17
11339,0.0,0.0,0.0,3611,54152,54165,13
11340,0.0,0.0,0.0,3611,54156,54165,9
11341,0.0,0.0,0.0,3611,54160,54165,5
11342,0.0,0.0,0.0,3611,54164,54165,1
11344,0.0,0.0,0.0,3611,54168,54165,-3
11346,0.0,0.0,0.0,3611,54172,54165,-7
11347,0.0,0.0,0.0,3611,54176,54165,-11
11348,0.0,0.0,0.0,3611,54180,54165,-15
11349,0.0,0.0,0.0,3611,54184,54165,-19
11350,0.0,0.0,0.0,3611,54188,54165,-23
11354,0.0,0.0,0.0,3611,54192,54165,-27
11355,0.0,0.0,0.0,3611,54196,54165,-31
11357,0.0,0.0,0.0,3611,54200,54165,-35
11358,0.0,0.0,0.0,3611,54204,54165,-39
11361,0.0,0.0,0.0,3611,54208,54165,-43
11362,0.0,0.0,0.0,3611,54212,54165,-47
11363,0.0,0.0,0.0,3611,54216,54165,-51
11364,0.0,0.0,0.0,3611,54220,54165,-55
11365,0.0,0.0,0.0,3611,54224,54165,-59
11368,0.0,0.0,0.0,3611,54228,54165,-63
11369,0.0,0.0,0.0,3611,54232,54165,-67
11370,0.0,0.0,0.0,3611,54236,54165,-71
11371,0.0,0.0,0.0,3611,54240,54165,-75
11375,0.0,0.0,0.0,3611,54244,54165,-79
11376,0.0,0.0,0.0,3611,54248,54165,-83
11377,0.0,0.0,0.0,3611,54252,54165,-87
11378,0.0,0.0,0.0,3611,54256,54165,-91
11379,0.0,0.0,0.0,3611,54260,54165,-95
11381,0.0,0.0,0.0,3611,54264,54165,-99
11382,0.0,0.0,0.0,3611,54268,54165,-103
11388,0.0,0.0,0.0,3611,54272,54165,-107
11390,0.0,0.0,0.0,3611,54276,54165,-111
11391,0.0,0.0,0.0,3611,54280,54165,-115
11393,0.0,0.0,0.0,3611,54284,54165,-119
11395,0.0,0.0,0.0,3611,54288,54165,-123
11396,0.0,0.0,0.0,3611,54292,54165,-127
11400,0.0,0.0,0.0,3611,54296,54165,-131
11401,0.0,0.0,0.0,3611,54300,54165,-135
11402,0.0,0.0,0.0,3611,54304,54165,-139
11403,0.0,0.0,0.0,3611,54308,54165,-143
11404,0.0,0.0,0.0,3611,54312,54165,-147
11405,0.0,0.0,0.0,3611,54316,54165,-151
11406,0.0,0.0,0.0,3611,54320,54165,-155
11407,0.0,0.0,0.0,3611,54324,54165,-159
11408,0.0,0.0,0.0,3611,54328,54165,-163
11411,0.0,0.0,0.0,3611,54332,54165,-167
11412,0.0,0.0,0.0,3611,54336,54165,-171
11414,0.0,0.0,0.0,3611,54340,54165,-175
11415,0.0,0.0,0.0,3611,54344,54165,-179
11418,0.0,0.0,0.0,3611,54348,54165,-183
11420,0.0,0.0,0.0,3611,54352,54165,-187
11421,0.0,0.0,0.0,3611,54356,54165,-191
11422,0.0,0.0,0.0,3611,54360,54165,-195
11423,0.0,0.0,0.0,3611,54364,54165,-199
11424,0.0,0.0,0.0,3611,54368,54165,-203
11425,0.0,0.0,0.0,3611,54372,54165,-207
11426,0.0,0.0,0.0,3611,54376,54165,-211
11427,0.0,0.0,0.0,3611,54380,54165,-215
11428,0.0,0.0,0.0,3611,54384,54165,-219
11429,0.0,0.0,0.0,3611,54388,54165,-223
11430,0.0,0.0,0.0,3611,54392,54165,-227
11432,0.0,0.0,0.0,3611,54396,54165,-231
11433,0.0,0.0,0.0,3611,54400,54165,-235
11434,0.0,0.0,0.0,3611,54404,54165,-239
11435,0.0,0.0,0.0,3611,54408,54165,-243
11436,0.0,0.0,0.0,3611,54412,54165,-247
11437,0.0,0.0,0.0,3611,54416,54165,-251
11438,0.0,0.0,0.0,3611,54420,54165,-255
11440,0.0,0.0,0.0,3611,54424,54165,-259
11441,0.0,0.0,0.0,3611,54428,54165,-263
11442,0.0,0.0,0.0,3611,54432,54165,-267
11443,0.0,0.0,0.0,3611,54436,54165,-271
11444,0.0,0.0,0.0,3611,54440,54165,-275
11445,0.0,0.0,0.0,3611,54444,54165,-279
11446,0.0,0.0,0.0,3611,54448,54165,-283
11447,0.0,0.0,0.0,3611,54452,54165,-287
11448,0.0,0.0,0.0,3611,54456,54165,-291
11450,0.0,0.0,0.0,3611,54460,54165,-295
11451,0.0,0.0,0.0,3611,54464,54165,-299
11452,0.0,0.0,0.0,3611,54468,54165,-303
11453,0.0,0.0,0.0,3611,54472,54165,-307
11454,0.0,0.0,0.0,3611,54476,54165,-311
11455,0.0,0.0,0.0,3611,54480,54165,-315
11458,0.0,0.0,0.0,3611,54484,54165,-319
11459,0.0,0.0,0.0,3611,54488,54165,-323
11460,0.0,0.0,0.0,3611,54492,54165,-327
11461,0.0,0.0,0.0,3611,54496,54165,-331
11463,0.0,0.0,0.0,3611,54500,54165,-335
11464,0.0,0.0,0.0,3611,54504,54165,-339
11465,0.0,0.0,0.0,3611,54508,54165,-343
11466,0.0,0.0,0.0,3611,54512,54165,-347
11467,0.0,0.0,0.0,3611,54516,54165,-351
11468,0.0,0.0,0.0,3611,54520,54165,-355
11471,0.0,0.0,0.0,3611,54524,54165,-359
11472,0.0,0.0,0.0,3611,54528,54165,-363
11473,0.0,0.0,0.0,3611,54532,54165,-367
11474,0.0,0.0,0.0,3611,54536,54165,-371
11475,0.0,0.0,0.0,3611,54540,54165,-375
11477,0.0,0.0,0.0,3611,54544,54165,-379
11478,0.0,0.0,0.0,3611,54548,54165,-383
11480,0.0,0.0,0.0,3611,54552,54165,-387
11481,0.0,0.0,0.0,3611,54556,54165,-391
11483,0.0,0.0,0.0,3611,54560,54165,-395
11484,0.0,0.0,0.0,3611,54564,54165,-399
11486,0.0,0.0,0.0,3611,54568,54165,-403
11487,0.0,0.0,0.0,3611,54572,54165,-407
11489,0.0,0.0,0.0,3611,54576,54165,-411
11490,0.0,0.0,0.0,3611,54580,54165,-415
11491,0.0,0.0,0.0,3611,54584,54165,-419
11492,0.0,0.0,0.0,3611,54588,54165,-423
11493,0.0,0.0,0.0,3611,54592,54165,-427
11495,0.0,0.0,0.0,3611,54596,54165,-431
11496,0.0,0.0,0.0,3611,54600,54165,-435
11497,0.0,0.0,0.0,3611,54604,54165,-439
11498,0.0,0.0,0.0,3611,54608,54165,-443
11499,0.0,0.0,0.0,3611,54612,54165,-447
11502,0.0,0.0,0.0,3611,54616,54165,-451
11504,0.0,0.0,0.0,3611,54620,54165,-455
11505,0.0,0.0,0.0,3611,54624,54165,-459
11506,0.0,0.0,0.0,3611,54628,54165,-463
11507,0.0,0.0,0.0,3611,54632,54165,-467
11508,0.0,0.0,0.0,3611,54636,54165,-471
11509,0.0,0.0,0.0,3611,54640,54165,-475
11510,0.0,0.0,0.0,3611,54644,54165,-479
11511,0.0,0.0,0.0,3611,54648,54165,-483
11512,0.0,0.0,0.0,3611,54652,54165,-487
11514,0.0,0.0,0.0,3611,54656,54165,-491
11516,0.0,0.0,0.0,3611,54660,54165,-495
11517,0.0,0.0,0.0,3611,54664,54165,-499
11518,0.0,0.0,0.0,3611,54668,54165,-503
11519,0.0,0.0,0.0,3611,54672,54165,-507
11520,0.0,0.0,0.0,3611,54676,54165,-511
11521,0.0,0.0,0.0,3611,54680,54165,-515
11523,0.0,0.0,0.0,3611,54684,54165,-519
11524,0.0,0.0,0.0,3611,54688,54165,-523
11525,0.0,0.0,0.0,3611,54692,54165,-527
11528,0.0,0.0,0.0,3611,54696,54165,-531
11529,0.0,0.0,0.0,3611,54700,54165,-535
11530,0.0,0.0,0.0,3611,54704,54165,-539
11531,0.0,0.0,0.0,3611,54708,54165,-543
11532,0.0,0.0,0.0,3611,54712,54165,-547
11533,0.0,0.0,0.0,3611,54716,54165,-551
11534,0.0,0.0,0.0,3611,54720,54165,-555
11536,0.0,0.0,0.0,3611,54724,54165,-559
11537,0.0,0.0,0.0,3611,54728,54165,-563
11538,0.0,0.0,0.0,3611,54732,54165,-567
11539,0.0,0.0,0.0,3611,54736,54165,-571
11540,0.0,0.0,0.0,3611,54740,54165,-575
11542,0.0,0.0,0.0,3611,54744,54165,-579
11543,0.0,0.0,0.0,3611,54748,54165,-583
11544,0.0,0.0,0.0,3611,54752,54165,-587
11545,0.0,0.0,0.0,3611,54756,54165,-591
11546,0.0,0.0,0.0,3611,54760,54165,-595
11548,0.0,0.0,0.0,3611,54764,54165,-599
11549,0.0,0.0,0.0,3611,54768,54165,-603
11550,0.0,0.0,0.0,3611,54772,54165,-607
11551,0.0,0.0,0.0,3611,54776,54165,-611
11554,0.0,0.0,0.0,3611,54780,54165,-615
11555,0.0,0.0,0.0,3611,54784,54165,-619
11556,0.0,0.0,0.0,3611,54788,54165,-623
11557,0.0,0.0,0.0,3611,54792,54165,-627
11558,0.0,0.0,0.0,3611,54796,54165,-631
11559,0.0,0.0,0.0,3611,54800,54165,-635
11560,0.0,0.0,0.0,3611,54804,54165,-639
11561,0.0,0.0,0.0,3611,54808,54165,-643
11562,0.0,0.0,0.0,3611,54812,54165,-647
11564,0.0,0.0,0.0,3611,54816,54165,-651
11566,0.0,0.0,0.0,3611,54820,54165,-655
11567,0.0,0.0,0.0,3611,54824,54165,-659
11568,0.0,0.0,0.0,3611,54828,54165,-663
11569,0.0,0.0,0.0,3611,54832,54165,-667
11572,0.0,0.0,0.0,3611,54836,54165,-671
11573,0.0,0.0,0.0,3611,54840,54165,-675
11574,0.0,0.0,0.0,3611,54844,54165,-679
11576,0.0,0.0,0.0,3611,54848,54165,-683
11577,0.0,0.0,0.0,3611,54852,54165,-687
11578,0.0,0.0,0.0,3611,54856,54165,-691
11579,0.0,0.0,0.0,3611,54860,54165,-695
11581,0.0,0.0,0.0,3611,54864,54165,-699
11582,0.0,0.0,0.0,3611,54868,54165,-703
11583,0.0,0.0,0.0,3611,54872,54165,-707
11584,0.0,0.0,0.0,3611,54876,54165,-711
11585,0.0,0.0,0.0,3611,54880,54165,-715
11586,0.0,0.0,0.0,3611,54884,54165,-719
11587,0.0,0.0,0.0,3611,54888,54165,-723
11588,0.0,0.0,0.0,3611,54892,54165,-727
11589,0.0,0.0,0.0,3611,54896,54165,-731
11590,0.0,0.0,0.0,3611,54900,54165,-735
11592,0.0,0.0,0.0,3611,54904,54165,-739
11593,0.0,0.0,0.0,3611,54908,54165,-743
11595,0.0,0.0,0.0,3611,54912,54165,-747
11596,0.0,0.0,0.0,3611,54916,54165,-751
11597,0.0,0.0,0.0,3611,54920,54165,-755
11599,0.0,0.0,0.0,3611,54924,54165,-759
11600,0.0,0.0,0.0,3611,54928,54165,-763
11601,0.0,0.0,0.0,3611,54932,54165,-767
11603,0.0,0.0,0.0,3611,54936,54165,-771
11604,0.0,0.0,0.0,3611,54940,54165,-775
11605,0.0,0.0,0.0,3611,54944,54165,-779
11607,0.0,0.0,0.0,3611,54948,54165,-783
11609,0.0,0.0,0.0,3611,54952,54165,-787
11610,0.0,0.0,0.0,3611,54956,54165,-791
11612,0.0,0.0,0.0,3611,54960,54165,-795
11613,0.0,0.0,0.0,3611,54964,54165,-799
11614,0.0,0.0,0.0,3611,54968,54165,-803
11615,0.0,0.0,0.0,3611,54972,54165,-807
11616,0.0,0.0,0.0,3611,54976,54165,-811
11617,0.0,0.0,0.0,3611,54980,54165,-815
11619,0.0,0.0,0.0,3611,54984,54165,-819
11620,0.0,0.0,0.0,3611,54988,54165,-823
11621,0.0,0.0,0.0,3611,54992,54165,-827
11622,0.0,0.0,0.0,3611,54996,54165,-831
11623,0.0,0.0,0.0,3611,55000,54165,-835
11624,0.0,0.0,0.0,3611,55004,54165,-839
11625,0.0,0.0,0.0,3611,55008,54165,-843
11628,0.0,0.0,0.0,3611,55012,54165,-847
11629,0.0,0.0,0.0,3611,55016,54165,-851
11630,0.0,0.0,0.0,3611,55020,54165,-855
11631,0.0,0.0,0.0,3611,55024,54165,-859
11632,0.0,0.0,0.0,3611,55028,54165,-863
11633,0.0,0.0,0.0,3611,55032,54165,-867
11634,0.0,0.0,0.0,3611,55036,54165,-871
11635,0.0,0.0,0.0,3611,55040,54165,-875
11636,0.0,0.0,0.0,3611,55044,54165,-879
11637,0.0,0.0,0.0,3611,55048,54165,-883
11638,0.0,0.0,0.0,3611,55052,54165,-887
11639,0.0,0.0,0.0,3611,55056,54165,-891
11640,0.0,0.0,0.0,3611,55060,54165,-895
11641,0.0,0.0,0.0,3611,55064,54165,-899
11643,0.0,0.0,0.0,3611,55068,54165,-903
11644,0.0,0.0,0.0,3611,55072,54165,-907
11645,0.0,0.0,0.0,3611,55076,54165,-911
11646,0.0,0.0,0.0,3611,55080,54165,-915
11647,0.0,0.0,0.0,3611,55084,54165,-919
11648,0.0,0.0,0.0,3611,55088,54165,-923
11649,0.0,0.0,0.0,3611,55092,54165,-927
11650,0.0,0.0,0.0,3611,55096,54165,-931
11651,0.0,0.0,0.0,3611,55100,54165,-935
11653,0.0,0.0,0.0,3611,55104,54165,-939
11654,0.0,0.0,0.0,3611,55108,54165,-943
11655,0.0,0.0,0.0,3611,55112,54165,-947
11656,0.0,0.0,0.0,3611,55116,54165,-951
11657,0.0,0.0,0.0,3611,55120,54165,-955
11658,0.0,0.0,0.0,3611,55124,54165,-959
11660,0.0,0.0,0.0,3611,55128,54165,-963
11661,0.0,0.0,0.0,3611,55132,54165,-967
11662,0.0,0.0,0.0,3611,55136,54165,-971
11663,0.0,0.0,0.0,3611,55140,54165,-975
11664,0.0,0.0,0.0,3611,55144,54165,-979
11665,0.0,0.0,0.0,3611,55148,54165,-983
11666,0.0,0.0,0.0,3611,55152,54165,-987
11667,0.0,0.0,0.0,3611,55156,54165,-991
11669,0.0,0.0,0.0,3611,55160,54165,-995
11670,0.0,0.0,0.0,3611,55164,54165,-999
11672,0.0,0.0,0.0,3611,55168,54165,-1003
11673,0.0,0.0,0.0,3611,55172,54165,-1007
11674,0.0,0.0,0.0,3611,55176,54165,-1011
11675,0.0,0.0,0.0,3611,55180,54165,-1015
11676,0.0,0.0,0.0,3611,55184,54165,-1019
11680,0.0,0.0,0.0,3611,55188,54165,-1023
11681,0.0,0.0,0.0,3611,55192,54165,-1027
11683,0.0,0.0,0.0,3611,55196,54165,-1031
11684,0.0,0.0,0.0,3611,55200,54165,-1035
11685,0.0,0.0,0.0,3611,55204,54165,-1039
11686,0.0,0.0,0.0,3611,55208,54165,-1043
11687,0.0,0.0,0.0,3611,55212,54165,-1047
11688,0.0,0.0,0.0,3611,55216,54165,-1051
11689,0.0,0.0,0.0,3611,55220,54165,-1055
11691,0.0,0.0,0.0,3611,55224,54165,-1059
11692,0.0,0.0,0.0,3611,55228,54165,-1063
11693,0.0,0.0,0.0,3611,55232,54165,-1067
11694,0.0,0.0,0.0,3611,55236,54165,-1071
11695,0.0,0.0,0.0,3611,55240,54165,-1075
11696,0.0,0.0,0.0,3611,55244,54165,-1079
11697,0.0,0.0,0.0,3611,55248,54165,-1083
11698,0.0,0.0,0.0,3611,55252,54165,-1087
11699,0.0,0.0,0.0,3611,55256,54165,-1091
11700,0.0,0.0,0.0,3611,55260,54165,-1095
11701,0.0,0.0,0.0,3611,55264,54165,-1099
11702,0.0,0.0,0.0,3611,55268,54165,-1103
11703,0.0,0.0,0.0,3611,55272,54165,-1107
11705,0.0,0.0,0.0,3611,55276,54165,-1111
11706,0.0,0.0,0.0,3611,55280,54165,-1115
11707,0.0,0.0,0.0,3611,55284,54165,-1119
11708,0.0,0.0,0.0,3611,55288,54165,-1123
11710,0.0,0.0,0.0,3611,55292,54165,-1127
11711,0.0,0.0,0.0,3611,55296,54165,-1131
11712,0.0,0.0,0.0,3611,55300,54165,-1135
11713,0.0,0.0,0.0,3611,55304,54165,-1139
11714,0.0,0.0,0.0,3611,55308,54165,-1143
11715,0.0,0.0,0.0,3611,55312,54165,-1147
11717,0.0,0.0,0.0,3611,55316,54165,-1151
11718,0.0,0.0,0.0,3611,55320,54165,-1155
11720,0.0,0.0,0.0,3611,55324,54165,-1159
11721,0.0,0.0,0.0,3611,55328,54165,-1163
11722,0.0,0.0,0.0,3611,55332,54165,-1167
11724,0.0,0.0,0.0,3611,55336,54165,-1171
11725,0.0,0.0,0.0,3611,55340,54165,-1175
11726,0.0,0.0,0.0,3611,55344,54165,-1179
11727,0.0,0.0,0.0,3611,55348,54165,-1183
11728,0.0,0.0,0.0,3611,55352,54165,-1187
11729,0.0,0.0,0.0,3611,55356,54165,-1191
11730,0.0,0.0,0.0,3611,55360,54165,-1195
11732,0.0,0.0,0.0,3611,55364,54165,-1199
11733,0.0,0.0,0.0,3611,55368,54165,-1203
11734,0.0,0.0,0.0,3611,55372,54165,-1207
11736,0.0,0.0,0.0,3611,55376,54165,-1211
11737,0.0,0.0,0.0,3611,55380,54165,-1215
11740,0.0,0.0,0.0,3611,55384,54165,-1219
11741,0.0,0.0,0.0,3611,55388,54165,-1223
11744,0.0,0.0,0.0,3611,55392,54165,-1227
11745,0.0,0.0,0.0,3611,55396,54165,-1231
11746,0.0,0.0,0.0,3611,55400,54165,-1235
11747,0.0,0.0,0.0,3611,55404,54165,-1239
11748,0.0,0.0,0.0,3611,55408,54165,-1243
11749,0.0,0.0,0.0,3611,55412,54165,-1247
11750,0.0,0.0,0.0,3611,55416,54165,-1251
11752,0.0,0.0,0.0,3611,55420,54165,-1255
11753,0.0,0.0,0.0,3611,55424,54165,-1259
11754,0.0,0.0,0.0,3611,55428,54165,-1263
11757,0.0,0.0,0.0,3611,55432,54165,-1267
11758,0.0,0.0,0.0,3611,55436,54165,-1271
11759,0.0,0.0,0.0,3611,55440,54165,-1275
11760,0.0,0.0,0.0,3611,55444,54165,-1279
11761,0.0,0.0,0.0,3611,55448,54165,-1283
11762,0.0,0.0,0.0,3611,55452,54165,-1287
11763,0.0,0.0,0.0,3611,55456,54165,-1291
11765,0.0,0.0,0.0,3611,55460,54165,-1295
11767,0.0,0.0,0.0,3611,55464,54165,-1299
11768,0.0,0.0,0.0,3611,55468,54165,-1303
11769,0.0,0.0,0.0,3611,55472,54165,-1307
11770,0.0,0.0,0.0,3611,55476,54165,-1311
11771,0.0,0.0,0.0,3611,55480,54165,-1315
11772,0.0,0.0,0.0,3611,55484,54165,-1319
11773,0.0,0.0,0.0,3611,55488,54165,-1323
11775,0.0,0.0,0.0,3611,55492,54165,-1327
11777,0.0,0.0,0.0,3611,55496,54165,-1331
11780,0.0,0.0,0.0,3611,55500,54165,-1335
11782,0.0,0.0,0.0,3611,55504,54165,-1339
11783,0.0,0.0,0.0,3611,55508,54165,-1343
11784,0.0,0.0,0.0,3611,55512,54165,-1347
11786,0.0,0.0,0.0,3611,55516,54165,-1351
11787,0.0,0.0,0.0,3611,55520,54165,-1355
11788,0.0,0.0,0.0,3611,55524,54165,-1359
11789,0.0,0.0,0.0,3611,55528,54165,-1363
11790,0.0,0.0,0.0,3611,55532,54165,-1367
11791,0.0,0.0,0.0,3611,55536,54165,-1371
11792,0.0,0.0,0.0,3611,55540,54165,-1375
11793,0.0,0.0,0.0,3611,55544,54165,-1379
11794,0.0,0.0,0.0,3611,55548,54165,-1383
11795,0.0,0.0,0.0,3611,55552,54165,-1387
11796,0.0,0.0,0.0,3611,55556,54165,-1391
11797,0.0,0.0,0.0,3611,55560,54165,-1395
11798,0.0,0.0,0.0,3611,55564,54165,-1399
11799,0.0,0.0,0.0,3611,55568,54165,-1403
11800,0.0,0.0,0.0,3611,55572,54165,-1407
11801,0.0,0.0,0.0,3611,55576,54165,-1411
11802,0.0,0.0,0.0,3611,55580,54165,-1415
11803,0.0,0.0,0.0,3611,55584,54165,-1419
11804,0.0,0.0,0.0,3611,55588,54165,-1423
11805,0.0,0.0,0.0,3611,55592,54165,-1427
11806,0.0,0.0,0.0,3611,55596,54165,-1431
11807,0.0,0.0,0.0,3611,55600,54165,-1435
11808,0.0,0.0,0.0,3611,55604,54165,-1439
11810,0.0,0.0,0.0,3611,55608,54165,-1443
11811,0.0,0.0,0.0,3611,55612,54165,-1447
11813,0.0,0.0,0.0,3611,55616,54165,-1451
11814,0.0,0.0,0.0,3611,55620,54165,-1455
11815,0.0,0.0,0.0,3611,55624,54165,-1459
11816,0.0,0.0,0.0,3611,55628,54165,-1463
11817,0.0,0.0,0.0,3611,55632,54165,-1467
11818,0.0,0.0,0.0,3611,55636,54165,-1471
11819,0.0,0.0,0.0,3611,55640,54165,-1475
11820,0.0,0.0,0.0,3611,55644,54165,-1479
11821,0.0,0.0,0.0,3611,55648,54165,-1483
11822,0.0,0.0,0.0,3611,55652,54165,-1487
11823,0.0,0.0,0.0,3611,55656,54165,-1491
11824,0.0,0.0,0.0,3611,55660,54165,-1495
11826,0.0,0.0,0.0,3611,55664,54165,-1499
11829,0.0,0.0,0.0,3611,55668,54165,-1503
11830,0.0,0.0,0.0,3611,55672,54165,-1507
11831,0.0,0.0,0.0,3611,55676,54165,-1511
11832,0.0,0.0,0.0,3611,55680,54165,-1515
11833,0.0,0.0,0.0,3611,55684,54165,-1519
11834,0.0,0.0,0.0,3611,55688,54165,-1523
11835,0.0,0.0,0.0,3611,55692,54165,-1527
11836,0.0,0.0,0.0,3611,55696,54165,-1531
11837,0.0,0.0,0.0,3611,55700,54165,-1535
11838,0.0,0.0,0.0,3611,55704,54165,-1539
11840,0.0,0.0,0.0,3611,55708,54165,-1543
11841,0.0,0.0,0.0,3611,55712,54165,-1547
11842,0.0,0.0,0.0,3611,55716,54165,-1551
11843,0.0,0.0,0.0,3611,55720,54165,-1555
11844,0.0,0.0,0.0,3611,55724,54165,-1559
11845,0.0,0.0,0.0,3611,55728,54165,-1563
11846,0.0,0.0,0.0,3611,55732,54165,-1567
11849,0.0,0.0,0.0,3611,55736,54165,-1571
11850,0.0,0.0,0.0,3611,55740,54165,-1575
11851,0.0,0.0,0.0,3611,55744,54165,-1579
11852,0.0,0.0,0.0,3611,55748,54165,-1583
11858,0.0,0.0,0.0,3611,55752,54165,-1587
11859,0.0,0.0,0.0,3611,55756,54165,-1591
11862,0.0,0.0,0.0,3611,55760,54165,-1595
11863,0.0,0.0,0.0,3611,55764,54165,-1599
11864,0.0,0.0,0.0,3611,55768,54165,-1603
11865,0.0,0.0,0.0,3611,55772,54165,-1607
11868,0.0,0.0,0.0,3611,55776,54165,-1611
11869,0.0,0.0,0.0,3611,55780,54165,-1615
11870,0.0,0.0,0.0,3611,55784,54165,-1619
11871,0.0,0.0,0.0,3611,55788,54165,-1623
11872,0.0,0.0,0.0,3611,55792,54165,-1627
11873,0.0,0.0,0.0,3611,55796,54165,-1631
11874,0.0,0.0,0.0,3611,55800,54165,-1635
11875,0.0,0.0,0.0,3611,55804,54165,-1639
11876,0.0,0.0,0.0,3611,55808,54165,-1643
11878,0.0,0.0,0.0,3611,55812,54165,-1647
11879,0.0,0.0,0.0,3611,55816,54165,-1651
11880,0.0,0.0,0.0,3611,55820,54165,-1655
11881,0.0,0.0,0.0,3611,55824,54165,-1659
11883,0.0,0.0,0.0,3611,55828,54165,-1663
11884,0.0,0.0,0.0,3611,55832,54165,-1667
11886,0.0,0.0,0.0,3611,55836,54165,-1671
11888,0.0,0.0,0.0,3611,55840,54165,-1675
11889,0.0,0.0,0.0,3611,55844,54165,-1679
11890,0.0,0.0,0.0,3611,55848,54165,-1683
11891,0.0,0.0,0.0,3611,55852,54165,-1687
11892,0.0,0.0,0.0,3611,55856,54165,-1691
11893,0.0,0.0,0.0,3611,55860,54165,-1695
11894,0.0,0.0,0.0,3611,55864,54165,-1699
11895,0.0,0.0,0.0,3611,55868,54165,-1703
11897,0.0,0.0,0.0,3611,55872,54165,-1707
11898,0.0,0.0,0.0,3611,55876,54165,-1711
11900,0.0,0.0,0.0,3611,55880,54165,-1715
11901,0.0,0.0,0.0,3611,55884,54165,-1719
11902,0.0,0.0,0.0,3611,55888,54165,-1723
11903,0.0,0.0,0.0,3611,55892,54165,-1727
11904,0.0,0.0,0.0,3611,55896,54165,-1731
11905,0.0,0.0,0.0,3611,55900,54165,-1735
11906,0.0,0.0,0.0,3611,55904,54165,-1739
11907,0.0,0.0,0.0,3611,55908,54165,-1743
11908,0.0,0.0,0.0,3611,55912,54165,-1747
11909,0.0,0.0,0.0,3611,55916,54165,-1751
11910,0.0,0.0,0.0,3611,55920,54165,-1755
11913,0.0,0.0,0.0,3611,55924,54165,-1759
11915,0.0,0.0,0.0,3611,55928,54165,-1763
11917,0.0,0.0,0.0,3611,55932,54165,-1767
11918,0.0,0.0,0.0,3611,55936,54165,-1771
11919,0.0,0.0,0.0,3611,55940,54165,-1775
11921,0.0,0.0,0.0,3611,55944,54165,-1779
11922,0.0,0.0,0.0,3611,55948,54165,-1783
11924,0.0,0.0,0.0,3611,55952,54165,-1787
11925,0.0,0.0,0.0,3611,55956,54165,-1791
11926,0.0,0.0,0.0,3611,55960,54165,-1795
11927,0.0,0.0,0.0,3611,55964,54165,-1799
11928,0.0,0.0,0.0,3611,55968,54165,-1803
11929,0.0,0.0,0.0,3611,55972,54165,-1807
11930,0.0,0.0,0.0,3611,55976,54165,-1811
11931,0.0,0.0,0.0,3611,55980,54165,-1815
11933,0.0,0.0,0.0,3611,55984,54165,-1819
11934,0.0,0.0,0.0,3611,55988,54165,-1823
11935,0.0,0.0,0.0,3611,55992,54165,-1827
11936,0.0,0.0,0.0,3611,55996,54165,-1831
11937,0.0,0.0,0.0,3611,56000,54165,-1835
11941,0.0,0.0,0.0,3611,56004,54165,-1839
11942,0.0,0.0,0.0,3611,56008,54165,-1843
11943,0.0,0.0,0.0,3611,56012,54165,-1847
11944,0.0,0.0,0.0,3611,56016,54165,-1851
11945,0.0,0.0,0.0,3611,56020,54165,-1855
11947,0.0,0.0,0.0,3611,56024,54165,-1859
11948,0.0,0.0,0.0,3611,56028,54165,-1863
11949,0.0,0.0,0.0,3611,56032,54165,-1867
11950,0.0,0.0,0.0,3611,56036,54165,-1871
11952,0.0,0.0,0.0,3611,56040,54165,-1875
11955,0.0,0.0,0.0,3611,56044,54165,-1879
11956,0.0,0.0,0.0,3611,56048,54165,-1883
11957,0.0,0.0,0.0,3611,56052,54165,-1887
11958,0.0,0.0,0.0,3611,56056,54165,-1891
11959,0.0,0.0,0.0,3611,56060,54165,-1895
11962,0.0,0.0,0.0,3611,56064,54165,-1899
11964,0.0,0.0,0.0,3611,56068,54165,-1903
11965,0.0,0.0,0.0,3611,56072,54165,-1907
11966,0.0,0.0,0.0,3611,56076,54165,-1911
11967,0.0,0.0,0.0,3611,56080,54165,-1915
11968,0.0,0.0,0.0,3611,56084,54165,-1919
11969,0.0,0.0,0.0,3611,56088,54165,-1923
11970,0.0,0.0,0.0,3611,56092,54165,-1927
11973,0.0,0.0,0.0,3611,56096,54165,-1931
11974,0.0,0.0,0.0,3611,56100,54165,-1935
11975,0.0,0.0,0.0,3611,56104,54165,-1939
11976,0.0,0.0,0.0,3611,56108,54165,-1943
11977,0.0,0.0,0.0,3611,56112,54165,-1947
11978,0.0,0.0,0.0,3611,56116,54165,-1951
11980,0.0,0.0,0.0,3611,56120,54165,-1955
11981,0.0,0.0,0.0,3611,56124,54165,-1959
11982,0.0,0.0,0.0,3611,56128,54165,-1963
11984,0.0,0.0,0.0,3611,56132,54165,-1967
11985,0.0,0.0,0.0,3611,56136,54165,-1971
11986,0.0,0.0,0.0,3611,56140,54165,-1975
11987,0.0,0.0,0.0,3611,56144,54165,-1979
11989,0.0,0.0,0.0,3611,56148,54165,-1983
11991,0.0,0.0,0.0,3611,56152,54165,-1987
11993,0.0,0.0,0.0,3611,56156,54165,-1991
11994,0.0,0.0,0.0,3611,56160,54165,-1995
11996,0.0,0.0,0.0,3611,56164,54165,-1999
11997,0.0,0.0,0.0,3611,56168,54165,-2003
11998,0.0,0.0,0.0,3611,56172,54165,-2007
11999,0.0,0.0,0.0,3611,56176,54165,-2011
12001,0.0,0.0,0.0,3611,56180,54165,-2015
12002,0.0,0.0,0.0,3611,56184,54165,-2019
12003,0.0,0.0,0.0,3611,56188,54165,-2023
12004,0.0,0.0,0.0,3611,56192,54165,-2027
12005,0.0,0.0,0.0,3611,56196,54165,-2031
12007,0.0,0.0,0.0,3611,56200,54165,-2035
12011,0.0,0.0,0.0,3611,56204,54165,-2039
12012,0.0,0.0,0.0,3611,56208,54165,-2043
12013,0.0,0.0,0.0,3611,56212,54165,-2047
12014,0.0,0.0,0.0,3611,56216,54165,-2051
12015,0.0,0.0,0.0,3611,56220,54165,-2055
12016,0.0,0.0,0.0,3611,56224,54165,-2059
12017,0.0,0.0,0.0,3611,56228,54165,-2063
12018,0.0,0.0,0.0,3611,56232,54165,-2067
12019,0.0,0.0,0.0,3611,56236,54165,-2071
12020,0.0,0.0,0.0,3611,56240,54165,-2075
12022,0.0,0.0,0.0,3611,56244,54165,-2079
12024,0.0,0.0,0.0,3611,56248,54165,-2083
12025,0.0,0.0,0.0,3611,56252,54165,-2087
12026,0.0,0.0,0.0,3611,56256,54165,-2091
12027,0.0,0.0,0.0,3611,56260,54165,-2095
12028,0.0,0.0,0.0,3611,56264,54165,-2099
12029,0.0,0.0,0.0,3611,56268,54165,-2103
12030,0.0,0.0,0.0,3611,56272,54165,-2107
12031,0.0,0.0,0.0,3611,56276,54165,-2111
12032,0.0,0.0,0.0,3611,56280,54165,-2115
12034,0.0,0.0,0.0,3611,56284,54165,-2119
12036,0.0,0.0,0.0,3611,56288,54165,-2123
12037,0.0,0.0,0.0,3611,56292,54165,-2127
12038,0.0,0.0,0.0,3611,56296,54165,-2131
12039,0.0,0.0,0.0,3611,56300,54165,-2135
12040,0.0,0.0,0.0,3611,56304,54165,-2139
12041,0.0,0.0,0.0,3611,56308,54165,-2143
12042,0.0,0.0,0.0,3611,56312,54165,-2147
12044,0.0,0.0,0.0,3611,56316,54165,-2151
12046,0.0,0.0,0.0,3611,56320,54165,-2155
12047,0.0,0.0,0.0,3611,56324,54165,-2159
12048,0.0,0.0,0.0,3611,56328,54165,-2163
12049,0.0,0.0,0.0,3611,56332,54165,-2167
12050,0.0,0.0,0.0,3611,56336,54165,-2171
12051,0.0,0.0,0.0,3611,56340,54165,-2175
12053,0.0,0.0,0.0,3611,56344,54165,-2179
12056,0.0,0.0,0.0,3611,56348,54165,-2183
12057,0.0,0.0,0.0,3611,56352,54165,-2187
12058,0.0,0.0,0.0,3611,56356,54165,-2191
12059,0.0,0.0,0.0,3611,56360,54165,-2195
12060,0.0,0.0,0.0,3611,56364,54165,-2199
12061,0.0,0.0,0.0,3611,56368,54165,-2203
12062,0.0,0.0,0.0,3611,56372,54165,-2207
12064,0.0,0.0,0.0,3611,56376,54165,-2211
12065,0.0,0.0,0.0,3611,56380,54165,-2215
12066,0.0,0.0,0.0,3611,56384,54165,-2219
12067,0.0,0.0,0.0,3611,56388,54165,-2223
12068,0.0,0.0,0.0,3611,56392,54165,-2227
12069,0.0,0.0,0.0,3611,56396,54165,-2231
12070,0.0,0.0,0.0,3611,56400,54165,-2235
12071,0.0,0.0,0.0,3611,56404,54165,-2239
12072,0.0,0.0,0.0,3611,56408,54165,-2243
12073,0.0,0.0,0.0,3611,56412,54165,-2247
12074,0.0,0.0,0.0,3611,56416,54165,-2251
12076,0.0,0.0,0.0,3611,56420,54165,-2255
12077,0.0,0.0,0.0,3611,56424,54165,-2259
12078,0.0,0.0,0.0,3611,56428,54165,-2263
12079,0.0,0.0,0.0,3611,56432,54165,-2267
12081,0.0,0.0,0.0,3611,56436,54165,-2271
12083,0.0,0.0,0.0,3611,56440,54165,-2275
12087,0.0,0.0,0.0,3611,56444,54165,-2279
12090,0.0,0.0,0.0,3611,56448,54165,-2283
12091,0.0,0.0,0.0,3611,56452,54165,-2287
12092,0.0,0.0,0.0,3611,56456,54165,-2291
12093,0.0,0.0,0.0,3611,56460,54165,-2295
12095,0.0,0.0,0.0,3611,56464,54165,-2299
12096,0.0,0.0,0.0,3611,56468,54165,-2303
12098,0.0,0.0,0.0,3611,56472,54165,-2307
12101,0.0,0.0,0.0,3611,56476,54165,-2311
12102,0.0,0.0,0.0,3611,56480,54165,-2315
12103,0.0,0.0,0.0,3611,56484,54165,-2319
12104,0.0,0.0,0.0,3611,56488,54165,-2323
12107,0.0,0.0,0.0,3611,56492,54165,-2327
12108,0.0,0.0,0.0,3611,56496,54165,-2331
12109,0.0,0.0,0.0,3611,56500,54165,-2335
12111,0.0,0.0,0.0,3611,56504,54165,-2339
12112,0.0,0.0,0.0,3611,56508,54165,-2343
12113,0.0,0.0,0.0,3611,56512,54165,-2347
12115,0.0,0.0,0.0,3611,56516,54165,-2351
12116,0.0,0.0,0.0,3611,56520,54165,-2355
12117,0.0,0.0,0.0,3611,56524,54165,-2359
12118,0.0,0.0,0.0,3611,56528,54165,-2363
12119,0.0,0.0,0.0,3611,56532,54165,-2367
12120,0.0,0.0,0.0,3611,56536,54165,-2371
12121,0.0,0.0,0.0,3611,56540,54165,-2375
12122,0.0,0.0,0.0,3611,56544,54165,-2379
12124,0.0,0.0,0.0,3611,56548,54165,-2383
12125,0.0,0.0,0.0,3611,56552,54165,-2387
12126,0.0,0.0,0.0,3611,56556,54165,-2391
12127,0.0,0.0,0.0,3611,56560,54165,-2395
12129,0.0,0.0,0.0,3611,56564,54165,-2399
12130,0.0,0.0,0.0,3611,56568,54165,-2403
12131,0.0,0.0,0.0,3611,56572,54165,-2407
12132,0.0,0.0,0.0,3611,56576,54165,-2411
12133,0.0,0.0,0.0,3611,56580,54165,-2415
12134,0.0,0.0,0.0,3611,56584,54165,-2419
12136,0.0,0.0,0.0,3611,56588,54165,-2423
12137,0.0,0.0,0.0,3611,56592,54165,-2427
12138,0.0,0.0,0.0,3611,56596,54165,-2431
12139,0.0,0.0,0.0,3611,56600,54165,-2435
12141,0.0,0.0,0.0,3611,56604,54165,-2439
12142,0.0,0.0,0.0,3611,56608,54165,-2443
12143,0.0,0.0,0.0,3611,56612,54165,-2447
12144,0.0,0.0,0.0,3611,56616,54165,-2451
12145,0.0,0.0,0.0,3611,56620,54165,-2455
12146,0.0,0.0,0.0,3611,56624,54165,-2459
12147,0.0,0.0,0.0,3611,56628,54165,-2463
12148,0.0,0.0,0.0,3611,56632,54165,-2467
12149,0.0,0.0,0.0,3611,56636,54165,-2471
12151,0.0,0.0,0.0,3611,56640,54165,-2475
12152,0.0,0.0,0.0,3611,56644,54165,-2479
12154,0.0,0.0,0.0,3611,56648,54165,-2483
12155,0.0,0.0,0.0,3611,56652,54165,-2487
12156,0.0,0.0,0.0,3611,56656,54165,-2491
12157,0.0,0.0,0.0,3611,56660,54165,-2495
12158,0.0,0.0,0.0,3611,56664,54165,-2499
12159,0.0,0.0,0.0,3611,56668,54165,-2503
12160,0.0,0.0,0.0,3611,56672,54165,-2507
12161,0.0,0.0,0.0,3611,56676,54165,-2511
12162,0.0,0.0,0.0,3611,56680,54165,-2515
12163,0.0,0.0,0.0,3611,56684,54165,-2519
12165,0.0,0.0,0.0,3611,56688,54165,-2523
12166,0.0,0.0,0.0,3611,56692,54165,-2527
12168,0.0,0.0,0.0,3611,56696,54165,-2531
12169,0.0,0.0,0.0,3611,56700,54165,-2535
12171,0.0,0.0,0.0,3611,56704,54165,-2539
12172,0.0,0.0,0.0,3611,56708,54165,-2543
12173,0.0,0.0,0.0,3611,56712,54165,-2547
12175,0.0,0.0,0.0,3611,56716,54165,-2551
12176,0.0,0.0,0.0,3611,56720,54165,-2555
12177,0.0,0.0,0.0,3611,56724,54165,-2559
12178,0.0,0.0,0.0,3611,56728,54165,-2563
12179,0.0,0.0,0.0,3611,56732,54165,-2567
12181,0.0,0.0,0.0,3611,56736,54165,-2571
12182,0.0,0.0,0.0,3611,56740,54165,-2575
12183,0.0,0.0,0.0,3611,56744,54165,-2579
12184,0.0,0.0,0.0,3611,56748,54165,-2583
12185,0.0,0.0,0.0,3611,56752,54165,-2587
12186,0.0,0.0,0.0,3611,56756,54165,-2591
12187,0.0,0.0,0.0,3611,56760,54165,-2595
12188,0.0,0.0,0.0,3611,56764,54165,-2599
12189,0.0,0.0,0.0,3611,56768,54165,-2603
12190,0.0,0.0,0.0,3611,56772,54165,-2607
12191,0.0,0.0,0.0,3611,56776,54165,-2611
12192,0.0,0.0,0.0,3611,56780,54165,-2615
12193,0.0,0.0,0.0,3611,56784,54165,-2619
12194,0.0,0.0,0.0,3611,56788,54165,-2623
12195,0.0,0.0,0.0,3611,56792,54165,-2627
12196,0.0,0.0,0.0,3611,56796,54165,-2631
12197,0.0,0.0,0.0,3611,56800,54165,-2635
12198,0.0,0.0,0.0,3611,56804,54165,-2639
12199,0.0,0.0,0.0,3611,56808,54165,-2643
12200,0.0,0.0,0.0,3611,56812,54165,-2647
12202,0.0,0.0,0.0,3611,56816,54165,-2651
12204,0.0,0.0,0.0,3611,56820,54165,-2655
12205,0.0,0.0,0.0,3611,56824,54165,-2659
12206,0.0,0.0,0.0,3611,56828,54165,-2663
12208,0.0,0.0,0.0,3611,56832,54165,-2667
12209,0.0,0.0,0.0,3611,56836,54165,-2671
12210,0.0,0.0,0.0,3611,56840,54165,-2675
12211,0.0,0.0,0.0,3611,56844,54165,-2679
12212,0.0,0.0,0.0,3611,56848,54165,-2683
12213,0.0,0.0,0.0,3611,56852,54165,-2687
12214,0.0,0.0,0.0,3611,56856,54165,-2691
12217,0.0,0.0,0.0,3611,56860,54165,-2695
12218,0.0,0.0,0.0,3611,56864,54165,-2699
12219,0.0,0.0,0.0,3611,56868,54165,-2703
12220,0.0,0.0,0.0,3611,56872,54165,-2707
12222,0.0,0.0,0.0,3611,56876,54165,-2711
12223,0.0,0.0,0.0,3611,56880,54165,-2715
12224,0.0,0.0,0.0,3611,56884,54165,-2719
12225,0.0,0.0,0.0,3611,56888,54165,-2723
12227,0.0,0.0,0.0,3611,56892,54165,-2727
12228,0.0,0.0,0.0,3611,56896,54165,-2731
12230,0.0,0.0,0.0,3611,56900,54165,-2735
12231,0.0,0.0,0.0,3611,56904,54165,-2739
12232,0.0,0.0,0.0,3611,56908,54165,-2743
12233,0.0,0.0,0.0,3611,56912,54165,-2747
12234,0.0,0.0,0.0,3611,56916,54165,-2751
12235,0.0,0.0,0.0,3611,56920,54165,-2755
12237,0.0,0.0,0.0,3611,56924,54165,-2759
12238,0.0,0.0,0.0,3611,56928,54165,-2763
12239,0.0,0.0,0.0,3611,56932,54165,-2767
12240,0.0,0.0,0.0,3611,56936,54165,-2771
12241,0.0,0.0,0.0,3611,56940,54165,-2775
12242,0.0,0.0,0.0,3611,56944,54165,-2779
12244,0.0,0.0,0.0,3611,56948,54165,-2783
12245,0.0,0.0,0.0,3611,56952,54165,-2787
12246,0.0,0.0,0.0,3611,56956,54165,-2791
12247,0.0,0.0,0.0,3611,56960,54165,-2795
12249,0.0,0.0,0.0,3611,56964,54165,-2799
12250,0.0,0.0,0.0,3611,56968,54165,-2803
12252,0.0,0.0,0.0,3611,56972,54165,-2807
12253,0.0,0.0,0.0,3611,56976,54165,-2811
12254,0.0,0.0,0.0,3611,56980,54165,-2815
12255,0.0,0.0,0.0,3611,56984,54165,-2819
12256,0.0,0.0,0.0,3611,56988,54165,-2823
12257,0.0,0.0,0.0,3611,56992,54165,-2827
12258,0.0,0.0,0.0,3611,56996,54165,-2831
12260,0.0,0.0,0.0,3611,57000,54165,-2835
12261,0.0,0.0,0.0,3611,57004,54165,-2839
12262,0.0,0.0,0.0,3611,57008,54165,-2843
12263,0.0,0.0,0.0,3611,57012,54165,-2847
12265,0.0,0.0,0.0,3611,57016,54165,-2851
12266,0.0,0.0,0.0,3611,57020,54165,-2855
12269,0.0,0.0,0.0,3611,57024,54165,-2859
12270,0.0,0.0,0.0,3611,57028,54165,-2863
12271,0.0,0.0,0.0,3611,57032,54165,-2867
12272,0.0,0.0,0.0,3611,57036,54165,-2871
12274,0.0,0.0,0.0,3611,57040,54165,-2875
12275,0.0,0.0,0.0,3611,57044,54165,-2879
12276,0.0,0.0,0.0,3611,57048,54165,-2883
12279,0.0,0.0,0.0,3611,57052,54165,-2887
12280,0.0,0.0,0.0,3611,57056,54165,-2891
12281,0.0,0.0,0.0,3611,57060,54165,-2895
12282,0.0,0.0,0.0,3611,57064,54165,-2899
12284,0.0,0.0,0.0,3611,57068,54165,-2903
12285,0.0,0.0,0.0,3611,57072,54165,-2907
12288,0.0,0.0,0.0,3611,57076,54165,-2911
12289,0.0,0.0,0.0,3611,57080,54165,-2915
12290,0.0,0.0,0.0,3611,57084,54165,-2919
12292,0.0,0.0,0.0,3611,57088,54165,-2923
12293,0.0,0.0,0.0,3611,57092,54165,-2927
12294,0.0,0.0,0.0,3611,57096,54165,-2931
12296,0.0,0.0,0.0,3611,57100,54165,-2935
12297,0.0,0.0,0.0,3611,57104,54165,-2939
12299,0.0,0.0,0.0,3611,57108,54165,-2943
12301,0.0,0.0,0.0,3611,57112,54165,-2947
12302,0.0,0.0,0.0,3611,57116,54165,-2951
12303,0.0,0.0,0.0,3611,57120,54165,-2955
12304,0.0,0.0,0.0,3611,57124,54165,-2959
12305,0.0,0.0,0.0,3611,57128,54165,-2963
12306,0.0,0.0,0.0,3611,57132,54165,-2967
12307,0.0,0.0,0.0,3611,57136,54165,-2971
12308,0.0,0.0,0.0,3611,57140,54165,-2975
12309,0.0,0.0,0.0,3611,57144,54165,-2979
12311,0.0,0.0,0.0,3611,57148,54165,-2983
12312,0.0,0.0,0.0,3611,57152,54165,-2987
12313,0.0,0.0,0.0,3611,57156,54165,-2991
12314,0.0,0.0,0.0,3611,57160,54165,-2995
12315,0.0,0.0,0.0,3611,57164,54165,-2999
12316,0.0,0.0,0.0,3611,57168,54165,-3003
12318,0.0,0.0,0.0,3611,57172,54165,-3007
12319,0.0,0.0,0.0,3611,57176,54165,-3011
12320,0.0,0.0,0.0,3611,57180,54165,-3015
12321,0.0,0.0,0.0,3611,57184,54165,-3019
12323,0.0,0.0,0.0,3611,57188,54165,-3023
12324,0.0,0.0,0.0,3611,57192,54165,-3027
12325,0.0,0.0,0.0,3611,57196,54165,-3031
12326,0.0,0.0,0.0,3611,57200,54165,-3035
12328,0.0,0.0,0.0,3611,57204,54165,-3039
12329,0.0,0.0,0.0,3611,57208,54165,-3043
12331,0.0,0.0,0.0,3611,57212,54165,-3047
12332,0.0,0.0,0.0,3611,57216,54165,-3051
12334,0.0,0.0,0.0,3611,57220,54165,-3055
12335,0.0,0.0,0.0,3611,57224,54165,-3059
12336,0.0,0.0,0.0,3611,57228,54165,-3063
12337,0.0,0.0,0.0,3611,57232,54165,-3067
12338,0.0,0.0,0.0,3611,57236,54165,-3071
12339,0.0,0.0,0.0,3611,57240,54165,-3075
12340,0.0,0.0,0.0,3611,57244,54165,-3079
12341,0.0,0.0,0.0,3611,57248,54165,-3083
12342,0.0,0.0,0.0,3611,57252,54165,-3087
12343,0.0,0.0,0.0,3611,57256,54165,-3091
12344,0.0,0.0,0.0,3611,57260,54165,-3095
12345,0.0,0.0,0.0,3611,57264,54165,-3099
12347,0.0,0.0,0.0,3611,57268,54165,-3103
12348,0.0,0.0,0.0,3611,57272,54165,-3107
12350,0.0,0.0,0.0,3611,57276,54165,-3111
12351,0.0,0.0,0.0,3611,57280,54165,-3115
12352,0.0,0.0,0.0,3611,57284,54165,-3119
12353,0.0,0.0,0.0,3611,57288,54165,-3123
12354,0.0,0.0,0.0,3611,57292,54165,-3127
12355,0.0,0.0,0.0,3611,57296,54165,-3131
12356,0.0,0.0,0.0,3611,57300,54165,-3135
12357,0.0,0.0,0.0,3611,57304,54165,-3139
12358,0.0,0.0,0.0,3611,57308,54165,-3143
12359,0.0,0.0,0.0,3611,57312,54165,-3147
12362,0.0,0.0,0.0,3611,57316,54165,-3151
12363,0.0,0.0,0.0,3611,57320,54165,-3155
12364,0.0,0.0,0.0,3611,57324,54165,-3159
12369,0.0,0.0,0.0,3611,57328,54165,-3163
12370,0.0,0.0,0.0,3611,57332,54165,-3167
12371,0.0,0.0,0.0,3611,57336,54165,-3171
12372,0.0,0.0,0.0,3611,57340,54165,-3175
12373,0.0,0.0,0.0,3611,57344,54165,-3179
12374,0.0,0.0,0.0,3611,57348,54165,-3183
12375,0.0,0.0,0.0,3611,57352,54165,-3187
12376,0.0,0.0,0.0,3611,57356,54165,-3191
12377,0.0,0.0,0.0,3611,57360,54165,-3195
12378,0.0,0.0,0.0,3611,57364,54165,-3199
12381,0.0,0.0,0.0,3611,57368,54165,-3203
12382,0.0,0.0,0.0,3611,57372,54165,-3207
12383,0.0,0.0,0.0,3611,57376,54165,-3211
12384,0.0,0.0,0.0,3611,57380,54165,-3215
12385,0.0,0.0,0.0,3611,57384,54165,-3219
12386,0.0,0.0,0.0,3611,57388,54165,-3223
12387,0.0,0.0,0.0,3611,57392,54165,-3227
12388,0.0,0.0,0.0,3611,57396,54165,-3231
12390,0.0,0.0,0.0,3611,57400,54165,-3235
12391,0.0,0.0,0.0,3611,57404,54165,-3239
12393,0.0,0.0,0.0,3611,57408,54165,-3243
12394,0.0,0.0,0.0,3611,57412,54165,-3247
12395,0.0,0.0,0.0,3611,57416,54165,-3251
12397,0.0,0.0,0.0,3611,57420,54165,-3255
12398,0.0,0.0,0.0,3611,57424,54165,-3259
12399,0.0,0.0,0.0,3611,57428,54165,-3263
12401,0.0,0.0,0.0,3611,57432,54165,-3267
12402,0.0,0.0,0.0,3611,57436,54165,-3271
12404,0.0,0.0,0.0,3611,57440,54165,-3275
12405,0.0,0.0,0.0,3611,57444,54165,-3279
12406,0.0,0.0,0.0,3611,57448,54165,-3283
12407,0.0,0.0,0.0,3611,57452,54165,-3287
12409,0.0,0.0,0.0,3611,57456,54165,-3291
12410,0.0,0.0,0.0,3611,57460,54165,-3295
12411,0.0,0.0,0.0,3611,57464,54165,-3299
12412,0.0,0.0,0.0,3611,57468,54165,-3303
12414,0.0,0.0,0.0,3611,57472,54165,-3307
12417,0.0,0.0,0.0,3611,57476,54165,-3311
12418,0.0,0.0,0.0,3611,57480,54165,-3315
12419,0.0,0.0,0.0,3611,57484,54165,-3319
12421,0.0,0.0,0.0,3611,57488,54165,-3323
12422,0.0,0.0,0.0,3611,57492,54165,-3327
12423,0.0,0.0,0.0,3611,57496,54165,-3331
12424,0.0,0.0,0.0,3611,57500,54165,-3335
12425,0.0,0.0,0.0,3611,57504,54165,-3339
12427,0.0,0.0,0.0,3611,57508,54165,-3343
12428,0.0,0.0,0.0,3611,57512,54165,-3347
12429,0.0,0.0,0.0,3611,57516,54165,-3351
12431,0.0,0.0,0.0,3611,57520,54165,-3355
12432,0.0,0.0,0.0,3611,57524,54165,-3359
12433,0.0,0.0,0.0,3611,57528,54165,-3363
12434,0.0,0.0,0.0,3611,57532,54165,-3367
12435,0.0,0.0,0.0,3611,57536,54165,-3371
12436,0.0,0.0,0.0,3611,57540,54165,-3375
12437,0.0,0.0,0.0,3611,57544,54165,-3379
12438,0.0,0.0,0.0,3611,57548,54165,-3383
12440,0.0,0.0,0.0,3611,57552,54165,-3387
12441,0.0,0.0,0.0,3611,57556,54165,-3391
12443,0.0,0.0,0.0,3611,57560,54165,-3395
12445,0.0,0.0,0.0,3611,57564,54165,-3399
12446,0.0,0.0,0.0,3611,57568,54165,-3403
12447,0.0,0.0,0.0,3611,57572,54165,-3407
12448,0.0,0.0,0.0,3611,57576,54165,-3411
12449,0.0,0.0,0.0,3611,57580,54165,-3415
12452,0.0,0.0,0.0,3611,57584,54165,-3419
12453,0.0,0.0,0.0,3611,57588,54165,-3423
12455,0.0,0.0,0.0,3611,57592,54165,-3427
12456,0.0,0.0,0.0,3611,57596,54165,-3431
12457,0.0,0.0,0.0,3611,57600,54165,-3435
12458,0.0,0.0,0.0,3611,57604,54165,-3439
12459,0.0,0.0,0.0,3611,57608,54165,-3443
12461,0.0,0.0,0.0,3611,57612,54165,-3447
12462,0.0,0.0,0.0,3611,57616,54165,-3451
12464,0.0,0.0,0.0,3611,57620,54165,-3455
12465,0.0,0.0,0.0,3611,57624,54165,-3459
12466,0.0,0.0,0.0,3611,57628,54165,-3463
12467,0.0,0.0,0.0,3611,57632,54165,-3467
12468,0.0,0.0,0.0,3611,57636,54165,-3471
12470,0.0,0.0,0.0,3611,57640,54165,-3475
12471,0.0,0.0,0.0,3611,57644,54165,-3479
12472,0.0,0.0,0.0,3611,57648,54165,-3483
12473,0.0,0.0,0.0,3611,57652,54165,-3487
12474,0.0,0.0,0.0,3611,57656,54165,-3491
12475,0.0,0.0,0.0,3611,57660,54165,-3495
12476,0.0,0.0,0.0,3611,57664,54165,-3499
12477,0.0,0.0,0.0,3611,57668,54165,-3503
12478,0.0,0.0,0.0,3611,57672,54165,-3507
12481,0.0,0.0,0.0,3611,57676,54165,-3511
12486,0.0,0.0,0.0,3611,57680,54165,-3515
12487,0.0,0.0,0.0,3611,57684,54165,-3519
12488,0.0,0.0,0.0,3611,57688,54165,-3523
12490,0.0,0.0,0.0,3611,57692,54165,-3527
12491,0.0,0.0,0.0,3611,57696,54165,-3531
12492,0.0,0.0,0.0,3611,57700,54165,-3535
12493,0.0,0.0,0.0,3611,57704,54165,-3539
12494,0.0,0.0,0.0,3611,57708,54165,-3543
12496,0.0,0.0,0.0,3611,57712,54165,-3547
12498,0.0,0.0,0.0,3611,57716,54165,-3551
12501,0.0,0.0,0.0,3611,57720,54165,-3555
12502,0.0,0.0,0.0,3611,57724,54165,-3559
12503,0.0,0.0,0.0,3611,57728,54165,-3563
12504,0.0,0.0,0.0,3611,57732,54165,-3567
12505,0.0,0.0,0.0,3611,57736,54165,-3571
12506,0.0,0.0,0.0,3611,57740,54165,-3575
12507,0.0,0.0,0.0,3611,57744,54165,-3579
12508,0.0,0.0,0.0,3611,57748,54165,-3583
12509,0.0,0.0,0.0,3611,57752,54165,-3587
12510,0.0,0.0,0.0,3611,57756,54165,-3591
12511,0.0,0.0,0.0,3611,57760,54165,-3595
12515,0.0,0.0,0.0,3611,57764,54165,-3599
12516,0.0,0.0,0.0,3611,57768,54165,-3603
12517,0.0,0.0,0.0,3611,57772,54165,-3607
12519,0.0,0.0,0.0,3611,57776,54165,-3611
12520,0.0,0.0,0.0,3611,57780,54165,-3615
12521,0.0,0.0,0.0,3611,57784,54165,-3619
12523,0.0,0.0,0.0,3611,57788,54165,-3623
12526,0.0,0.0,0.0,3611,57792,54165,-3627
12528,0.0,0.0,0.0,3611,57796,54165,-3631
12529,0.0,0.0,0.0,3611,57800,54165,-3635
12531,0.0,0.0,0.0,3611,57804,54165,-3639
12533,0.0,0.0,0.0,3611,57808,54165,-3643
12534,0.0,0.0,0.0,3611,57812,54165,-3647
12538,0.0,0.0,0.0,3611,57816,54165,-3651
12539,0.0,0.0,0.0,3611,57820,54165,-3655
12541,0.0,0.0,0.0,3611,57824,54165,-3659
12542,0.0,0.0,0.0,3611,57828,54165,-3663
12543,0.0,0.0,0.0,3611,57832,54165,-3667
12544,0.0,0.0,0.0,3611,57836,54165,-3671
12546,0.0,0.0,0.0,3611,57840,54165,-3675
12547,0.0,0.0,0.0,3611,57844,54165,-3679
12548,0.0,0.0,0.0,3611,57848,54165,-3683
12549,0.0,0.0,0.0,3611,57852,54165,-3687
12551,0.0,0.0,0.0,3611,57856,54165,-3691
12552,0.0,0.0,0.0,3611,57860,54165,-3695
12553,0.0,0.0,0.0,3611,57864,54165,-3699
12554,0.0,0.0,0.0,3611,57868,54165,-3703
12555,0.0,0.0,0.0,3611,57872,54165,-3707
12556,0.0,0.0,0.0,3611,57876,54165,-3711
12557,0.0,0.0,0.0,3611,57880,54165,-3715
12559,0.0,0.0,0.0,3611,57884,54165,-3719
12560,0.0,0.0,0.0,3611,57888,54165,-3723
12561,0.0,0.0,0.0,3611,57892,54165,-3727
12562,0.0,0.0,0.0,3611,57896,54165,-3731
12563,0.0,0.0,0.0,3611,57900,54165,-3735
12564,0.0,0.0,0.0,3611,57904,54165,-3739
12565,0.0,0.0,0.0,3611,57908,54165,-3743
12566,0.0,0.0,0.0,3611,57912,54165,-3747
12568,0.0,0.0,0.0,3611,57916,54165,-3751
12571,0.0,0.0,0.0,3611,57920,54165,-3755
12572,0.0,0.0,0.0,3611,57924,54165,-3759
12574,0.0,0.0,0.0,3611,57928,54165,-3763
12575,0.0,0.0,0.0,3611,57932,54165,-3767
12576,0.0,0.0,0.0,3611,57936,54165,-3771
12577,0.0,0.0,0.0,3611,57940,54165,-3775
12578,0.0,0.0,0.0,3611,57944,54165,-3779
12579,0.0,0.0,0.0,3611,57948,54165,-3783
12583,0.0,0.0,0.0,3611,57952,54165,-3787
12584,0.0,0.0,0.0,3611,57956,54165,-3791
12585,0.0,0.0,0.0,3611,57960,54165,-3795
12586,0.0,0.0,0.0,3611,57964,54165,-3799
12588,0.0,0.0,0.0,3611,57968,54165,-3803
12590,0.0,0.0,0.0,3611,57972,54165,-3807
12591,0.0,0.0,0.0,3611,57976,54165,-3811
12592,0.0,0.0,0.0,3611,57980,54165,-3815
12594,0.0,0.0,0.0,3611,57984,54165,-3819
12596,0.0,0.0,0.0,3611,57988,54165,-3823
12597,0.0,0.0,0.0,3611,57992,54165,-3827
12598,0.0,0.0,0.0,3611,57996,54165,-3831
12599,0.0,0.0,0.0,3611,58000,54165,-3835
12601,0.0,0.0,0.0,3611,58004,54165,-3839
12602,0.0,0.0,0.0,3611,58008,54165,-3843
12603,0.0,0.0,0.0,3611,58012,54165,-3847
12604,0.0,0.0,0.0,3611,58016,54165,-3851
12605,0.0,0.0,0.0,3611,58020,54165,-3855
12606,0.0,0.0,0.0,3611,58024,54165,-3859
12610,0.0,0.0,0.0,3611,58028,54165,-3863
12611,0.0,0.0,0.0,3611,58032,54165,-3867
12612,0.0,0.0,0.0,3611,58036,54165,-3871
12613,0.0,0.0,0.0,3611,58040,54165,-3875
12614,0.0,0.0,0.0,3611,58044,54165,-3879
12616,0.0,0.0,0.0,3611,58048,54165,-3883
12617,0.0,0.0,0.0,3611,58052,54165,-3887
12618,0.0,0.0,0.0,3611,58056,54165,-3891
12622,0.0,0.0,0.0,3611,58060,54165,-3895
12624,0.0,0.0,0.0,3611,58064,54165,-3899
12625,0.0,0.0,0.0,3611,58068,54165,-3903
12627,0.0,0.0,0.0,3611,58072,54165,-3907
12628,0.0,0.0,0.0,3611,58076,54165,-3911
12629,0.0,0.0,0.0,3611,58080,54165,-3915
12630,0.0,0.0,0.0,3611,58084,54165,-3919
12631,0.0,0.0,0.0,3611,58088,54165,-3923
12632,0.0,0.0,0.0,3611,58092,54165,-3927
12633,0.0,0.0,0.0,3611,58096,54165,-3931
12634,0.0,0.0,0.0,3611,58100,54165,-3935
12635,0.0,0.0,0.0,3611,58104,54165,-3939
12636,0.0,0.0,0.0,3611,58108,54165,-3943
12637,0.0,0.0,0.0,3611,58112,54165,-3947
12640,0.0,0.0,0.0,3611,58116,54165,-3951
12641,0.0,0.0,0.0,3611,58120,54165,-3955
12644,0.0,0.0,0.0,3611,58124,54165,-3959
12645,0.0,0.0,0.0,3611,58128,54165,-3963
12646,0.0,0.0,0.0,3611,58132,54165,-3967
12647,0.0,0.0,0.0,3611,58136,54165,-3971
12649,0.0,0.0,0.0,3611,58140,54165,-3975
12651,0.0,0.0,0.0,3611,58144,54165,-3979
12652,0.0,0.0,0.0,3611,58148,54165,-3983
12653,0.0,0.0,0.0,3611,58152,54165,-3987
12655,0.0,0.0,0.0,3611,58156,54165,-3991
12656,0.0,0.0,0.0,3611,58160,54165,-3995
12658,0.0,0.0,0.0,3611,58164,54165,-3999
12659,0.0,0.0,0.0,3611,58168,54165,-4003
12660,0.0,0.0,0.0,3611,58172,54165,-4007
12661,0.0,0.0,0.0,3611,58176,54165,-4011
12663,0.0,0.0,0.0,3611,58180,54165,-4015
12665,0.0,0.0,0.0,3611,58184,54165,-4019
12666,0.0,0.0,0.0,3611,58188,54165,-4023
12667,0.0,0.0,0.0,3611,58192,54165,-4027
12669,0.0,0.0,0.0,3611,58196,54165,-4031
12670,0.0,0.0,0.0,3611,58200,54165,-4035
12673,0.0,0.0,0.0,3611,58204,54165,-4039
12674,0.0,0.0,0.0,3611,58208,54165,-4043
12675,0.0,0.0,0.0,3611,58212,54165,-4047
12676,0.0,0.0,0.0,3611,58216,54165,-4051
12677,0.0,0.0,0.0,3611,58220,54165,-4055
12679,0.0,0.0,0.0,3611,58224,54165,-4059
12680,0.0,0.0,0.0,3611,58228,54165,-4063
12681,0.0,0.0,0.0,3611,58232,54165,-4067
12682,0.0,0.0,0.0,3611,58236,54165,-4071
12683,0.0,0.0,0.0,3611,58240,54165,-4075
12685,0.0,0.0,0.0,3611,58244,54165,-4079
12687,0.0,0.0,0.0,3611,58248,54165,-4083
12688,0.0,0.0,0.0,3611,58252,54165,-4087
12689,0.0,0.0,0.0,3611,58256,54165,-4091
12691,0.0,0.0,0.0,3611,58260,54165,-4095
12692,0.0,0.0,0.0,3611,58264,54165,-4099
12693,0.0,0.0,0.0,3611,58268,54165,-4103
12694,0.0,0.0,0.0,3611,58272,54165,-4107
12695,0.0,0.0,0.0,3611,58276,54165,-4111
12696,0.0,0.0,0.0,3611,58280,54165,-4115
12698,0.0,0.0,0.0,3611,58284,54165,-4119
12700,0.0,0.0,0.0,3611,58288,54165,-4123
12701,0.0,0.0,0.0,3611,58292,54165,-4127
12702,0.0,0.0,0.0,3611,58296,54165,-4131
12703,0.0,0.0,0.0,3611,58300,54165,-4135
12704,0.0,0.0,0.0,3611,58304,54165,-4139
12707,0.0,0.0,0.0,3611,58308,54165,-4143
12708,0.0,0.0,0.0,3611,58312,54165,-4147
12710,0.0,0.0,0.0,3611,58316,54165,-4151
12714,0.0,0.0,0.0,3611,58320,54165,-4155
12716,0.0,0.0,0.0,3611,58324,54165,-4159
12717,0.0,0.0,0.0,3611,58328,54165,-4163
12718,0.0,0.0,0.0,3611,58332,54165,-4167
12721,0.0,0.0,0.0,3611,58336,54165,-4171
12722,0.0,0.0,0.0,3611,58340,54165,-4175
12723,0.0,0.0,0.0,3611,58344,54165,-4179
12725,0.0,0.0,0.0,3611,58348,54165,-4183
12727,0.0,0.0,0.0,3611,58352,54165,-4187
12728,0.0,0.0,0.0,3611,58356,54165,-4191
12729,0.0,0.0,0.0,3611,58360,54165,-4195
12730,0.0,0.0,0.0,3611,58364,54165,-4199
12731,0.0,0.0,0.0,3611,58368,54165,-4203
12732,0.0,0.0,0.0,3611,58372,54165,-4207
12734,0.0,0.0,0.0,3611,58376,54165,-4211
12735,0.0,0.0,0.0,3611,58380,54165,-4215
12737,0.0,0.0,0.0,3611,58384,54165,-4219
12738,0.0,0.0,0.0,3611,58388,54165,-4223
12739,0.0,0.0,0.0,3611,58392,54165,-4227
12740,0.0,0.0,0.0,3611,58396,54165,-4231
12741,0.0,0.0,0.0,3611,58400,54165,-4235
12742,0.0,0.0,0.0,3611,58404,54165,-4239
12743,0.0,0.0,0.0,3611,58408,54165,-4243
12745,0.0,0.0,0.0,3611,58412,54165,-4247
12746,0.0,0.0,0.0,3611,58416,54165,-4251
12747,0.0,0.0,0.0,3611,58420,54165,-4255
12748,0.0,0.0,0.0,3611,58424,54165,-4259
12751,0.0,0.0,0.0,3611,58428,54165,-4263
12752,0.0,0.0,0.0,3611,58432,54165,-4267
12753,0.0,0.0,0.0,3611,58436,54165,-4271
12754,0.0,0.0,0.0,3611,58440,54165,-4275
12755,0.0,0.0,0.0,3611,58444,54165,-4279
12756,0.0,0.0,0.0,3611,58448,54165,-4283
12759,0.0,0.0,0.0,3611,58452,54165,-4287
12760,0.0,0.0,0.0,3611,58456,54165,-4291
12763,0.0,0.0,0.0,3611,58460,54165,-4295
12765,0.0,0.0,0.0,3611,58464,54165,-4299
12766,0.0,0.0,0.0,3611,58468,54165,-4303
12768,0.0,0.0,0.0,3611,58472,54165,-4307
12769,0.0,0.0,0.0,3611,58476,54165,-4311
12770,0.0,0.0,0.0,3611,58480,54165,-4315
12771,0.0,0.0,0.0,3611,58484,54165,-4319
12772,0.0,0.0,0.0,3611,58488,54165,-4323
12773,0.0,0.0,0.0,3611,58492,54165,-4327
12774,0.0,0.0,0.0,3611,58496,54165,-4331
12776,0.0,0.0,0.0,3611,58500,54165,-4335
12777,0.0,0.0,0.0,3611,58504,54165,-4339
12778,0.0,0.0,0.0,3611,58508,54165,-4343
12780,0.0,0.0,0.0,3611,58512,54165,-4347
12781,0.0,0.0,0.0,3611,58516,54165,-4351
12782,0.0,0.0,0.0,3611,58520,54165,-4355
12784,0.0,0.0,0.0,3611,58524,54165,-4359
12785,0.0,0.0,0.0,3611,58528,54165,-4363
12786,0.0,0.0,0.0,3611,58532,54165,-4367
12787,0.0,0.0,0.0,3611,58536,54165,-4371
12788,0.0,0.0,0.0,3611,58540,54165,-4375
12789,0.0,0.0,0.0,3611,58544,54165,-4379
12790,0.0,0.0,0.0,3611,58548,54165,-4383
12791,0.0,0.0,0.0,3611,58552,54165,-4387
12792,0.0,0.0,0.0,3611,58556,54165,-4391
12794,0.0,0.0,0.0,3611,58560,54165,-4395
12795,0.0,0.0,0.0,3611,58564,54165,-4399
12796,0.0,0.0,0.0,3611,58568,54165,-4403
12797,0.0,0.0,0.0,3611,58572,54165,-4407
12798,0.0,0.0,0.0,3611,58576,54165,-4411
12801,0.0,0.0,0.0,3611,58580,54165,-4415
12804,0.0,0.0,0.0,3611,58584,54165,-4419
12806,0.0,0.0,0.0,3611,58588,54165,-4423
12807,0.0,0.0,0.0,3611,58592,54165,-4427
12809,0.0,0.0,0.0,3611,58596,54165,-4431
12810,0.0,0.0,0.0,3611,58600,54165,-4435
12811,0.0,0.0,0.0,3611,58604,54165,-4439
12813,0.0,0.0,0.0,3611,58608,54165,-4443
12814,0.0,0.0,0.0,3611,58612,54165,-4447
12816,0.0,0.0,0.0,3611,58616,54165,-4451
12819,0.0,0.0,0.0,3611,58620,54165,-4455
12821,0.0,0.0,0.0,3611,58624,54165,-4459
12822,0.0,0.0,0.0,3611,58628,54165,-4463
12823,0.0,0.0,0.0,3611,58632,54165,-4467
12827,0.0,0.0,0.0,3611,58636,54165,-4471
12828,0.0,0.0,0.0,3611,58640,54165,-4475
12829,0.0,0.0,0.0,3611,58644,54165,-4479
12830,0.0,0.0,0.0,3611,58648,54165,-4483
12831,0.0,0.0,0.0,3611,58652,54165,-4487
12832,0.0,0.0,0.0,3611,58656,54165,-4491
12833,0.0,0.0,0.0,3611,58660,54165,-4495
12834,0.0,0.0,0.0,3611,58664,54165,-4499
12835,0.0,0.0,0.0,3611,58668,54165,-4503
12836,0.0,0.0,0.0,3611,58672,54165,-4507
12837,0.0,0.0,0.0,3611,58676,54165,-4511
12838,0.0,0.0,0.0,3611,58680,54165,-4515
12839,0.0,0.0,0.0,3611,58684,54165,-4519
12841,0.0,0.0,0.0,3611,58688,54165,-4523
12842,0.0,0.0,0.0,3611,58692,54165,-4527
12843,0.0,0.0,0.0,3611,58696,54165,-4531
12844,0.0,0.0,0.0,3611,58700,54165,-4535
12845,0.0,0.0,0.0,3611,58704,54165,-4539
12846,0.0,0.0,0.0,3611,58708,54165,-4543
12847,0.0,0.0,0.0,3611,58712,54165,-4547
12848,0.0,0.0,0.0,3611,58716,54165,-4551
12849,0.0,0.0,0.0,3611,58720,54165,-4555
12850,0.0,0.0,0.0,3611,58724,54165,-4559
12851,0.0,0.0,0.0,3611,58728,54165,-4563
12852,0.0,0.0,0.0,3611,58732,54165,-4567
12854,0.0,0.0,0.0,3611,58736,54165,-4571
12855,0.0,0.0,0.0,3611,58740,54165,-4575
12858,0.0,0.0,0.0,3611,58744,54165,-4579
12859,0.0,0.0,0.0,3611,58748,54165,-4583
12860,0.0,0.0,0.0,3611,58752,54165,-4587
12861,0.0,0.0,0.0,3611,58756,54165,-4591
12862,0.0,0.0,0.0,3611,58760,54165,-4595
12863,0.0,0.0,0.0,3611,58764,54165,-4599
12864,0.0,0.0,0.0,3611,58768,54165,-4603
12865,0.0,0.0,0.0,3611,58772,54165,-4607
12867,0.0,0.0,0.0,3611,58776,54165,-4611
12868,0.0,0.0,0.0,3611,58780,54165,-4615
12870,0.0,0.0,0.0,3611,58784,54165,-4619
12871,0.0,0.0,0.0,3611,58788,54165,-4623
12872,0.0,0.0,0.0,3611,58792,54165,-4627
12873,0.0,0.0,0.0,3611,58796,54165,-4631
12874,0.0,0.0,0.0,3611,58800,54165,-4635
12877,0.0,0.0,0.0,3611,58804,54165,-4639
12878,0.0,0.0,0.0,3611,58808,54165,-4643
12879,0.0,0.0,0.0,3611,58812,54165,-4647
12880,0.0,0.0,0.0,3611,58816,54165,-4651
12881,0.0,0.0,0.0,3611,58820,54165,-4655
12882,0.0,0.0,0.0,3611,58824,54165,-4659
12883,0.0,0.0,0.0,3611,58828,54165,-4663
12884,0.0,0.0,0.0,3611,58832,54165,-4667
12885,0.0,0.0,0.0,3611,58836,54165,-4671
12886,0.0,0.0,0.0,3611,58840,54165,-4675
12890,0.0,0.0,0.0,3611,58844,54165,-4679
12891,0.0,0.0,0.0,3611,58848,54165,-4683
12895,0.0,0.0,0.0,3611,58852,54165,-4687
12896,0.0,0.0,0.0,3611,58856,54165,-4691
12897,0.0,0.0,0.0,3611,58860,54165,-4695
12898,0.0,0.0,0.0,3611,58864,54165,-4699
12899,0.0,0.0,0.0,3611,58868,54165,-4703
12900,0.0,0.0,0.0,3611,58872,54165,-4707
12902,0.0,0.0,0.0,3611,58876,54165,-4711
12903,0.0,0.0,0.0,3611,58880,54165,-4715
12904,0.0,0.0,0.0,3611,58884,54165,-4719
12906,0.0,0.0,0.0,3611,58888,54165,-4723
12908,0.0,0.0,0.0,3611,58892,54165,-4727
12910,0.0,0.0,0.0,3611,58896,54165,-4731
12911,0.0,0.0,0.0,3611,58900,54165,-4735
12912,0.0,0.0,0.0,3611,58904,54165,-4739
12913,0.0,0.0,0.0,3611,58908,54165,-4743
12914,0.0,0.0,0.0,3611,58912,54165,-4747
12916,0.0,0.0,0.0,3611,58916,54165,-4751
12918,0.0,0.0,0.0,3611,58920,54165,-4755
12919,0.0,0.0,0.0,3611,58924,54165,-4759
12920,0.0,0.0,0.0,3611,58928,54165,-4763
12922,0.0,0.0,0.0,3611,58932,54165,-4767
12923,0.0,0.0,0.0,3611,58936,54165,-4771
12925,0.0,0.0,0.0,3611,58940,54165,-4775
12926,0.0,0.0,0.0,3611,58944,54165,-4779
12927,0.0,0.0,0.0,3611,58948,54165,-4783
12928,0.0,0.0,0.0,3611,58952,54165,-4787
12929,0.0,0.0,0.0,3611,58956,54165,-4791
12930,0.0,0.0,0.0,3611,58960,54165,-4795
12931,0.0,0.0,0.0,3611,58964,54165,-4799
12932,0.0,0.0,0.0,3611,58968,54165,-4803
12933,0.0,0.0,0.0,3611,58972,54165,-4807
12934,0.0,0.0,0.0,3611,58976,54165,-4811
12935,0.0,0.0,0.0,3611,58980,54165,-4815
12936,0.0,0.0,0.0,3611,58984,54165,-4819
12937,0.0,0.0,0.0,3611,58988,54165,-4823
12938,0.0,0.0,0.0,3611,58992,54165,-4827
12939,0.0,0.0,0.0,3611,58996,54165,-4831
12941,0.0,0.0,0.0,3611,59000,54165,-4835
12942,0.0,0.0,0.0,3611,59004,54165,-4839
12943,0.0,0.0,0.0,3611,59008,54165,-4843
12944,0.0,0.0,0.0,3611,59012,54165,-4847
12945,0.0,0.0,0.0,3611,59016,54165,-4851
12946,0.0,0.0,0.0,3611,59020,54165,-4855
12947,0.0,0.0,0.0,3611,59024,54165,-4859
12948,0.0,0.0,0.0,3611,59028,54165,-4863
12949,0.0,0.0,0.0,3611,59032,54165,-4867
12952,0.0,0.0,0.0,3611,59036,54165,-4871
12953,0.0,0.0,0.0,3611,59040,54165,-4875
12954,0.0,0.0,0.0,3611,59044,54165,-4879
12955,0.0,0.0,0.0,3611,59048,54165,-4883
12956,0.0,0.0,0.0,3611,59052,54165,-4887
12957,0.0,0.0,0.0,3611,59056,54165,-4891
12960,0.0,0.0,0.0,3611,59060,54165,-4895
12963,0.0,0.0,0.0,3611,59064,54165,-4899
12964,0.0,0.0,0.0,3611,59068,54165,-4903
12966,0.0,0.0,0.0,3611,59072,54165,-4907
12967,0.0,0.0,0.0,3611,59076,54165,-4911
12968,0.0,0.0,0.0,3611,59080,54165,-4915
12970,0.0,0.0,0.0,3611,59084,54165,-4919
12972,0.0,0.0,0.0,3611,59088,54165,-4923
12975,0.0,0.0,0.0,3611,59092,54165,-4927
12976,0.0,0.0,0.0,3611,59096,54165,-4931
12977,0.0,0.0,0.0,3611,59100,54165,-4935
12980,0.0,0.0,0.0,3611,59104,54165,-4939
12982,0.0,0.0,0.0,3611,59108,54165,-4943
12983,0.0,0.0,0.0,3611,59112,54165,-4947
12986,0.0,0.0,0.0,3611,59116,54165,-4951
12988,0.0,0.0,0.0,3611,59120,54165,-4955
12989,0.0,0.0,0.0,3611,59124,54165,-4959
12990,0.0,0.0,0.0,3611,59128,54165,-4963
12991,0.0,0.0,0.0,3611,59132,54165,-4967
12992,0.0,0.0,0.0,3611,59136,54165,-4971
12993,0.0,0.0,0.0,3611,59140,54165,-4975
12994,0.0,0.0,0.0,3611,59144,54165,-4979
12995,0.0,0.0,0.0,3611,59148,54165,-4983
12997,0.0,0.0,0.0,3611,59152,54165,-4987
13000,0.0,0.0,0.0,3611,59156,54165,-4991
13001,0.0,0.0,0.0,3611,59160,54165,-4995
13003,0.0,0.0,0.0,3611,59164,54165,-4999
13005,0.0,0.0,0.0,3611,59168,54165,-5003
13006,0.0,0.0,0.0,3611,59172,54165,-5007
13007,0.0,0.0,0.0,3611,59176,54165,-5011
13009,0.0,0.0,0.0,3611,59180,54165,-5015
13011,0.0,0.0,0.0,3611,59184,54165,-5019
13012,0.0,0.0,0.0,3611,59188,54165,-5023
13013,0.0,0.0,0.0,3611,59192,54165,-5027
13014,0.0,0.0,0.0,3611,59196,54165,-5031
13015,0.0,0.0,0.0,3611,59200,54165,-5035
13016,0.0,0.0,0.0,3611,59204,54165,-5039
13017,0.0,0.0,0.0,3611,59208,54165,-5043
13018,0.0,0.0,0.0,3611,59212,54165,-5047
13019,0.0,0.0,0.0,3611,59216,54165,-5051
13021,0.0,0.0,0.0,3611,59220,54165,-5055
13022,0.0,0.0,0.0,3611,59224,54165,-5059
13023,0.0,0.0,0.0,3611,59228,54165,-5063
13024,0.0,0.0,0.0,3611,59232,54165,-5067
13025,0.0,0.0,0.0,3611,59236,54165,-5071
13026,0.0,0.0,0.0,3611,59240,54165,-5075
13029,0.0,0.0,0.0,3611,59244,54165,-5079
13030,0.0,0.0,0.0,3611,59248,54165,-5083
13032,0.0,0.0,0.0,3611,59252,54165,-5087
13033,0.0,0.0,0.0,3611,59256,54165,-5091
13035,0.0,0.0,0.0,3611,59260,54165,-5095
13036,0.0,0.0,0.0,3611,59264,54165,-5099
13038,0.0,0.0,0.0,3611,59268,54165,-5103
13039,0.0,0.0,0.0,3611,59272,54165,-5107
13040,0.0,0.0,0.0,3611,59276,54165,-5111
13042,0.0,0.0,0.0,3611,59280,54165,-5115
13044,0.0,0.0,0.0,3611,59284,54165,-5119
13046,0.0,0.0,0.0,3611,59288,54165,-5123
13047,0.0,0.0,0.0,3611,59292,54165,-5127
13048,0.0,0.0,0.0,3611,59296,54165,-5131
13049,0.0,0.0,0.0,3611,59300,54165,-5135
13050,0.0,0.0,0.0,3611,59304,54165,-5139
13052,0.0,0.0,0.0,3611,59308,54165,-5143
13053,0.0,0.0,0.0,3611,59312,54165,-5147
13054,0.0,0.0,0.0,3611,59316,54165,-5151
13055,0.0,0.0,0.0,3611,59320,54165,-5155
13056,0.0,0.0,0.0,3611,59324,54165,-5159
13057,0.0,0.0,0.0,3611,59328,54165,-5163
13058,0.0,0.0,0.0,3611,59332,54165,-5167
13062,0.0,0.0,0.0,3611,59336,54165,-5171
13063,0.0,0.0,0.0,3611,59340,54165,-5175
13064,0.0,0.0,0.0,3611,59344,54165,-5179
13065,0.0,0.0,0.0,3611,59348,54165,-5183
13066,0.0,0.0,0.0,3611,59352,54165,-5187
13068,0.0,0.0,0.0,3611,59356,54165,-5191
13069,0.0,0.0,0.0,3611,59360,54165,-5195
13070,0.0,0.0,0.0,3611,59364,54165,-5199
13071,0.0,0.0,0.0,3611,59368,54165,-5203
13072,0.0,0.0,0.0,3611,59372,54165,-5207
13073,0.0,0.0,0.0,3611,59376,54165,-5211
13074,0.0,0.0,0.0,3611,59380,54165,-5215
13075,0.0,0.0,0.0,3611,59384,54165,-5219
13076,0.0,0.0,0.0,3611,59388,54165,-5223
13078,0.0,0.0,0.0,3611,59392,54165,-5227
13079,0.0,0.0,0.0,3611,59396,54165,-5231
13080,0.0,0.0,0.0,3611,59400,54165,-5235
13081,0.0,0.0,0.0,3611,59404,54165,-5239
13082,0.0,0.0,0.0,3611,59408,54165,-5243
13083,0.0,0.0,0.0,3611,59412,54165,-5247
13084,0.0,0.0,0.0,3611,59416,54165,-5251
13085,0.0,0.0,0.0,3611,59420,54165,-5255
13086,0.0,0.0,0.0,3611,59424,54165,-5259
13087,0.0,0.0,0.0,3611,59428,54165,-5263
13088,0.0,0.0,0.0,3611,59432,54165,-5267
13089,0.0,0.0,0.0,3611,59436,54165,-5271
13090,0.0,0.0,0.0,3611,59440,54165,-5275
13091,0.0,0.0,0.0,3611,59444,54165,-5279
13092,0.0,0.0,0.0,3611,59448,54165,-5283
13093,0.0,0.0,0.0,3611,59452,54165,-5287
13094,0.0,0.0,0.0,3611,59456,54165,-5291
13095,0.0,0.0,0.0,3611,59460,54165,-5295
13096,0.0,0.0,0.0,3611,59464,54165,-5299
13098,0.0,0.0,0.0,3611,59468,54165,-5303
13099,0.0,0.0,0.0,3611,59472,54165,-5307
13100,0.0,0.0,0.0,3611,59476,54165,-5311
13101,0.0,0.0,0.0,3611,59480,54165,-5315
13106,0.0,0.0,0.0,3611,59484,54165,-5319
13107,0.0,0.0,0.0,3611,59488,54165,-5323
13108,0.0,0.0,0.0,3611,59492,54165,-5327
13109,0.0,0.0,0.0,3611,59496,54165,-5331
13110,0.0,0.0,0.0,3611,59500,54165,-5335
13113,0.0,0.0,0.0,3611,59504,54165,-5339
13114,0.0,0.0,0.0,3611,59508,54165,-5343
13116,0.0,0.0,0.0,3611,59512,54165,-5347
13117,0.0,0.0,0.0,3611,59516,54165,-5351
13119,0.0,0.0,0.0,3611,59520,54165,-5355
13120,0.0,0.0,0.0,3611,59524,54165,-5359
13121,0.0,0.0,0.0,3611,59528,54165,-5363
13122,0.0,0.0,0.0,3611,59532,54165,-5367
13124,0.0,0.0,0.0,3611,59536,54165,-5371
13125,0.0,0.0,0.0,3611,59540,54165,-5375
13126,0.0,0.0,0.0,3611,59544,54165,-5379
13127,0.0,0.0,0.0,3611,59548,54165,-5383
13128,0.0,0.0,0.0,3611,59552,54165,-5387
13130,0.0,0.0,0.0,3611,59556,54165,-5391
13131,0.0,0.0,0.0,3611,59560,54165,-5395
13132,0.0,0.0,0.0,3611,59564,54165,-5399
13133,0.0,0.0,0.0,3611,59568,54165,-5403
13134,0.0,0.0,0.0,3611,59572,54165,-5407
13135,0.0,0.0,0.0,3611,59576,54165,-5411
13136,0.0,0.0,0.0,3611,59580,54165,-5415
13137,0.0,0.0,0.0,3611,59584,54165,-5419
13138,0.0,0.0,0.0,3611,59588,54165,-5423
13139,0.0,0.0,0.0,3611,59592,54165,-5427
13140,0.0,0.0,0.0,3611,59596,54165,-5431
13141,0.0,0.0,0.0,3611,59600,54165,-5435
13142,0.0,0.0,0.0,3611,59604,54165,-5439
13143,0.0,0.0,0.0,3611,59608,54165,-5443
13144,0.0,0.0,0.0,3611,59612,54165,-5447
13145,0.0,0.0,0.0,3611,59616,54165,-5451
13147,0.0,0.0,0.0,3611,59620,54165,-5455
13148,0.0,0.0,0.0,3611,59624,54165,-5459
13149,0.0,0.0,0.0,3611,59628,54165,-5463
13150,0.0,0.0,0.0,3611,59632,54165,-5467
13151,0.0,0.0,0.0,3611,59636,54165,-5471
13152,0.0,0.0,0.0,3611,59640,54165,-5475
13153,0.0,0.0,0.0,3611,59644,54165,-5479
13154,0.0,0.0,0.0,3611,59648,54165,-5483
13156,0.0,0.0,0.0,3611,59652,54165,-5487
13157,0.0,0.0,0.0,3611,59656,54165,-5491
13160,0.0,0.0,0.0,3611,59660,54165,-5495
13161,0.0,0.0,0.0,3611,59664,54165,-5499
13163,0.0,0.0,0.0,3611,59668,54165,-5503
13164,0.0,0.0,0.0,3611,59672,54165,-5507
13165,0.0,0.0,0.0,3611,59676,54165,-5511
13166,0.0,0.0,0.0,3611,59680,54165,-5515
13167,0.0,0.0,0.0,3611,59684,54165,-5519
13168,0.0,0.0,0.0,3611,59688,54165,-5523
13169,0.0,0.0,0.0,3611,59692,54165,-5527
13170,0.0,0.0,0.0,3611,59696,54165,-5531
13171,0.0,0.0,0.0,3611,59700,54165,-5535
13172,0.0,0.0,0.0,3611,59704,54165,-5539
13173,0.0,0.0,0.0,3611,59708,54165,-5543
13174,0.0,0.0,0.0,3611,59712,54165,-5547
13175,0.0,0.0,0.0,3611,59716,54165,-5551
13176,0.0,0.0,0.0,3611,59720,54165,-5555
13180,0.0,0.0,0.0,3611,59724,54165,-5559
13181,0.0,0.0,0.0,3611,59728,54165,-5563
13182,0.0,0.0,0.0,3611,59732,54165,-5567
13183,0.0,0.0,0.0,3611,59736,54165,-5571
13185,0.0,0.0,0.0,3611,59740,54165,-5575
13186,0.0,0.0,0.0,3611,59744,54165,-5579
13188,0.0,0.0,0.0,3611,59748,54165,-5583
13189,0.0,0.0,0.0,3611,59752,54165,-5587
13190,0.0,0.0,0.0,3611,59756,54165,-5591
13192,0.0,0.0,0.0,3611,59760,54165,-5595
13193,0.0,0.0,0.0,3611,59764,54165,-5599
13195,0.0,0.0,0.0,3611,59768,54165,-5603
13197,0.0,0.0,0.0,3611,59772,54165,-5607
13199,0.0,0.0,0.0,3611,59776,54165,-5611
13200,0.0,0.0,0.0,3611,59780,54165,-5615
13201,0.0,0.0,0.0,3611,59784,54165,-5619
13202,0.0,0.0,0.0,3611,59788,54165,-5623
13205,0.0,0.0,0.0,3611,59792,54165,-5627
13207,0.0,0.0,0.0,3611,59796,54165,-5631
13208,0.0,0.0,0.0,3611,59800,54165,-5635
13211,0.0,0.0,0.0,3611,59804,54165,-5639
13212,0.0,0.0,0.0,3611,59808,54165,-5643
13213,0.0,0.0,0.0,3611,59812,54165,-5647
13214,0.0,0.0,0.0,3611,59816,54165,-5651
13215,0.0,0.0,0.0,3611,59820,54165,-5655
13216,0.0,0.0,0.0,3611,59824,54165,-5659
13217,0.0,0.0,0.0,3611,59828,54165,-5663
13219,0.0,0.0,0.0,3611,59832,54165,-5667
13222,0.0,0.0,0.0,3611,59836,54165,-5671
13223,0.0,0.0,0.0,3611,59840,54165,-5675
13225,0.0,0.0,0.0,3611,59844,54165,-5679
13226,0.0,0.0,0.0,3611,59848,54165,-5683
13228,0.0,0.0,0.0,3611,59852,54165,-5687
13229,0.0,0.0,0.0,3611,59856,54165,-5691
13232,0.0,0.0,0.0,3611,59860,54165,-5695
13233,0.0,0.0,0.0,3611,59864,54165,-5699
13234,0.0,0.0,0.0,3611,59868,54165,-5703
13236,0.0,0.0,0.0,3611,59872,54165,-5707
13237,0.0,0.0,0.0,3611,59876,54165,-5711
13238,0.0,0.0,0.0,3611,59880,54165,-5715
13240,0.0,0.0,0.0,3611,59884,54165,-5719
13241,0.0,0.0,0.0,3611,59888,54165,-5723
13242,0.0,0.0,0.0,3611,59892,54165,-5727
13247,0.0,0.0,0.0,3611,59896,54165,-5731
13248,0.0,0.0,0.0,3611,59900,54165,-5735
13249,0.0,0.0,0.0,3611,59904,54165,-5739
13250,0.0,0.0,0.0,3611,59908,54165,-5743
13253,0.0,0.0,0.0,3611,59912,54165,-5747
13255,0.0,0.0,0.0,3611,59916,54165,-5751
13256,0.0,0.0,0.0,3611,59920,54165,-5755
13258,0.0,0.0,0.0,3611,59924,54165,-5759
13261,0.0,0.0,0.0,3611,59928,54165,-5763
13262,0.0,0.0,0.0,3611,59932,54165,-5767
13264,0.0,0.0,0.0,3611,59936,54165,-5771
13265,0.0,0.0,0.0,3611,59940,54165,-5775
13266,0.0,0.0,0.0,3611,59944,54165,-5779
13267,0.0,0.0,0.0,3611,59948,54165,-5783
13269,0.0,0.0,0.0,3611,59952,54165,-5787
13270,0.0,0.0,0.0,3611,59956,54165,-5791
13271,0.0,0.0,0.0,3611,59960,54165,-5795
13272,0.0,0.0,0.0,3611,59964,54165,-5799
13273,0.0,0.0,0.0,3611,59968,54165,-5803
13274,0.0,0.0,0.0,3611,59972,54165,-5807
13275,0.0,0.0,0.0,3611,59976,54165,-5811
13278,0.0,0.0,0.0,3611,59980,54165,-5815
13279,0.0,0.0,0.0,3611,59984,54165,-5819
13280,0.0,0.0,0.0,3611,59988,54165,-5823
13281,0.0,0.0,0.0,3611,59992,54165,-5827
13283,0.0,0.0,0.0,3611,59996,54165,-5831
13284,0.0,0.0,0.0,3611,60000,54165,-5835
13287,0.0,0.0,0.0,3611,60004,54165,-5839
13288,0.0,0.0,0.0,3611,60008,54165,-5843
13289,0.0,0.0,0.0,3611,60012,54165,-5847
13291,0.0,0.0,0.0,3611,60016,54165,-5851
13292,0.0,0.0,0.0,3611,60020,54165,-5855
13293,0.0,0.0,0.0,3611,60024,54165,-5859
13294,0.0,0.0,0.0,3611,60028,54165,-5863
13295,0.0,0.0,0.0,3611,60032,54165,-5867
13298,0.0,0.0,0.0,3611,60036,54165,-5871
13299,0.0,0.0,0.0,3611,60040,54165,-5875
13301,0.0,0.0,0.0,3611,60044,54165,-5879
13302,0.0,0.0,0.0,3611,60048,54165,-5883
13304,0.0,0.0,0.0,3611,60052,54165,-5887
13305,0.0,0.0,0.0,3611,60056,54165,-5891
13308,0.0,0.0,0.0,3611,60060,54165,-5895
13311,0.0,0.0,0.0,3611,60064,54165,-5899
13312,0.0,0.0,0.0,3611,60068,54165,-5903
13313,0.0,0.0,0.0,3611,60072,54165,-5907
13314,0.0,0.0,0.0,3611,60076,54165,-5911
13316,0.0,0.0,0.0,3611,60080,54165,-5915
13317,0.0,0.0,0.0,3611,60084,54165,-5919
13318,0.0,0.0,0.0,3611,60088,54165,-5923
13320,0.0,0.0,0.0,3611,60092,54165,-5927
13321,0.0,0.0,0.0,3611,60096,54165,-5931
13323,0.0,0.0,0.0,3611,60100,54165,-5935
13328,0.0,0.0,0.0,3611,60104,54165,-5939
13329,0.0,0.0,0.0,3611,60108,54165,-5943
13330,0.0,0.0,0.0,3611,60112,54165,-5947
13332,0.0,0.0,0.0,3611,60116,54165,-5951
13333,0.0,0.0,0.0,3611,60120,54165,-5955
13334,0.0,0.0,0.0,3611,60124,54165,-5959
13335,0.0,0.0,0.0,3611,60128,54165,-5963
13336,0.0,0.0,0.0,3611,60132,54165,-5967
13337,0.0,0.0,0.0,3611,60136,54165,-5971
13339,0.0,0.0,0.0,3611,60140,54165,-5975
13340,0.0,0.0,0.0,3611,60144,54165,-5979
13341,0.0,0.0,0.0,3611,60148,54165,-5983
13342,0.0,0.0,0.0,3611,60152,54165,-5987
13343,0.0,0.0,0.0,3611,60156,54165,-5991
13344,0.0,0.0,0.0,3611,60160,54165,-5995
13345,0.0,0.0,0.0,3611,60164,54165,-5999
13346,0.0,0.0,0.0,3611,60168,54165,-6003
13347,0.0,0.0,0.0,3611,60172,54165,-6007
13349,0.0,0.0,0.0,3611,60176,54165,-6011
13350,0.0,0.0,0.0,3611,60180,54165,-6015
13351,0.0,0.0,0.0,3611,60184,54165,-6019
13352,0.0,0.0,0.0,3611,60188,54165,-6023
13354,0.0,0.0,0.0,3611,60192,54165,-6027
13355,0.0,0.0,0.0,3611,60196,54165,-6031
13356,0.0,0.0,0.0,3611,60200,54165,-6035
13357,0.0,0.0,0.0,3611,60204,54165,-6039
13359,0.0,0.0,0.0,3611,60208,54165,-6043
13360,0.0,0.0,0.0,3611,60212,54165,-6047
13361,0.0,0.0,0.0,3611,60216,54165,-6051
13365,0.0,0.0,0.0,3611,60220,54165,-6055
13366,0.0,0.0,0.0,3611,60224,54165,-6059
13367,0.0,0.0,0.0,3611,60228,54165,-6063
13369,0.0,0.0,0.0,3611,60232,54165,-6067
13370,0.0,0.0,0.0,3611,60236,54165,-6071
13372,0.0,0.0,0.0,3611,60240,54165,-6075
13373,0.0,0.0,0.0,3611,60244,54165,-6079
13374,0.0,0.0,0.0,3611,60248,54165,-6083
13375,0.0,0.0,0.0,3611,60252,54165,-6087
13376,0.0,0.0,0.0,3611,60256,54165,-6091
13378,0.0,0.0,0.0,3611,60260,54165,-6095
13380,0.0,0.0,0.0,3611,60264,54165,-6099
13382,0.0,0.0,0.0,3611,60268,54165,-6103
13383,0.0,0.0,0.0,3611,60272,54165,-6107
13384,0.0,0.0,0.0,3611,60276,54165,-6111
13385,0.0,0.0,0.0,3611,60280,54165,-6115
13386,0.0,0.0,0.0,3611,60284,54165,-6119
13387,0.0,0.0,0.0,3611,60288,54165,-6123
13388,0.0,0.0,0.0,3611,60292,54165,-6127
13389,0.0,0.0,0.0,3611,60296,54165,-6131
13390,0.0,0.0,0.0,3611,60300,54165,-6135
13391,0.0,0.0,0.0,3611,60304,54165,-6139
13392,0.0,0.0,0.0,3611,60308,54165,-6143
13393,0.0,0.0,0.0,3611,60312,54165,-6147
13394,0.0,0.0,0.0,3611,60316,54165,-6151
13395,0.0,0.0,0.0,3611,60320,54165,-6155
13396,0.0,0.0,0.0,3611,60324,54165,-6159
13398,0.0,0.0,0.0,3611,60328,54165,-6163
13399,0.0,0.0,0.0,3611,60332,54165,-6167
13401,0.0,0.0,0.0,3611,60336,54165,-6171
13404,0.0,0.0,0.0,3611,60340,54165,-6175
13406,0.0,0.0,0.0,3611,60344,54165,-6179
13408,0.0,0.0,0.0,3611,60348,54165,-6183
13409,0.0,0.0,0.0,3611,60352,54165,-6187
13410,0.0,0.0,0.0,3611,60356,54165,-6191
13411,0.0,0.0,0.0,3611,60360,54165,-6195
13412,0.0,0.0,0.0,3611,60364,54165,-6199
13413,0.0,0.0,0.0,3611,60368,54165,-6203
13414,0.0,0.0,0.0,3611,60372,54165,-6207
13415,0.0,0.0,0.0,3611,60376,54165,-6211
13416,0.0,0.0,0.0,3611,60380,54165,-6215
13417,0.0,0.0,0.0,3611,60384,54165,-6219
13418,0.0,0.0,0.0,3611,60388,54165,-6223
13419,0.0,0.0,0.0,3611,60392,54165,-6227
13420,0.0,0.0,0.0,3611,60396,54165,-6231
13421,0.0,0.0,0.0,3611,60400,54165,-6235
13423,0.0,0.0,0.0,3611,60404,54165,-6239
13424,0.0,0.0,0.0,3611,60408,54165,-6243
13425,0.0,0.0,0.0,3611,60412,54165,-6247
13427,0.0,0.0,0.0,3611,60416,54165,-6251
13428,0.0,0.0,0.0,3611,60420,54165,-6255
13430,0.0,0.0,0.0,3611,60424,54165,-6259
13431,0.0,0.0,0.0,3611,60428,54165,-6263
13432,0.0,0.0,0.0,3611,60432,54165,-6267
13433,0.0,0.0,0.0,3611,60436,54165,-6271
13434,0.0,0.0,0.0,3611,60440,54165,-6275
13435,0.0,0.0,0.0,3611,60444,54165,-6279
13436,0.0,0.0,0.0,3611,60448,54165,-6283
13437,0.0,0.0,0.0,3611,60452,54165,-6287
13438,0.0,0.0,0.0,3611,60456,54165,-6291
13439,0.0,0.0,0.0,3611,60460,54165,-6295
13440,0.0,0.0,0.0,3611,60464,54165,-6299
13441,0.0,0.0,0.0,3611,60468,54165,-6303
13443,0.0,0.0,0.0,3611,60472,54165,-6307
13444,0.0,0.0,0.0,3611,60476,54165,-6311
13445,0.0,0.0,0.0,3611,60480,54165,-6315
13446,0.0,0.0,0.0,3611,60484,54165,-6319
13447,0.0,0.0,0.0,3611,60488,54165,-6323
13448,0.0,0.0,0.0,3611,60492,54165,-6327
13449,0.0,0.0,0.0,3611,60496,54165,-6331
13450,0.0,0.0,0.0,3611,60500,54165,-6335
13451,0.0,0.0,0.0,3611,60504,54165,-6339
13452,0.0,0.0,0.0,3611,60508,54165,-6343
13453,0.0,0.0,0.0,3611,60512,54165,-6347
13454,0.0,0.0,0.0,3611,60516,54165,-6351
13455,0.0,0.0,0.0,3611,60520,54165,-6355
13456,0.0,0.0,0.0,3611,60524,54165,-6359
13457,0.0,0.0,0.0,3611,60528,54165,-6363
13458,0.0,0.0,0.0,3611,60532,54165,-6367
13459,0.0,0.0,0.0,3611,60536,54165,-6371
13460,0.0,0.0,0.0,3611,60540,54165,-6375
13461,0.0,0.0,0.0,3611,60544,54165,-6379
13462,0.0,0.0,0.0,3611,60548,54165,-6383
13463,0.0,0.0,0.0,3611,60552,54165,-6387
13465,0.0,0.0,0.0,3611,60556,54165,-6391
13466,0.0,0.0,0.0,3611,60560,54165,-6395
13467,0.0,0.0,0.0,3611,60564,54165,-6399
13470,0.0,0.0,0.0,3611,60568,54165,-6403
13471,0.0,0.0,0.0,3611,60572,54165,-6407
13473,0.0,0.0,0.0,3611,60576,54165,-6411
13474,0.0,0.0,0.0,3611,60580,54165,-6415
13475,0.0,0.0,0.0,3611,60584,54165,-6419
13476,0.0,0.0,0.0,3611,60588,54165,-6423
13477,0.0,0.0,0.0,3611,60592,54165,-6427
13478,0.0,0.0,0.0,3611,60596,54165,-6431
13480,0.0,0.0,0.0,3611,60600,54165,-6435
13481,0.0,0.0,0.0,3611,60604,54165,-6439
13482,0.0,0.0,0.0,3611,60608,54165,-6443
13483,0.0,0.0,0.0,3611,60612,54165,-6447
13484,0.0,0.0,0.0,3611,60616,54165,-6451
13485,0.0,0.0,0.0,3611,60620,54165,-6455
13486,0.0,0.0,0.0,3611,60624,54165,-6459
13487,0.0,0.0,0.0,3611,60628,54165,-6463
13488,0.0,0.0,0.0,3611,60632,54165,-6467
13489,0.0,0.0,0.0,3611,60636,54165,-6471
13491,0.0,0.0,0.0,3611,60640,54165,-6475
13492,0.0,0.0,0.0,3611,60644,54165,-6479
13494,0.0,0.0,0.0,3611,60648,54165,-6483
13495,0.0,0.0,0.0,3611,60652,54165,-6487
13496,0.0,0.0,0.0,3611,60656,54165,-6491
13497,0.0,0.0,0.0,3611,60660,54165,-6495
13498,0.0,0.0,0.0,3611,60664,54165,-6499
13502,0.0,0.0,0.0,3611,60668,54165,-6503
13503,0.0,0.0,0.0,3611,60672,54165,-6507
13504,0.0,0.0,0.0,3611,60676,54165,-6511
13505,0.0,0.0,0.0,3611,60680,54165,-6515
13507,0.0,0.0,0.0,3611,60684,54165,-6519
13508,0.0,0.0,0.0,3611,60688,54165,-6523
13509,0.0,0.0,0.0,3611,60692,54165,-6527
13510,0.0,0.0,0.0,3611,60696,54165,-6531
13511,0.0,0.0,0.0,3611,60700,54165,-6535
13512,0.0,0.0,0.0,3611,60704,54165,-6539
13514,0.0,0.0,0.0,3611,60708,54165,-6543
13515,0.0,0.0,0.0,3611,60712,54165,-6547
13516,0.0,0.0,0.0,3611,60716,54165,-6551
13517,0.0,0.0,0.0,3611,60720,54165,-6555
13519,0.0,0.0,0.0,3611,60724,54165,-6559
13520,0.0,0.0,0.0,3611,60728,54165,-6563
13521,0.0,0.0,0.0,3611,60732,54165,-6567
13522,0.0,0.0,0.0,3611,60736,54165,-6571
13523,0.0,0.0,0.0,3611,60740,54165,-6575
13526,0.0,0.0,0.0,3611,60744,54165,-6579
13527,0.0,0.0,0.0,3611,60748,54165,-6583
13528,0.0,0.0,0.0,3611,60752,54165,-6587
13529,0.0,0.0,0.0,3611,60756,54165,-6591
13531,0.0,0.0,0.0,3611,60760,54165,-6595
13532,0.0,0.0,0.0,3611,60764,54165,-6599
13533,0.0,0.0,0.0,3611,60768,54165,-6603
13536,0.0,0.0,0.0,3611,60772,54165,-6607
13537,0.0,0.0,0.0,3611,60776,54165,-6611
13538,0.0,0.0,0.0,3611,60780,54165,-6615
13539,0.0,0.0,0.0,3611,60784,54165,-6619
13540,0.0,0.0,0.0,3611,60788,54165,-6623
13541,0.0,0.0,0.0,3611,60792,54165,-6627
13542,0.0,0.0,0.0,3611,60796,54165,-6631
13543,0.0,0.0,0.0,3611,60800,54165,-6635
13544,0.0,0.0,0.0,3611,60804,54165,-6639
13546,0.0,0.0,0.0,3611,60808,54165,-6643
13550,0.0,0.0,0.0,3611,60812,54165,-6647
13551,0.0,0.0,0.0,3611,60816,54165,-6651
13552,0.0,0.0,0.0,3611,60820,54165,-6655
13553,0.0,0.0,0.0,3611,60824,54165,-6659
13555,0.0,0.0,0.0,3611,60828,54165,-6663
13556,0.0,0.0,0.0,3611,60832,54165,-6667
13557,0.0,0.0,0.0,3611,60836,54165,-6671
13558,0.0,0.0,0.0,3611,60840,54165,-6675
13559,0.0,0.0,0.0,3611,60844,54165,-6679
13560,0.0,0.0,0.0,3611,60848,54165,-6683
13561,0.0,0.0,0.0,3611,60852,54165,-6687
13562,0.0,0.0,0.0,3611,60856,54165,-6691
13563,0.0,0.0,0.0,3611,60860,54165,-6695
13564,0.0,0.0,0.0,3611,60864,54165,-6699
13565,0.0,0.0,0.0,3611,60868,54165,-6703
13566,0.0,0.0,0.0,3611,60872,54165,-6707
13568,0.0,0.0,0.0,3611,60876,54165,-6711
13569,0.0,0.0,0.0,3611,60880,54165,-6715
13570,0.0,0.0,0.0,3611,60884,54165,-6719
13571,0.0,0.0,0.0,3611,60888,54165,-6723
13572,0.0,0.0,0.0,3611,60892,54165,-6727
13574,0.0,0.0,0.0,3611,60896,54165,-6731
13575,0.0,0.0,0.0,3611,60900,54165,-6735
13576,0.0,0.0,0.0,3611,60904,54165,-6739
13577,0.0,0.0,0.0,3611,60908,54165,-6743
13578,0.0,0.0,0.0,3611,60912,54165,-6747
13579,0.0,0.0,0.0,3611,60916,54165,-6751
13580,0.0,0.0,0.0,3611,60920,54165,-6755
13581,0.0,0.0,0.0,3611,60924,54165,-6759
13582,0.0,0.0,0.0,3611,60928,54165,-6763
13583,0.0,0.0,0.0,3611,60932,54165,-6767
13585,0.0,0.0,0.0,3611,60936,54165,-6771
13586,0.0,0.0,0.0,3611,60940,54165,-6775
13587,0.0,0.0,0.0,3611,60944,54165,-6779
13588,0.0,0.0,0.0,3611,60948,54165,-6783
13589,0.0,0.0,0.0,3611,60952,54165,-6787
13590,0.0,0.0,0.0,3611,60956,54165,-6791
13592,0.0,0.0,0.0,3611,60960,54165,-6795
13593,0.0,0.0,0.0,3611,60964,54165,-6799
13594,0.0,0.0,0.0,3611,60968,54165,-6803
13596,0.0,0.0,0.0,3611,60972,54165,-6807
13597,0.0,0.0,0.0,3611,60976,54165,-6811
13598,0.0,0.0,0.0,3611,60980,54165,-6815
13599,0.0,0.0,0.0,3611,60984,54165,-6819
13600,0.0,0.0,0.0,3611,60988,54165,-6823
13601,0.0,0.0,0.0,3611,60992,54165,-6827
13603,0.0,0.0,0.0,3611,60996,54165,-6831
13604,0.0,0.0,0.0,3611,61000,54165,-6835
13605,0.0,0.0,0.0,3611,61004,54165,-6839
13607,0.0,0.0,0.0,3611,61008,54165,-6843
13608,0.0,0.0,0.0,3611,61012,54165,-6847
13609,0.0,0.0,0.0,3611,61016,54165,-6851
13610,0.0,0.0,0.0,3611,61020,54165,-6855
13611,0.0,0.0,0.0,3611,61024,54165,-6859
13613,0.0,0.0,0.0,3611,61028,54165,-6863
13614,0.0,0.0,0.0,3611,61032,54165,-6867
13616,0.0,0.0,0.0,3611,61036,54165,-6871
13620,0.0,0.0,0.0,3611,61040,54165,-6875
13621,0.0,0.0,0.0,3611,61044,54165,-6879
13622,0.0,0.0,0.0,3611,61048,54165,-6883
13624,0.0,0.0,0.0,3611,61052,54165,-6887
13625,0.0,0.0,0.0,3611,61056,54165,-6891
13628,0.0,0.0,0.0,3611,61060,54165,-6895
13629,0.0,0.0,0.0,3611,61064,54165,-6899
13630,0.0,0.0,0.0,3611,61068,54165,-6903
13631,0.0,0.0,0.0,3611,61072,54165,-6907
13633,0.0,0.0,0.0,3611,61076,54165,-6911
13637,0.0,0.0,0.0,3611,61080,54165,-6915
13640,0.0,0.0,0.0,3611,61084,54165,-6919
13641,0.0,0.0,0.0,3611,61088,54165,-6923
13642,0.0,0.0,0.0,3611,61092,54165,-6927
13643,0.0,0.0,0.0,3611,61096,54165,-6931
13644,0.0,0.0,0.0,3611,61100,54165,-6935
13647,0.0,0.0,0.0,3611,61104,54165,-6939
13648,0.0,0.0,0.0,3611,61108,54165,-6943
13649,0.0,0.0,0.0,3611,61112,54165,-6947
13651,0.0,0.0,0.0,3611,61116,54165,-6951
13652,0.0,0.0,0.0,3611,61120,54165,-6955
13653,0.0,0.0,0.0,3611,61124,54165,-6959
13654,0.0,0.0,0.0,3611,61128,54165,-6963
13655,0.0,0.0,0.0,3611,61132,54165,-6967
13656,0.0,0.0,0.0,3611,61136,54165,-6971
13657,0.0,0.0,0.0,3611,61140,54165,-6975
13658,0.0,0.0,0.0,3611,61144,54165,-6979
13659,0.0,0.0,0.0,3611,61148,54165,-6983
13660,0.0,0.0,0.0,3611,61152,54165,-6987
13662,0.0,0.0,0.0,3611,61156,54165,-6991
13664,0.0,0.0,0.0,3611,61160,54165,-6995
13665,0.0,0.0,0.0,3611,61164,54165,-6999
13666,0.0,0.0,0.0,3611,61168,54165,-7003
13667,0.0,0.0,0.0,3611,61172,54165,-7007
13668,0.0,0.0,0.0,3611,61176,54165,-7011
13669,0.0,0.0,0.0,3611,61180,54165,-7015
13671,0.0,0.0,0.0,3611,61184,54165,-7019
13674,0.0,0.0,0.0,3611,61188,54165,-7023
13675,0.0,0.0,0.0,3611,61192,54165,-7027
13676,0.0,0.0,0.0,3611,61196,54165,-7031
13677,0.0,0.0,0.0,3611,61200,54165,-7035
13679,0.0,0.0,0.0,3611,61204,54165,-7039
13680,0.0,0.0,0.0,3611,61208,54165,-7043
13682,0.0,0.0,0.0,3611,61212,54165,-7047
13683,0.0,0.0,0.0,3611,61216,54165,-7051
13684,0.0,0.0,0.0,3611,61220,54165,-7055
13685,0.0,0.0,0.0,3611,61224,54165,-7059
13687,0.0,0.0,0.0,3611,61228,54165,-7063
13688,0.0,0.0,0.0,3611,61232,54165,-7067
13689,0.0,0.0,0.0,3611,61236,54165,-7071
13690,0.0,0.0,0.0,3611,61240,54165,-7075
13692,0.0,0.0,0.0,3611,61244,54165,-7079
13693,0.0,0.0,0.0,3611,61248,54165,-7083
13695,0.0,0.0,0.0,3611,61252,54165,-7087
13696,0.0,0.0,0.0,3611,61256,54165,-7091
13697,0.0,0.0,0.0,3611,61260,54165,-7095
13698,0.0,0.0,0.0,3611,61264,54165,-7099
13699,0.0,0.0,0.0,3611,61268,54165,-7103
13700,0.0,0.0,0.0,3611,61272,54165,-7107
13701,0.0,0.0,0.0,3611,61276,54165,-7111
13702,0.0,0.0,0.0,3611,61280,54165,-7115
13703,0.0,0.0,0.0,3611,61284,54165,-7119
13704,0.0,0.0,0.0,3611,61288,54165,-7123
13705,0.0,0.0,0.0,3611,61292,54165,-7127
13707,0.0,0.0,0.0,3611,61296,54165,-7131
13708,0.0,0.0,0.0,3611,61300,54165,-7135
13709,0.0,0.0,0.0,3611,61304,54165,-7139
13710,0.0,0.0,0.0,3611,61308,54165,-7143
13711,0.0,0.0,0.0,3611,61312,54165,-7147
13712,0.0,0.0,0.0,3611,61316,54165,-7151
13715,0.0,0.0,0.0,3611,61320,54165,-7155
13716,0.0,0.0,0.0,3611,61324,54165,-7159
13717,0.0,0.0,0.0,3611,61328,54165,-7163
13719,0.0,0.0,0.0,3611,61332,54165,-7167
13720,0.0,0.0,0.0,3611,61336,54165,-7171
13721,0.0,0.0,0.0,3611,61340,54165,-7175
13722,0.0,0.0,0.0,3611,61344,54165,-7179
13723,0.0,0.0,0.0,3611,61348,54165,-7183
13724,0.0,0.0,0.0,3611,61352,54165,-7187
13725,0.0,0.0,0.0,3611,61356,54165,-7191
13726,0.0,0.0,0.0,3611,61360,54165,-7195
13728,0.0,0.0,0.0,3611,61364,54165,-7199
13729,0.0,0.0,0.0,3611,61368,54165,-7203
13730,0.0,0.0,0.0,3611,61372,54165,-7207
13731,0.0,0.0,0.0,3611,61376,54165,-7211
13732,0.0,0.0,0.0,3611,61380,54165,-7215
13733,0.0,0.0,0.0,3611,61384,54165,-7219
13735,0.0,0.0,0.0,3611,61388,54165,-7223
13736,0.0,0.0,0.0,3611,61392,54165,-7227
13739,0.0,0.0,0.0,3611,61396,54165,-7231
13740,0.0,0.0,0.0,3611,61400,54165,-7235
13742,0.0,0.0,0.0,3611,61404,54165,-7239
13743,0.0,0.0,0.0,3611,61408,54165,-7243
13746,0.0,0.0,0.0,3611,61412,54165,-7247
13747,0.0,0.0,0.0,3611,61416,54165,-7251
13748,0.0,0.0,0.0,3611,61420,54165,-7255
13749,0.0,0.0,0.0,3611,61424,54165,-7259
13750,0.0,0.0,0.0,3611,61428,54165,-7263
13752,0.0,0.0,0.0,3611,61432,54165,-7267
13753,0.0,0.0,0.0,3611,61436,54165,-7271
13754,0.0,0.0,0.0,3611,61440,54165,-7275
13755,0.0,0.0,0.0,3611,61444,54165,-7279
13756,0.0,0.0,0.0,3611,61448,54165,-7283
13757,0.0,0.0,0.0,3611,61452,54165,-7287
13758,0.0,0.0,0.0,3611,61456,54165,-7291
13759,0.0,0.0,0.0,3611,61460,54165,-7295
13760,0.0,0.0,0.0,3611,61464,54165,-7299
13762,0.0,0.0,0.0,3611,61468,54165,-7303
13763,0.0,0.0,0.0,3611,61472,54165,-7307
13764,0.0,0.0,0.0,3611,61476,54165,-7311
13765,0.0,0.0,0.0,3611,61480,54165,-7315
13766,0.0,0.0,0.0,3611,61484,54165,-7319
13767,0.0,0.0,0.0,3611,61488,54165,-7323
13768,0.0,0.0,0.0,3611,61492,54165,-7327
13770,0.0,0.0,0.0,3611,61496,54165,-7331
13771,0.0,0.0,0.0,3611,61500,54165,-7335
13772,0.0,0.0,0.0,3611,61504,54165,-7339
13773,0.0,0.0,0.0,3611,61508,54165,-7343
13775,0.0,0.0,0.0,3611,61512,54165,-7347
13777,0.0,0.0,0.0,3611,61516,54165,-7351
13778,0.0,0.0,0.0,3611,61520,54165,-7355
13779,0.0,0.0,0.0,3611,61524,54165,-7359
13780,0.0,0.0,0.0,3611,61528,54165,-7363
13782,0.0,0.0,0.0,3611,61532,54165,-7367
13783,0.0,0.0,0.0,3611,61536,54165,-7371
13784,0.0,0.0,0.0,3611,61540,54165,-7375
13785,0.0,0.0,0.0,3611,61544,54165,-7379
13787,0.0,0.0,0.0,3611,61548,54165,-7383
13788,0.0,0.0,0.0,3611,61552,54165,-7387
13789,0.0,0.0,0.0,3611,61556,54165,-7391
13790,0.0,0.0,0.0,3611,61560,54165,-7395
13791,0.0,0.0,0.0,3611,61564,54165,-7399
13792,0.0,0.0,0.0,3611,61568,54165,-7403
13793,0.0,0.0,0.0,3611,61572,54165,-7407
13794,0.0,0.0,0.0,3611,61576,54165,-7411
13796,0.0,0.0,0.0,3611,61580,54165,-7415
13797,0.0,0.0,0.0,3611,61584,54165,-7419
13798,0.0,0.0,0.0,3611,61588,54165,-7423
13799,0.0,0.0,0.0,3611,61592,54165,-7427
13801,0.0,0.0,0.0,3611,61596,54165,-7431
13802,0.0,0.0,0.0,3611,61600,54165,-7435
13803,0.0,0.0,0.0,3611,61604,54165,-7439
13804,0.0,0.0,0.0,3611,61608,54165,-7443
13805,0.0,0.0,0.0,3611,61612,54165,-7447
13807,0.0,0.0,0.0,3611,61616,54165,-7451
13809,0.0,0.0,0.0,3611,61620,54165,-7455
13811,0.0,0.0,0.0,3611,61624,54165,-7459
13812,0.0,0.0,0.0,3611,61628,54165,-7463
13813,0.0,0.0,0.0,3611,61632,54165,-7467
13814,0.0,0.0,0.0,3611,61636,54165,-7471
13816,0.0,0.0,0.0,3611,61640,54165,-7475
13817,0.0,0.0,0.0,3611,61644,54165,-7479
13819,0.0,0.0,0.0,3611,61648,54165,-7483
13820,0.0,0.0,0.0,3611,61652,54165,-7487
13821,0.0,0.0,0.0,3611,61656,54165,-7491
13822,0.0,0.0,0.0,3611,61660,54165,-7495
13823,0.0,0.0,0.0,3611,61664,54165,-7499
13825,0.0,0.0,0.0,3611,61668,54165,-7503
13826,0.0,0.0,0.0,3611,61672,54165,-7507
13827,0.0,0.0,0.0,3611,61676,54165,-7511
13828,0.0,0.0,0.0,3611,61680,54165,-7515
13829,0.0,0.0,0.0,3611,61684,54165,-7519
13830,0.0,0.0,0.0,3611,61688,54165,-7523
13831,0.0,0.0,0.0,3611,61692,54165,-7527
13832,0.0,0.0,0.0,3611,61696,54165,-7531
13833,0.0,0.0,0.0,3611,61700,54165,-7535
13834,0.0,0.0,0.0,3611,61704,54165,-7539
13835,0.0,0.0,0.0,3611,61708,54165,-7543
13836,0.0,0.0,0.0,3611,61712,54165,-7547
13837,0.0,0.0,0.0,3611,61716,54165,-7551
13838,0.0,0.0,0.0,3611,61720,54165,-7555
13839,0.0,0.0,0.0,3611,61724,54165,-7559
13840,0.0,0.0,0.0,3611,61728,54165,-7563
13841,0.0,0.0,0.0,3611,61732,54165,-7567
13842,0.0,0.0,0.0,3611,61736,54165,-7571
13843,0.0,0.0,0.0,3611,61740,54165,-7575
13846,0.0,0.0,0.0,3611,61744,54165,-7579
13849,0.0,0.0,0.0,3611,61748,54165,-7583
13850,0.0,0.0,0.0,3611,61752,54165,-7587
13851,0.0,0.0,0.0,3611,61756,54165,-7591
13853,0.0,0.0,0.0,3611,61760,54165,-7595
13854,0.0,0.0,0.0,3611,61764,54165,-7599
13855,0.0,0.0,0.0,3611,61768,54165,-7603
13856,0.0,0.0,0.0,3611,61772,54165,-7607
13857,0.0,0.0,0.0,3611,61776,54165,-7611
13858,0.0,0.0,0.0,3611,61780,54165,-7615
13859,0.0,0.0,0.0,3611,61784,54165,-7619
13860,0.0,0.0,0.0,3611,61788,54165,-7623
13861,0.0,0.0,0.0,3611,61792,54165,-7627
13862,0.0,0.0,0.0,3611,61796,54165,-7631
13863,0.0,0.0,0.0,3611,61800,54165,-7635
13864,0.0,0.0,0.0,3611,61804,54165,-7639
13865,0.0,0.0,0.0,3611,61808,54165,-7643
13866,0.0,0.0,0.0,3611,61812,54165,-7647
13867,0.0,0.0,0.0,3611,61816,54165,-7651
13868,0.0,0.0,0.0,3611,61820,54165,-7655
13869,0.0,0.0,0.0,3611,61824,54165,-7659
13871,0.0,0.0,0.0,3611,61828,54165,-7663
13872,0.0,0.0,0.0,3611,61832,54165,-7667
13873,0.0,0.0,0.0,3611,61836,54165,-7671
13874,0.0,0.0,0.0,3611,61840,54165,-7675
13875,0.0,0.0,0.0,3611,61844,54165,-7679
13876,0.0,0.0,0.0,3611,61848,54165,-7683
13877,0.0,0.0,0.0,3611,61852,54165,-7687
13878,0.0,0.0,0.0,3611,61856,54165,-7691
13879,0.0,0.0,0.0,3611,61860,54165,-7695
13880,0.0,0.0,0.0,3611,61864,54165,-7699
13881,0.0,0.0,0.0,3611,61868,54165,-7703
13882,0.0,0.0,0.0,3611,61872,54165,-7707
13883,0.0,0.0,0.0,3611,61876,54165,-7711
13884,0.0,0.0,0.0,3611,61880,54165,-7715
13885,0.0,0.0,0.0,3611,61884,54165,-7719
13886,0.0,0.0,0.0,3611,61888,54165,-7723
13887,0.0,0.0,0.0,3611,61892,54165,-7727
13888,0.0,0.0,0.0,3611,61896,54165,-7731
13889,0.0,0.0,0.0,3611,61900,54165,-7735
13891,0.0,0.0,0.0,3611,61904,54165,-7739
13892,0.0,0.0,0.0,3611,61908,54165,-7743
13893,0.0,0.0,0.0,3611,61912,54165,-7747
13895,0.0,0.0,0.0,3611,61916,54165,-7751
13896,0.0,0.0,0.0,3611,61920,54165,-7755
13897,0.0,0.0,0.0,3611,61924,54165,-7759
13898,0.0,0.0,0.0,3611,61928,54165,-7763
13899,0.0,0.0,0.0,3611,61932,54165,-7767
13900,0.0,0.0,0.0,3611,61936,54165,-7771
13901,0.0,0.0,0.0,3611,61940,54165,-7775
13902,0.0,0.0,0.0,3611,61944,54165,-7779
13903,0.0,0.0,0.0,3611,61948,54165,-7783
13904,0.0,0.0,0.0,3611,61952,54165,-7787
13905,0.0,0.0,0.0,3611,61956,54165,-7791
13906,0.0,0.0,0.0,3611,61960,54165,-7795
13908,0.0,0.0,0.0,3611,61964,54165,-7799
13910,0.0,0.0,0.0,3611,61968,54165,-7803
13911,0.0,0.0,0.0,3611,61972,54165,-7807
13913,0.0,0.0,0.0,3611,61976,54165,-7811
13914,0.0,0.0,0.0,3611,61980,54165,-7815
13916,0.0,0.0,0.0,3611,61984,54165,-7819
13917,0.0,0.0,0.0,3611,61988,54165,-7823
13918,0.0,0.0,0.0,3611,61992,54165,-7827
13919,0.0,0.0,0.0,3611,61996,54165,-7831
13920,0.0,0.0,0.0,3611,62000,54165,-7835
13921,0.0,0.0,0.0,3611,62004,54165,-7839
13922,0.0,0.0,0.0,3611,62008,54165,-7843
13923,0.0,0.0,0.0,3611,62012,54165,-7847
13924,0.0,0.0,0.0,3611,62016,54165,-7851
13925,0.0,0.0,0.0,3611,62020,54165,-7855
13926,0.0,0.0,0.0,3611,62024,54165,-7859
13928,0.0,0.0,0.0,3611,62028,54165,-7863
13929,0.0,0.0,0.0,3611,62032,54165,-7867
13932,0.0,0.0,0.0,3611,62036,54165,-7871
13933,0.0,0.0,0.0,3611,62040,54165,-7875
13934,0.0,0.0,0.0,3611,62044,54165,-7879
13935,0.0,0.0,0.0,3611,62048,54165,-7883
13936,0.0,0.0,0.0,3611,62052,54165,-7887
13937,0.0,0.0,0.0,3611,62056,54165,-7891
13938,0.0,0.0,0.0,3611,62060,54165,-7895
13940,0.0,0.0,0.0,3611,62064,54165,-7899
13941,0.0,0.0,0.0,3611,62068,54165,-7903
13942,0.0,0.0,0.0,3611,62072,54165,-7907
13943,0.0,0.0,0.0,3611,62076,54165,-7911
13946,0.0,0.0,0.0,3611,62080,54165,-7915
13947,0.0,0.0,0.0,3611,62084,54165,-7919
13948,0.0,0.0,0.0,3611,62088,54165,-7923
13949,0.0,0.0,0.0,3611,62092,54165,-7927
13952,0.0,0.0,0.0,3611,62096,54165,-7931
13953,0.0,0.0,0.0,3611,62100,54165,-7935
13955,0.0,0.0,0.0,3611,62104,54165,-7939
13957,0.0,0.0,0.0,3611,62108,54165,-7943
13959,0.0,0.0,0.0,3611,62112,54165,-7947
13960,0.0,0.0,0.0,3611,62116,54165,-7951
13962,0.0,0.0,0.0,3611,62120,54165,-7955
13963,0.0,0.0,0.0,3611,62124,54165,-7959
13965,0.0,0.0,0.0,3611,62128,54165,-7963
13966,0.0,0.0,0.0,3611,62132,54165,-7967
13967,0.0,0.0,0.0,3611,62136,54165,-7971
13969,0.0,0.0,0.0,3611,62140,54165,-7975
13971,0.0,0.0,0.0,3611,62144,54165,-7979
13972,0.0,0.0,0.0,3611,62148,54165,-7983
13973,0.0,0.0,0.0,3611,62152,54165,-7987
13974,0.0,0.0,0.0,3611,62156,54165,-7991
13975,0.0,0.0,0.0,3611,62160,54165,-7995
13977,0.0,0.0,0.0,3611,62164,54165,-7999
13979,0.0,0.0,0.0,3611,62168,54165,-8003
13980,0.0,0.0,0.0,3611,62172,54165,-8007
13981,0.0,0.0,0.0,3611,62176,54165,-8011
13982,0.0,0.0,0.0,3611,62180,54165,-8015
13983,0.0,0.0,0.0,3611,62184,54165,-8019
13984,0.0,0.0,0.0,3611,62188,54165,-8023
13985,0.0,0.0,0.0,3611,62192,54165,-8027
13986,0.0,0.0,0.0,3611,62196,54165,-8031
13987,0.0,0.0,0.0,3611,62200,54165,-8035
13988,0.0,0.0,0.0,3611,62204,54165,-8039
13989,0.0,0.0,0.0,3611,62208,54165,-8043
13990,0.0,0.0,0.0,3611,62212,54165,-8047
13991,0.0,0.0,0.0,3611,62216,54165,-8051
13992,0.0,0.0,0.0,3611,62220,54165,-8055
13993,0.0,0.0,0.0,3611,62224,54165,-8059
13994,0.0,0.0,0.0,3611,62228,54165,-8063
13995,0.0,0.0,0.0,3611,62232,54165,-8067
13996,0.0,0.0,0.0,3611,62236,54165,-8071
13997,0.0,0.0,0.0,3611,62240,54165,-8075
13998,0.0,0.0,0.0,3611,62244,54165,-8079
13999,0.0,0.0,0.0,3611,62248,54165,-8083
14000,0.0,0.0,0.0,3611,62252,54165,-8087
14001,0.0,0.0,0.0,3611,62256,54165,-8091
14002,0.0,0.0,0.0,3611,62260,54165,-8095
14003,0.0,0.0,0.0,3611,62264,54165,-8099
14004,0.0,0.0,0.0,3611,62268,54165,-8103
14005,0.0,0.0,0.0,3611,62272,54165,-8107
14007,0.0,0.0,0.0,3611,62276,54165,-8111
14008,0.0,0.0,0.0,3611,62280,54165,-8115
14011,0.0,0.0,0.0,3611,62284,54165,-8119
14012,0.0,0.0,0.0,3611,62288,54165,-8123
14013,0.0,0.0,0.0,3611,62292,54165,-8127
14015,0.0,0.0,0.0,3611,62296,54165,-8131
14016,0.0,0.0,0.0,3611,62300,54165,-8135
14018,0.0,0.0,0.0,3611,62304,54165,-8139
14019,0.0,0.0,0.0,3611,62308,54165,-8143
14020,0.0,0.0,0.0,3611,62312,54165,-8147
14021,0.0,0.0,0.0,3611,62316,54165,-8151
14022,0.0,0.0,0.0,3611,62320,54165,-8155
14023,0.0,0.0,0.0,3611,62324,54165,-8159
14024,0.0,0.0,0.0,3611,62328,54165,-8163
14025,0.0,0.0,0.0,3611,62332,54165,-8167
14026,0.0,0.0,0.0,3611,62336,54165,-8171
14027,0.0,0.0,0.0,3611,62340,54165,-8175
14028,0.0,0.0,0.0,3611,62344,54165,-8179
14029,0.0,0.0,0.0,3611,62348,54165,-8183
14031,0.0,0.0,0.0,3611,62352,54165,-8187
14032,0.0,0.0,0.0,3611,62356,54165,-8191
14033,0.0,0.0,0.0,3611,62360,54165,-8195
14034,0.0,0.0,0.0,3611,62364,54165,-8199
14036,0.0,0.0,0.0,3611,62368,54165,-8203
14037,0.0,0.0,0.0,3611,62372,54165,-8207
14038,0.0,0.0,0.0,3611,62376,54165,-8211
14039,0.0,0.0,0.0,3611,62380,54165,-8215
14040,0.0,0.0,0.0,3611,62384,54165,-8219
14042,0.0,0.0,0.0,3611,62388,54165,-8223
14043,0.0,0.0,0.0,3611,62392,54165,-8227
14044,0.0,0.0,0.0,3611,62396,54165,-8231
14045,0.0,0.0,0.0,3611,62400,54165,-8235
14046,0.0,0.0,0.0,3611,62404,54165,-8239
14048,0.0,0.0,0.0,3611,62408,54165,-8243
14050,0.0,0.0,0.0,3611,62412,54165,-8247
14051,0.0,0.0,0.0,3611,62416,54165,-8251
14053,0.0,0.0,0.0,3611,62420,54165,-8255
14054,0.0,0.0,0.0,3611,62424,54165,-8259
14055,0.0,0.0,0.0,3611,62428,54165,-8263
14056,0.0,0.0,0.0,3611,62432,54165,-8267
14057,0.0,0.0,0.0,3611,62436,54165,-8271
14058,0.0,0.0,0.0,3611,62440,54165,-8275
14059,0.0,0.0,0.0,3611,62444,54165,-8279
14060,0.0,0.0,0.0,3611,62448,54165,-8283
14062,0.0,0.0,0.0,3611,62452,54165,-8287
14063,0.0,0.0,0.0,3611,62456,54165,-8291
14064,0.0,0.0,0.0,3611,62460,54165,-8295
14065,0.0,0.0,0.0,3611,62464,54165,-8299
14066,0.0,0.0,0.0,3611,62468,54165,-8303
14067,0.0,0.0,0.0,3611,62472,54165,-8307
14068,0.0,0.0,0.0,3611,62476,54165,-8311
14069,0.0,0.0,0.0,3611,62480,54165,-8315
14070,0.0,0.0,0.0,3611,62484,54165,-8319
14071,0.0,0.0,0.0,3611,62488,54165,-8323
14072,0.0,0.0,0.0,3611,62492,54165,-8327
14073,0.0,0.0,0.0,3611,62496,54165,-8331
14074,0.0,0.0,0.0,3611,62500,54165,-8335
14075,0.0,0.0,0.0,3611,62504,54165,-8339
14076,0.0,0.0,0.0,3611,62508,54165,-8343
14077,0.0,0.0,0.0,3611,62512,54165,-8347
14078,0.0,0.0,0.0,3611,62516,54165,-8351
14079,0.0,0.0,0.0,3611,62520,54165,-8355
14080,0.0,0.0,0.0,3611,62524,54165,-8359
14081,0.0,0.0,0.0,3611,62528,54165,-8363
14082,0.0,0.0,0.0,3611,62532,54165,-8367
14083,0.0,0.0,0.0,3611,62536,54165,-8371
14084,0.0,0.0,0.0,3611,62540,54165,-8375
14085,0.0,0.0,0.0,3611,62544,54165,-8379
14086,0.0,0.0,0.0,3611,62548,54165,-8383
14087,0.0,0.0,0.0,3611,62552,54165,-8387
14088,0.0,0.0,0.0,3611,62556,54165,-8391
14089,0.0,0.0,0.0,3611,62560,54165,-8395
14090,0.0,0.0,0.0,3611,62564,54165,-8399
14092,0.0,0.0,0.0,3611,62568,54165,-8403
14093,0.0,0.0,0.0,3611,62572,54165,-8407
14094,0.0,0.0,0.0,3611,62576,54165,-8411
14095,0.0,0.0,0.0,3611,62580,54165,-8415
14096,0.0,0.0,0.0,3611,62584,54165,-8419
14098,0.0,0.0,0.0,3611,62588,54165,-8423
14099,0.0,0.0,0.0,3611,62592,54165,-8427
14103,0.0,0.0,0.0,3611,62596,54165,-8431
14106,0.0,0.0,0.0,3611,62600,54165,-8435
14107,0.0,0.0,0.0,3611,62604,54165,-8439
14108,0.0,0.0,0.0,3611,62608,54165,-8443
14110,0.0,0.0,0.0,3611,62612,54165,-8447
14111,0.0,0.0,0.0,3611,62616,54165,-8451
14112,0.0,0.0,0.0,3611,62620,54165,-8455
14113,0.0,0.0,0.0,3611,62624,54165,-8459
14114,0.0,0.0,0.0,3611,62628,54165,-8463
14115,0.0,0.0,0.0,3611,62632,54165,-8467
14116,0.0,0.0,0.0,3611,62636,54165,-8471
14118,0.0,0.0,0.0,3611,62640,54165,-8475
14119,0.0,0.0,0.0,3611,62644,54165,-8479
14120,0.0,0.0,0.0,3611,62648,54165,-8483
14121,0.0,0.0,0.0,3611,62652,54165,-8487
14122,0.0,0.0,0.0,3611,62656,54165,-8491
14123,0.0,0.0,0.0,3611,62660,54165,-8495
14124,0.0,0.0,0.0,3611,62664,54165,-8499
14125,0.0,0.0,0.0,3611,62668,54165,-8503
14126,0.0,0.0,0.0,3611,62672,54165,-8507
14127,0.0,0.0,0.0,3611,62676,54165,-8511
14128,0.0,0.0,0.0,3611,62680,54165,-8515
14130,0.0,0.0,0.0,3611,62684,54165,-8519
14134,0.0,0.0,0.0,3611,62688,54165,-8523
14135,0.0,0.0,0.0,3611,62692,54165,-8527
14136,0.0,0.0,0.0,3611,62696,54165,-8531
14138,0.0,0.0,0.0,3611,62700,54165,-8535
14140,0.0,0.0,0.0,3611,62704,54165,-8539
14141,0.0,0.0,0.0,3611,62708,54165,-8543
14142,0.0,0.0,0.0,3611,62712,54165,-8547
14145,0.0,0.0,0.0,3611,62716,54165,-8551
14146,0.0,0.0,0.0,3611,62720,54165,-8555
14147,0.0,0.0,0.0,3611,62724,54165,-8559
14148,0.0,0.0,0.0,3611,62728,54165,-8563
14149,0.0,0.0,0.0,3611,62732,54165,-8567
14150,0.0,0.0,0.0,3611,62736,54165,-8571
14151,0.0,0.0,0.0,3611,62740,54165,-8575
14152,0.0,0.0,0.0,3611,62744,54165,-8579
14153,0.0,0.0,0.0,3611,62748,54165,-8583
14154,0.0,0.0,0.0,3611,62752,54165,-8587
14155,0.0,0.0,0.0,3611,62756,54165,-8591
14156,0.0,0.0,0.0,3611,62760,54165,-8595
14157,0.0,0.0,0.0,3611,62764,54165,-8599
14160,0.0,0.0,0.0,3611,62768,54165,-8603
14161,0.0,0.0,0.0,3611,62772,54165,-8607
14163,0.0,0.0,0.0,3611,62776,54165,-8611
14164,0.0,0.0,0.0,3611,62780,54165,-8615
14167,0.0,0.0,0.0,3611,62784,54165,-8619
14168,0.0,0.0,0.0,3611,62788,54165,-8623
14169,0.0,0.0,0.0,3611,62792,54165,-8627
14170,0.0,0.0,0.0,3611,62796,54165,-8631
14171,0.0,0.0,0.0,3611,62800,54165,-8635
14173,0.0,0.0,0.0,3611,62804,54165,-8639
14174,0.0,0.0,0.0,3611,62808,54165,-8643
14175,0.0,0.0,0.0,3611,62812,54165,-8647
14176,0.0,0.0,0.0,3611,62816,54165,-8651
14177,0.0,0.0,0.0,3611,62820,54165,-8655
14178,0.0,0.0,0.0,3611,62824,54165,-8659
14179,0.0,0.0,0.0,3611,62828,54165,-8663
14180,0.0,0.0,0.0,3611,62832,54165,-8667
14182,0.0,0.0,0.0,3611,62836,54165,-8671
14183,0.0,0.0,0.0,3611,62840,54165,-8675
14184,0.0,0.0,0.0,3611,62844,54165,-8679
14185,0.0,0.0,0.0,3611,62848,54165,-8683
14187,0.0,0.0,0.0,3611,62852,54165,-8687
14188,0.0,0.0,0.0,3611,62856,54165,-8691
14189,0.0,0.0,0.0,3611,62860,54165,-8695
14190,0.0,0.0,0.0,3611,62864,54165,-8699
14191,0.0,0.0,0.0,3611,62868,54165,-8703
14192,0.0,0.0,0.0,3611,62872,54165,-8707
14198,0.0,0.0,0.0,3611,62876,54165,-8711
14200,0.0,0.0,0.0,3611,62880,54165,-8715
14201,0.0,0.0,0.0,3611,62884,54165,-8719
14202,0.0,0.0,0.0,3611,62888,54165,-8723
14203,0.0,0.0,0.0,3611,62892,54165,-8727
14204,0.0,0.0,0.0,3611,62896,54165,-8731
14205,0.0,0.0,0.0,3611,62900,54165,-8735
14206,0.0,0.0,0.0,3611,62904,54165,-8739
14207,0.0,0.0,0.0,3611,62908,54165,-8743
14208,0.0,0.0,0.0,3611,62912,54165,-8747
14209,0.0,0.0,0.0,3611,62916,54165,-8751
14210,0.0,0.0,0.0,3611,62920,54165,-8755
14211,0.0,0.0,0.0,3611,62924,54165,-8759
14214,0.0,0.0,0.0,3611,62928,54165,-8763
14215,0.0,0.0,0.0,3611,62932,54165,-8767
14217,0.0,0.0,0.0,3611,62936,54165,-8771
14218,0.0,0.0,0.0,3611,62940,54165,-8775
14220,0.0,0.0,0.0,3611,62944,54165,-8779
14222,0.0,0.0,0.0,3611,62948,54165,-8783
14225,0.0,0.0,0.0,3611,62952,54165,-8787
14226,0.0,0.0,0.0,3611,62956,54165,-8791
14227,0.0,0.0,0.0,3611,62960,54165,-8795
14229,0.0,0.0,0.0,3611,62964,54165,-8799
14230,0.0,0.0,0.0,3611,62968,54165,-8803
14231,0.0,0.0,0.0,3611,62972,54165,-8807
14232,0.0,0.0,0.0,3611,62976,54165,-8811
14234,0.0,0.0,0.0,3611,62980,54165,-8815
14235,0.0,0.0,0.0,3611,62984,54165,-8819
14237,0.0,0.0,0.0,3611,62988,54165,-8823
14240,0.0,0.0,0.0,3611,62992,54165,-8827
14243,0.0,0.0,0.0,3611,62996,54165,-8831
14244,0.0,0.0,0.0,3611,63000,54165,-8835
14245,0.0,0.0,0.0,3611,63004,54165,-8839
14246,0.0,0.0,0.0,3611,63008,54165,-8843
14248,0.0,0.0,0.0,3611,63012,54165,-8847
14249,0.0,0.0,0.0,3611,63016,54165,-8851
14250,0.0,0.0,0.0,3611,63020,54165,-8855
14251,0.0,0.0,0.0,3611,63024,54165,-8859
14252,0.0,0.0,0.0,3611,63028,54165,-8863
14253,0.0,0.0,0.0,3611,63032,54165,-8867
14254,0.0,0.0,0.0,3611,63036,54165,-8871
14255,0.0,0.0,0.0,3611,63040,54165,-8875
14257,0.0,0.0,0.0,3611,63044,54165,-8879
14258,0.0,0.0,0.0,3611,63048,54165,-8883
14261,0.0,0.0,0.0,3611,63052,54165,-8887
14262,0.0,0.0,0.0,3611,63056,54165,-8891
14263,0.0,0.0,0.0,3611,63060,54165,-8895
14264,0.0,0.0,0.0,3611,63064,54165,-8899
14265,0.0,0.0,0.0,3611,63068,54165,-8903
14266,0.0,0.0,0.0,3611,63072,54165,-8907
14267,0.0,0.0,0.0,3611,63076,54165,-8911
14268,0.0,0.0,0.0,3611,63080,54165,-8915
14269,0.0,0.0,0.0,3611,63084,54165,-8919
14271,0.0,0.0,0.0,3611,63088,54165,-8923
14273,0.0,0.0,0.0,3611,63092,54165,-8927
14275,0.0,0.0,0.0,3611,63096,54165,-8931
14276,0.0,0.0,0.0,3611,63100,54165,-8935
14278,0.0,0.0,0.0,3611,63104,54165,-8939
14279,0.0,0.0,0.0,3611,63108,54165,-8943
14281,0.0,0.0,0.0,3611,63112,54165,-8947
14282,0.0,0.0,0.0,3611,63116,54165,-8951
14283,0.0,0.0,0.0,3611,63120,54165,-8955
14284,0.0,0.0,0.0,3611,63124,54165,-8959
14285,0.0,0.0,0.0,3611,63128,54165,-8963
14286,0.0,0.0,0.0,3611,63132,54165,-8967
14288,0.0,0.0,0.0,3611,63136,54165,-8971
14289,0.0,0.0,0.0,3611,63140,54165,-8975
14290,0.0,0.0,0.0,3611,63144,54165,-8979
14291,0.0,0.0,0.0,3611,63148,54165,-8983
14292,0.0,0.0,0.0,3611,63152,54165,-8987
14293,0.0,0.0,0.0,3611,63156,54165,-8991
14294,0.0,0.0,0.0,3611,63160,54165,-8995
14295,0.0,0.0,0.0,3611,63164,54165,-8999
14297,0.0,0.0,0.0,3611,63168,54165,-9003
14300,0.0,0.0,0.0,3611,63172,54165,-9007
14301,0.0,0.0,0.0,3611,63176,54165,-9011
14304,0.0,0.0,0.0,3611,63180,54165,-9015
14305,0.0,0.0,0.0,3611,63184,54165,-9019
14306,0.0,0.0,0.0,3611,63188,54165,-9023
14307,0.0,0.0,0.0,3611,63192,54165,-9027
14309,0.0,0.0,0.0,3611,63196,54165,-9031
14310,0.0,0.0,0.0,3611,63200,54165,-9035
14311,0.0,0.0,0.0,3611,63204,54165,-9039
14312,0.0,0.0,0.0,3611,63208,54165,-9043
14313,0.0,0.0,0.0,3611,63212,54165,-9047
14314,0.0,0.0,0.0,3611,63216,54165,-9051
14315,0.0,0.0,0.0,3611,63220,54165,-9055
14316,0.0,0.0,0.0,3611,63224,54165,-9059
14317,0.0,0.0,0.0,3611,63228,54165,-9063
14318,0.0,0.0,0.0,3611,63232,54165,-9067
14320,0.0,0.0,0.0,3611,63236,54165,-9071
14322,0.0,0.0,0.0,3611,63240,54165,-9075
14324,0.0,0.0,0.0,3611,63244,54165,-9079
14327,0.0,0.0,0.0,3611,63248,54165,-9083
14329,0.0,0.0,0.0,3611,63252,54165,-9087
14331,0.0,0.0,0.0,3611,63256,54165,-9091
14332,0.0,0.0,0.0,3611,63260,54165,-9095
14333,0.0,0.0,0.0,3611,63264,54165,-9099
14335,0.0,0.0,0.0,3611,63268,54165,-9103
14336,0.0,0.0,0.0,3611,63272,54165,-9107
14337,0.0,0.0,0.0,3611,63276,54165,-9111
14338,0.0,0.0,0.0,3611,63280,54165,-9115
14339,0.0,0.0,0.0,3611,63284,54165,-9119
14340,0.0,0.0,0.0,3611,63288,54165,-9123
14341,0.0,0.0,0.0,3611,63292,54165,-9127
14342,0.0,0.0,0.0,3611,63296,54165,-9131
14343,0.0,0.0,0.0,3611,63300,54165,-9135
14344,0.0,0.0,0.0,3611,63304,54165,-9139
14345,0.0,0.0,0.0,3611,63308,54165,-9143
14346,0.0,0.0,0.0,3611,63312,54165,-9147
14347,0.0,0.0,0.0,3611,63316,54165,-9151
14348,0.0,0.0,0.0,3611,63320,54165,-9155
14349,0.0,0.0,0.0,3611,63324,54165,-9159
14350,0.0,0.0,0.0,3611,63328,54165,-9163
14351,0.0,0.0,0.0,3611,63332,54165,-9167
14353,0.0,0.0,0.0,3611,63336,54165,-9171
14354,0.0,0.0,0.0,3611,63340,54165,-9175
14355,0.0,0.0,0.0,3611,63344,54165,-9179
14356,0.0,0.0,0.0,3611,63348,54165,-9183
14357,0.0,0.0,0.0,3611,63352,54165,-9187
14358,0.0,0.0,0.0,3611,63356,54165,-9191
14360,0.0,0.0,0.0,3611,63360,54165,-9195
14362,0.0,0.0,0.0,3611,63364,54165,-9199
14364,0.0,0.0,0.0,3611,63368,54165,-9203
14365,0.0,0.0,0.0,3611,63372,54165,-9207
14367,0.0,0.0,0.0,3611,63376,54165,-9211
14368,0.0,0.0,0.0,3611,63380,54165,-9215
14369,0.0,0.0,0.0,3611,63384,54165,-9219
14370,0.0,0.0,0.0,3611,63388,54165,-9223
14371,0.0,0.0,0.0,3611,63392,54165,-9227
14372,0.0,0.0,0.0,3611,63396,54165,-9231
14374,0.0,0.0,0.0,3611,63400,54165,-9235
14376,0.0,0.0,0.0,3611,63404,54165,-9239
14377,0.0,0.0,0.0,3611,63408,54165,-9243
14378,0.0,0.0,0.0,3611,63412,54165,-9247
14380,0.0,0.0,0.0,3611,63416,54165,-9251
14381,0.0,0.0,0.0,3611,63420,54165,-9255
14383,0.0,0.0,0.0,3611,63424,54165,-9259
14385,0.0,0.0,0.0,3611,63428,54165,-9263
14386,0.0,0.0,0.0,3611,63432,54165,-9267
14387,0.0,0.0,0.0,3611,63436,54165,-9271
14388,0.0,0.0,0.0,3611,63440,54165,-9275
14389,0.0,0.0,0.0,3611,63444,54165,-9279
14392,0.0,0.0,0.0,3611,63448,54165,-9283
14393,0.0,0.0,0.0,3611,63452,54165,-9287
14395,0.0,0.0,0.0,3611,63456,54165,-9291
14397,0.0,0.0,0.0,3611,63460,54165,-9295
14399,0.0,0.0,0.0,3611,63464,54165,-9299
14401,0.0,0.0,0.0,3611,63468,54165,-9303
14402,0.0,0.0,0.0,3611,63472,54165,-9307
14403,0.0,0.0,0.0,3611,63476,54165,-9311
14405,0.0,0.0,0.0,3611,63480,54165,-9315
14406,0.0,0.0,0.0,3611,63484,54165,-9319
14407,0.0,0.0,0.0,3611,63488,54165,-9323
14408,0.0,0.0,0.0,3611,63492,54165,-9327
14411,0.0,0.0,0.0,3611,63496,54165,-9331
14412,0.0,0.0,0.0,3611,63500,54165,-9335
14413,0.0,0.0,0.0,3611,63504,54165,-9339
14414,0.0,0.0,0.0,3611,63508,54165,-9343
14415,0.0,0.0,0.0,3611,63512,54165,-9347
14416,0.0,0.0,0.0,3611,63516,54165,-9351
14418,0.0,0.0,0.0,3611,63520,54165,-9355
14419,0.0,0.0,0.0,3611,63524,54165,-9359
14421,0.0,0.0,0.0,3611,63528,54165,-9363
14422,0.0,0.0,0.0,3611,63532,54165,-9367
14423,0.0,0.0,0.0,3611,63536,54165,-9371
14424,0.0,0.0,0.0,3611,63540,54165,-9375
14425,0.0,0.0,0.0,3611,63544,54165,-9379
14426,0.0,0.0,0.0,3611,63548,54165,-9383
14427,0.0,0.0,0.0,3611,63552,54165,-9387
14428,0.0,0.0,0.0,3611,63556,54165,-9391
14429,0.0,0.0,0.0,3611,63560,54165,-9395
14431,0.0,0.0,0.0,3611,63564,54165,-9399
14432,0.0,0.0,0.0,3611,63568,54165,-9403
14433,0.0,0.0,0.0,3611,63572,54165,-9407
14434,0.0,0.0,0.0,3611,63576,54165,-9411
14435,0.0,0.0,0.0,3611,63580,54165,-9415
14436,0.0,0.0,0.0,3611,63584,54165,-9419
14437,0.0,0.0,0.0,3611,63588,54165,-9423
14440,0.0,0.0,0.0,3611,63592,54165,-9427
14441,0.0,0.0,0.0,3611,63596,54165,-9431
14442,0.0,0.0,0.0,3611,63600,54165,-9435
14444,0.0,0.0,0.0,3611,63604,54165,-9439
14445,0.0,0.0,0.0,3611,63608,54165,-9443
14447,0.0,0.0,0.0,3611,63612,54165,-9447
14448,0.0,0.0,0.0,3611,63616,54165,-9451
14450,0.0,0.0,0.0,3611,63620,54165,-9455
14451,0.0,0.0,0.0,3611,63624,54165,-9459
14453,0.0,0.0,0.0,3611,63628,54165,-9463
14454,0.0,0.0,0.0,3611,63632,54165,-9467
14455,0.0,0.0,0.0,3611,63636,54165,-9471
14456,0.0,0.0,0.0,3611,63640,54165,-9475
14457,0.0,0.0,0.0,3611,63644,54165,-9479
14458,0.0,0.0,0.0,3611,63648,54165,-9483
14459,0.0,0.0,0.0,3611,63652,54165,-9487
14460,0.0,0.0,0.0,3611,63656,54165,-9491
14461,0.0,0.0,0.0,3611,63660,54165,-9495
14462,0.0,0.0,0.0,3611,63664,54165,-9499
14463,0.0,0.0,0.0,3611,63668,54165,-9503
14465,0.0,0.0,0.0,3611,63672,54165,-9507
14467,0.0,0.0,0.0,3611,63676,54165,-9511
14468,0.0,0.0,0.0,3611,63680,54165,-9515
14469,0.0,0.0,0.0,3611,63684,54165,-9519
14470,0.0,0.0,0.0,3611,63688,54165,-9523
14471,0.0,0.0,0.0,3611,63692,54165,-9527
14472,0.0,0.0,0.0,3611,63696,54165,-9531
14473,0.0,0.0,0.0,3611,63700,54165,-9535
14474,0.0,0.0,0.0,3611,63704,54165,-9539
14475,0.0,0.0,0.0,3611,63708,54165,-9543
14476,0.0,0.0,0.0,3611,63712,54165,-9547
14477,0.0,0.0,0.0,3611,63716,54165,-9551
14479,0.0,0.0,0.0,3611,63720,54165,-9555
14480,0.0,0.0,0.0,3611,63724,54165,-9559
14481,0.0,0.0,0.0,3611,63728,54165,-9563
14482,0.0,0.0,0.0,3611,63732,54165,-9567
14483,0.0,0.0,0.0,3611,63736,54165,-9571
14484,0.0,0.0,0.0,3611,63740,54165,-9575
14485,0.0,0.0,0.0,3611,63744,54165,-9579
14486,0.0,0.0,0.0,3611,63748,54165,-9583
14487,0.0,0.0,0.0,3611,63752,54165,-9587
14488,0.0,0.0,0.0,3611,63756,54165,-9591
14489,0.0,0.0,0.0,3611,63760,54165,-9595
14490,0.0,0.0,0.0,3611,63764,54165,-9599
14491,0.0,0.0,0.0,3611,63768,54165,-9603
14492,0.0,0.0,0.0,3611,63772,54165,-9607
14493,0.0,0.0,0.0,3611,63776,54165,-9611
14494,0.0,0.0,0.0,3611,63780,54165,-9615
14495,0.0,0.0,0.0,3611,63784,54165,-9619
14496,0.0,0.0,0.0,3611,63788,54165,-9623
14497,0.0,0.0,0.0,3611,63792,54165,-9627
14498,0.0,0.0,0.0,3611,63796,54165,-9631
14499,0.0,0.0,0.0,3611,63800,54165,-9635
14500,0.0,0.0,0.0,3611,63804,54165,-9639
14501,0.0,0.0,0.0,3611,63808,54165,-9643
14503,0.0,0.0,0.0,3611,63812,54165,-9647
14505,0.0,0.0,0.0,3611,63816,54165,-9651
14506,0.0,0.0,0.0,3611,63820,54165,-9655
14507,0.0,0.0,0.0,3611,63824,54165,-9659
14508,0.0,0.0,0.0,3611,63828,54165,-9663
14509,0.0,0.0,0.0,3611,63832,54165,-9667
14511,0.0,0.0,0.0,3611,63836,54165,-9671
14514,0.0,0.0,0.0,3611,63840,54165,-9675
14516,0.0,0.0,0.0,3611,63844,54165,-9679
14517,0.0,0.0,0.0,3611,63848,54165,-9683
14519,0.0,0.0,0.0,3611,63852,54165,-9687
14520,0.0,0.0,0.0,3611,63856,54165,-9691
14521,0.0,0.0,0.0,3611,63860,54165,-9695
14522,0.0,0.0,0.0,3611,63864,54165,-9699
14523,0.0,0.0,0.0,3611,63868,54165,-9703
14524,0.0,0.0,0.0,3611,63872,54165,-9707
14526,0.0,0.0,0.0,3611,63876,54165,-9711
14530,0.0,0.0,0.0,3611,63880,54165,-9715
14531,0.0,0.0,0.0,3611,63884,54165,-9719
14533,0.0,0.0,0.0,3611,63888,54165,-9723
14534,0.0,0.0,0.0,3611,63892,54165,-9727
14535,0.0,0.0,0.0,3611,63896,54165,-9731
14537,0.0,0.0,0.0,3611,63900,54165,-9735
14538,0.0,0.0,0.0,3611,63904,54165,-9739
14539,0.0,0.0,0.0,3611,63908,54165,-9743
14540,0.0,0.0,0.0,3611,63912,54165,-9747
14541,0.0,0.0,0.0,3611,63916,54165,-9751
14542,0.0,0.0,0.0,3611,63920,54165,-9755
14543,0.0,0.0,0.0,3611,63924,54165,-9759
14547,0.0,0.0,0.0,3611,63928,54165,-9763
14548,0.0,0.0,0.0,3611,63932,54165,-9767
14549,0.0,0.0,0.0,3611,63936,54165,-9771
14552,0.0,0.0,0.0,3611,63940,54165,-9775
14553,0.0,0.0,0.0,3611,63944,54165,-9779
14554,0.0,0.0,0.0,3611,63948,54165,-9783
14555,0.0,0.0,0.0,3611,63952,54165,-9787
14556,0.0,0.0,0.0,3611,63956,54165,-9791
14557,0.0,0.0,0.0,3611,63960,54165,-9795
14558,0.0,0.0,0.0,3611,63964,54165,-9799
14559,0.0,0.0,0.0,3611,63968,54165,-9803
14560,0.0,0.0,0.0,3611,63972,54165,-9807
14561,0.0,0.0,0.0,3611,63976,54165,-9811
14562,0.0,0.0,0.0,3611,63980,54165,-9815
14563,0.0,0.0,0.0,3611,63984,54165,-9819
14564,0.0,0.0,0.0,3611,63988,54165,-9823
14565,0.0,0.0,0.0,3611,63992,54165,-9827
14566,0.0,0.0,0.0,3611,63996,54165,-9831
14567,0.0,0.0,0.0,3611,64000,54165,-9835
14568,0.0,0.0,0.0,3611,64004,54165,-9839
14569,0.0,0.0,0.0,3611,64008,54165,-9843
14570,0.0,0.0,0.0,3611,64012,54165,-9847
14571,0.0,0.0,0.0,3611,64016,54165,-9851
14572,0.0,0.0,0.0,3611,64020,54165,-9855
14574,0.0,0.0,0.0,3611,64024,54165,-9859
14575,0.0,0.0,0.0,3611,64028,54165,-9863
14576,0.0,0.0,0.0,3611,64032,54165,-9867
14577,0.0,0.0,0.0,3611,64036,54165,-9871
14578,0.0,0.0,0.0,3611,64040,54165,-9875
14579,0.0,0.0,0.0,3611,64044,54165,-9879
14580,0.0,0.0,0.0,3611,64048,54165,-9883
14582,0.0,0.0,0.0,3611,64052,54165,-9887
14583,0.0,0.0,0.0,3611,64056,54165,-9891
14584,0.0,0.0,0.0,3611,64060,54165,-9895
14585,0.0,0.0,0.0,3611,64064,54165,-9899
14587,0.0,0.0,0.0,3611,64068,54165,-9903
14589,0.0,0.0,0.0,3611,64072,54165,-9907
14590,0.0,0.0,0.0,3611,64076,54165,-9911
14592,0.0,0.0,0.0,3611,64080,54165,-9915
14593,0.0,0.0,0.0,3611,64084,54165,-9919
14594,0.0,0.0,0.0,3611,64088,54165,-9923
14596,0.0,0.0,0.0,3611,64092,54165,-9927
14597,0.0,0.0,0.0,3611,64096,54165,-9931
14598,0.0,0.0,0.0,3611,64100,54165,-9935
14599,0.0,0.0,0.0,3611,64104,54165,-9939
14600,0.0,0.0,0.0,3611,64108,54165,-9943
14601,0.0,0.0,0.0,3611,64112,54165,-9947
14602,0.0,0.0,0.0,3611,64116,54165,-9951
14603,0.0,0.0,0.0,3611,64120,54165,-9955
14604,0.0,0.0,0.0,3611,64124,54165,-9959
14605,0.0,0.0,0.0,3611,64128,54165,-9963
14606,0.0,0.0,0.0,3611,64132,54165,-9967
14607,0.0,0.0,0.0,3611,64136,54165,-9971
14610,0.0,0.0,0.0,3611,64140,54165,-9975
14612,0.0,0.0,0.0,3611,64144,54165,-9979
14614,0.0,0.0,0.0,3611,64148,54165,-9983
14616,0.0,0.0,0.0,3611,64152,54165,-9987
14617,0.0,0.0,0.0,3611,64156,54165,-9991
14618,0.0,0.0,0.0,3611,64160,54165,-9995
14619,0.0,0.0,0.0,3611,64164,54165,-9999
14620,0.0,0.0,0.0,3611,64168,54165,-10003
14621,0.0,0.0,0.0,3611,64172,54165,-10007
14622,0.0,0.0,0.0,3611,64176,54165,-10011
14623,0.0,0.0,0.0,3611,64180,54165,-10015
14624,0.0,0.0,0.0,3611,64184,54165,-10019
14625,0.0,0.0,0.0,3611,64188,54165,-10023
14626,0.0,0.0,0.0,3611,64192,54165,-10027
14627,0.0,0.0,0.0,3611,64196,54165,-10031
14628,0.0,0.0,0.0,3611,64200,54165,-10035
14629,0.0,0.0,0.0,3611,64204,54165,-10039
14630,0.0,0.0,0.0,3611,64208,54165,-10043
14631,0.0,0.0,0.0,3611,64212,54165,-10047
14632,0.0,0.0,0.0,3611,64216,54165,-10051
14634,0.0,0.0,0.0,3611,64220,54165,-10055
14636,0.0,0.0,0.0,3611,64224,54165,-10059
14638,0.0,0.0,0.0,3611,64228,54165,-10063
14639,0.0,0.0,0.0,3611,64232,54165,-10067
14640,0.0,0.0,0.0,3611,64236,54165,-10071
14641,0.0,0.0,0.0,3611,64240,54165,-10075
14642,0.0,0.0,0.0,3611,64244,54165,-10079
14643,0.0,0.0,0.0,3611,64248,54165,-10083
14645,0.0,0.0,0.0,3611,64252,54165,-10087
14647,0.0,0.0,0.0,3611,64256,54165,-10091
14648,0.0,0.0,0.0,3611,64260,54165,-10095
14650,0.0,0.0,0.0,3611,64264,54165,-10099
14654,0.0,0.0,0.0,3611,64268,54165,-10103
14655,0.0,0.0,0.0,3611,64272,54165,-10107
14656,0.0,0.0,0.0,3611,64276,54165,-10111
14658,0.0,0.0,0.0,3611,64280,54165,-10115
14659,0.0,0.0,0.0,3611,64284,54165,-10119
14661,0.0,0.0,0.0,3611,64288,54165,-10123
14662,0.0,0.0,0.0,3611,64292,54165,-10127
14663,0.0,0.0,0.0,3611,64296,54165,-10131
14664,0.0,0.0,0.0,3611,64300,54165,-10135
14666,0.0,0.0,0.0,3611,64304,54165,-10139
14667,0.0,0.0,0.0,3611,64308,54165,-10143
14668,0.0,0.0,0.0,3611,64312,54165,-10147
14669,0.0,0.0,0.0,3611,64316,54165,-10151
14670,0.0,0.0,0.0,3611,64320,54165,-10155
14672,0.0,0.0,0.0,3611,64324,54165,-10159
14673,0.0,0.0,0.0,3611,64328,54165,-10163
14674,0.0,0.0,0.0,3611,64332,54165,-10167
14675,0.0,0.0,0.0,3611,64336,54165,-10171
14678,0.0,0.0,0.0,3611,64340,54165,-10175
14679,0.0,0.0,0.0,3611,64344,54165,-10179
14680,0.0,0.0,0.0,3611,64348,54165,-10183
14682,0.0,0.0,0.0,3611,64352,54165,-10187
14683,0.0,0.0,0.0,3611,64356,54165,-10191
14684,0.0,0.0,0.0,3611,64360,54165,-10195
14685,0.0,0.0,0.0,3611,64364,54165,-10199
14686,0.0,0.0,0.0,3611,64368,54165,-10203
14687,0.0,0.0,0.0,3611,64372,54165,-10207
14688,0.0,0.0,0.0,3611,64376,54165,-10211
14689,0.0,0.0,0.0,3611,64380,54165,-10215
14690,0.0,0.0,0.0,3611,64384,54165,-10219
14691,0.0,0.0,0.0,3611,64388,54165,-10223
14693,0.0,0.0,0.0,3611,64392,54165,-10227
14694,0.0,0.0,0.0,3611,64396,54165,-10231
14695,0.0,0.0,0.0,3611,64400,54165,-10235
14697,0.0,0.0,0.0,3611,64404,54165,-10239
14698,0.0,0.0,0.0,3611,64408,54165,-10243
14699,0.0,0.0,0.0,3611,64412,54165,-10247
14700,0.0,0.0,0.0,3611,64416,54165,-10251
14702,0.0,0.0,0.0,3611,64420,54165,-10255
14703,0.0,0.0,0.0,3611,64424,54165,-10259
14704,0.0,0.0,0.0,3611,64428,54165,-10263
14705,0.0,0.0,0.0,3611,64432,54165,-10267
14706,0.0,0.0,0.0,3611,64436,54165,-10271
14707,0.0,0.0,0.0,3611,64440,54165,-10275
14708,0.0,0.0,0.0,3611,64444,54165,-10279
14709,0.0,0.0,0.0,3611,64448,54165,-10283
14710,0.0,0.0,0.0,3611,64452,54165,-10287
14711,0.0,0.0,0.0,3611,64456,54165,-10291
14712,0.0,0.0,0.0,3611,64460,54165,-10295
14713,0.0,0.0,0.0,3611,64464,54165,-10299
14714,0.0,0.0,0.0,3611,64468,54165,-10303
14715,0.0,0.0,0.0,3611,64472,54165,-10307
14716,0.0,0.0,0.0,3611,64476,54165,-10311
14717,0.0,0.0,0.0,3611,64480,54165,-10315
14718,0.0,0.0,0.0,3611,64484,54165,-10319
14719,0.0,0.0,0.0,3611,64488,54165,-10323
14720,0.0,0.0,0.0,3611,64492,54165,-10327
14722,0.0,0.0,0.0,3611,64496,54165,-10331
14723,0.0,0.0,0.0,3611,64500,54165,-10335
14724,0.0,0.0,0.0,3611,64504,54165,-10339
14725,0.0,0.0,0.0,3611,64508,54165,-10343
14726,0.0,0.0,0.0,3611,64512,54165,-10347
14727,0.0,0.0,0.0,3611,64516,54165,-10351
14728,0.0,0.0,0.0,3611,64520,54165,-10355
14729,0.0,0.0,0.0,3611,64524,54165,-10359
14730,0.0,0.0,0.0,3611,64528,54165,-10363
14731,0.0,0.0,0.0,3611,64532,54165,-10367
14732,0.0,0.0,0.0,3611,64536,54165,-10371
14733,0.0,0.0,0.0,3611,64540,54165,-10375
14734,0.0,0.0,0.0,3611,64544,54165,-10379
14736,0.0,0.0,0.0,3611,64548,54165,-10383
14737,0.0,0.0,0.0,3611,64552,54165,-10387
14738,0.0,0.0,0.0,3611,64556,54165,-10391
14739,0.0,0.0,0.0,3611,64560,54165,-10395
14740,0.0,0.0,0.0,3611,64564,54165,-10399
14741,0.0,0.0,0.0,3611,64568,54165,-10403
14743,0.0,0.0,0.0,3611,64572,54165,-10407
14744,0.0,0.0,0.0,3611,64576,54165,-10411
14745,0.0,0.0,0.0,3611,64580,54165,-10415
14746,0.0,0.0,0.0,3611,64584,54165,-10419
14747,0.0,0.0,0.0,3611,64588,54165,-10423
14748,0.0,0.0,0.0,3611,64592,54165,-10427
14749,0.0,0.0,0.0,3611,64596,54165,-10431
14750,0.0,0.0,0.0,3611,64600,54165,-10435
14751,0.0,0.0,0.0,3611,64604,54165,-10439
14752,0.0,0.0,0.0,3611,64608,54165,-10443
14754,0.0,0.0,0.0,3611,64612,54165,-10447
14756,0.0,0.0,0.0,3611,64616,54165,-10451
14757,0.0,0.0,0.0,3611,64620,54165,-10455
14758,0.0,0.0,0.0,3611,64624,54165,-10459
14759,0.0,0.0,0.0,3611,64628,54165,-10463
14760,0.0,0.0,0.0,3611,64632,54165,-10467
14762,0.0,0.0,0.0,3611,64636,54165,-10471
14763,0.0,0.0,0.0,3611,64640,54165,-10475
14766,0.0,0.0,0.0,3611,64644,54165,-10479
14767,0.0,0.0,0.0,3611,64648,54165,-10483
14768,0.0,0.0,0.0,3611,64652,54165,-10487
14769,0.0,0.0,0.0,3611,64656,54165,-10491
14770,0.0,0.0,0.0,3611,64660,54165,-10495
14771,0.0,0.0,0.0,3611,64664,54165,-10499
14772,0.0,0.0,0.0,3611,64668,54165,-10503
14773,0.0,0.0,0.0,3611,64672,54165,-10507
14774,0.0,0.0,0.0,3611,64676,54165,-10511
14775,0.0,0.0,0.0,3611,64680,54165,-10515
14777,0.0,0.0,0.0,3611,64684,54165,-10519
14779,0.0,0.0,0.0,3611,64688,54165,-10523
14781,0.0,0.0,0.0,3611,64692,54165,-10527
14782,0.0,0.0,0.0,3611,64696,54165,-10531
14783,0.0,0.0,0.0,3611,64700,54165,-10535
14784,0.0,0.0,0.0,3611,64704,54165,-10539
14785,0.0,0.0,0.0,3611,64708,54165,-10543
14786,0.0,0.0,0.0,3611,64712,54165,-10547
14787,0.0,0.0,0.0,3611,64716,54165,-10551
14788,0.0,0.0,0.0,3611,64720,54165,-10555
14789,0.0,0.0,0.0,3611,64724,54165,-10559
14790,0.0,0.0,0.0,3611,64728,54165,-10563
14792,0.0,0.0,0.0,3611,64732,54165,-10567
14793,0.0,0.0,0.0,3611,64736,54165,-10571
14794,0.0,0.0,0.0,3611,64740,54165,-10575
14795,0.0,0.0,0.0,3611,64744,54165,-10579
14796,0.0,0.0,0.0,3611,64748,54165,-10583
14797,0.0,0.0,0.0,3611,64752,54165,-10587
14798,0.0,0.0,0.0,3611,64756,54165,-10591
14799,0.0,0.0,0.0,3611,64760,54165,-10595
14800,0.0,0.0,0.0,3611,64764,54165,-10599
14801,0.0,0.0,0.0,3611,64768,54165,-10603
14802,0.0,0.0,0.0,3611,64772,54165,-10607
14803,0.0,0.0,0.0,3611,64776,54165,-10611
14804,0.0,0.0,0.0,3611,64780,54165,-10615
14805,0.0,0.0,0.0,3611,64784,54165,-10619
14806,0.0,0.0,0.0,3611,64788,54165,-10623
14807,0.0,0.0,0.0,3611,64792,54165,-10627
14810,0.0,0.0,0.0,3611,64796,54165,-10631
14811,0.0,0.0,0.0,3611,64800,54165,-10635
14812,0.0,0.0,0.0,3611,64804,54165,-10639
14813,0.0,0.0,0.0,3611,64808,54165,-10643
14815,0.0,0.0,0.0,3611,64812,54165,-10647
14816,0.0,0.0,0.0,3611,64816,54165,-10651
14818,0.0,0.0,0.0,3611,64820,54165,-10655
14819,0.0,0.0,0.0,3611,64824,54165,-10659
14820,0.0,0.0,0.0,3611,64828,54165,-10663
14823,0.0,0.0,0.0,3611,64832,54165,-10667
14824,0.0,0.0,0.0,3611,64836,54165,-10671
14825,0.0,0.0,0.0,3611,64840,54165,-10675
14826,0.0,0.0,0.0,3611,64844,54165,-10679
14827,0.0,0.0,0.0,3611,64848,54165,-10683
14828,0.0,0.0,0.0,3611,64852,54165,-10687
14829,0.0,0.0,0.0,3611,64856,54165,-10691
14830,0.0,0.0,0.0,3611,64860,54165,-10695
14831,0.0,0.0,0.0,3611,64864,54165,-10699
14832,0.0,0.0,0.0,3611,64868,54165,-10703
14833,0.0,0.0,0.0,3611,64872,54165,-10707
14834,0.0,0.0,0.0,3611,64876,54165,-10711
14835,0.0,0.0,0.0,3611,64880,54165,-10715
14836,0.0,0.0,0.0,3611,64884,54165,-10719
14837,0.0,0.0,0.0,3611,64888,54165,-10723
14838,0.0,0.0,0.0,3611,64892,54165,-10727
14839,0.0,0.0,0.0,3611,64896,54165,-10731
14840,0.0,0.0,0.0,3611,64900,54165,-10735
14841,0.0,0.0,0.0,3611,64904,54165,-10739
14842,0.0,0.0,0.0,3611,64908,54165,-10743
14843,0.0,0.0,0.0,3611,64912,54165,-10747
14844,0.0,0.0,0.0,3611,64916,54165,-10751
14845,0.0,0.0,0.0,3611,64920,54165,-10755
14846,0.0,0.0,0.0,3611,64924,54165,-10759
14847,0.0,0.0,0.0,3611,64928,54165,-10763
14848,0.0,0.0,0.0,3611,64932,54165,-10767
14849,0.0,0.0,0.0,3611,64936,54165,-10771
14850,0.0,0.0,0.0,3611,64940,54165,-10775
14851,0.0,0.0,0.0,3611,64944,54165,-10779
14852,0.0,0.0,0.0,3611,64948,54165,-10783
14853,0.0,0.0,0.0,3611,64952,54165,-10787
14854,0.0,0.0,0.0,3611,64956,54165,-10791
14855,0.0,0.0,0.0,3611,64960,54165,-10795
14856,0.0,0.0,0.0,3611,64964,54165,-10799
14857,0.0,0.0,0.0,3611,64968,54165,-10803
14858,0.0,0.0,0.0,3611,64972,54165,-10807
14859,0.0,0.0,0.0,3611,64976,54165,-10811
14860,0.0,0.0,0.0,3611,64980,54165,-10815
14861,0.0,0.0,0.0,3611,64984,54165,-10819
14862,0.0,0.0,0.0,3611,64988,54165,-10823
14864,0.0,0.0,0.0,3611,64992,54165,-10827
14866,0.0,0.0,0.0,3611,64996,54165,-10831
14869,0.0,0.0,0.0,3611,65000,54165,-10835
14870,0.0,0.0,0.0,3611,65004,54165,-10839
14871,0.0,0.0,0.0,3611,65008,54165,-10843
14872,0.0,0.0,0.0,3611,65012,54165,-10847
14874,0.0,0.0,0.0,3611,65016,54165,-10851
14875,0.0,0.0,0.0,3611,65020,54165,-10855
14876,0.0,0.0,0.0,3611,65024,54165,-10859
14878,0.0,0.0,0.0,3611,65028,54165,-10863
14879,0.0,0.0,0.0,3611,65032,54165,-10867
14881,0.0,0.0,0.0,3611,65036,54165,-10871
14882,0.0,0.0,0.0,3611,65040,54165,-10875
14883,0.0,0.0,0.0,3611,65044,54165,-10879
14884,0.0,0.0,0.0,3611,65048,54165,-10883
14885,0.0,0.0,0.0,3611,65052,54165,-10887
14887,0.0,0.0,0.0,3611,65056,54165,-10891
14888,0.0,0.0,0.0,3611,65060,54165,-10895
14889,0.0,0.0,0.0,3611,65064,54165,-10899
14891,0.0,0.0,0.0,3611,65068,54165,-10903
14892,0.0,0.0,0.0,3611,65072,54165,-10907
14893,0.0,0.0,0.0,3611,65076,54165,-10911
14896,0.0,0.0,0.0,3611,65080,54165,-10915
14897,0.0,0.0,0.0,3611,65084,54165,-10919
14898,0.0,0.0,0.0,3611,65088,54165,-10923
14899,0.0,0.0,0.0,3611,65092,54165,-10927
14900,0.0,0.0,0.0,3611,65096,54165,-10931
14901,0.0,0.0,0.0,3611,65100,54165,-10935
14903,0.0,0.0,0.0,3611,65104,54165,-10939
14904,0.0,0.0,0.0,3611,65108,54165,-10943
14905,0.0,0.0,0.0,3611,65112,54165,-10947
14906,0.0,0.0,0.0,3611,65116,54165,-10951
14907,0.0,0.0,0.0,3611,65120,54165,-10955
14908,0.0,0.0,0.0,3611,65124,54165,-10959
14909,0.0,0.0,0.0,3611,65128,54165,-10963
14910,0.0,0.0,0.0,3611,65132,54165,-10967
14911,0.0,0.0,0.0,3611,65136,54165,-10971
14912,0.0,0.0,0.0,3611,65140,54165,-10975
14914,0.0,0.0,0.0,3611,65144,54165,-10979
14915,0.0,0.0,0.0,3611,65148,54165,-10983
14916,0.0,0.0,0.0,3611,65152,54165,-10987
14917,0.0,0.0,0.0,3611,65156,54165,-10991
14918,0.0,0.0,0.0,3611,65160,54165,-10995
14920,0.0,0.0,0.0,3611,65164,54165,-10999
14921,0.0,0.0,0.0,3611,65168,54165,-11003
14923,0.0,0.0,0.0,3611,65172,54165,-11007
14924,0.0,0.0,0.0,3611,65176,54165,-11011
14929,0.0,0.0,0.0,3611,65180,54165,-11015
14930,0.0,0.0,0.0,3611,65184,54165,-11019
14931,0.0,0.0,0.0,3611,65188,54165,-11023
14933,0.0,0.0,0.0,3611,65192,54165,-11027
14934,0.0,0.0,0.0,3611,65196,54165,-11031
14935,0.0,0.0,0.0,3611,65200,54165,-11035
14936,0.0,0.0,0.0,3611,65204,54165,-11039
14937,0.0,0.0,0.0,3611,65208,54165,-11043
14938,0.0,0.0,0.0,3611,65212,54165,-11047
14939,0.0,0.0,0.0,3611,65216,54165,-11051
14940,0.0,0.0,0.0,3611,65220,54165,-11055
14941,0.0,0.0,0.0,3611,65224,54165,-11059
14942,0.0,0.0,0.0,3611,65228,54165,-11063
14943,0.0,0.0,0.0,3611,65232,54165,-11067
14944,0.0,0.0,0.0,3611,65236,54165,-11071
14946,0.0,0.0,0.0,3611,65240,54165,-11075
14947,0.0,0.0,0.0,3611,65244,54165,-11079
14948,0.0,0.0,0.0,3611,65248,54165,-11083
14950,0.0,0.0,0.0,3611,65252,54165,-11087
14951,0.0,0.0,0.0,3611,65256,54165,-11091
14952,0.0,0.0,0.0,3611,65260,54165,-11095
14953,0.0,0.0,0.0,3611,65264,54165,-11099
14955,0.0,0.0,0.0,3611,65268,54165,-11103
14956,0.0,0.0,0.0,3611,65272,54165,-11107
14957,0.0,0.0,0.0,3611,65276,54165,-11111
14958,0.0,0.0,0.0,3611,65280,54165,-11115
14959,0.0,0.0,0.0,3611,65284,54165,-11119
14960,0.0,0.0,0.0,3611,65288,54165,-11123
14961,0.0,0.0,0.0,3611,65292,54165,-11127
14962,0.0,0.0,0.0,3611,65296,54165,-11131
14963,0.0,0.0,0.0,3611,65300,54165,-11135
14964,0.0,0.0,0.0,3611,65304,54165,-11139
14965,0.0,0.0,0.0,3611,65308,54165,-11143
14966,0.0,0.0,0.0,3611,65312,54165,-11147
14967,0.0,0.0,0.0,3611,65316,54165,-11151
14968,0.0,0.0,0.0,3611,65320,54165,-11155
14969,0.0,0.0,0.0,3611,65324,54165,-11159
14971,0.0,0.0,0.0,3611,65328,54165,-11163
14973,0.0,0.0,0.0,3611,65332,54165,-11167
14974,0.0,0.0,0.0,3611,65336,54165,-11171
14975,0.0,0.0,0.0,3611,65340,54165,-11175
14978,0.0,0.0,0.0,3611,65344,54165,-11179
14980,0.0,0.0,0.0,3611,65348,54165,-11183
14983,0.0,0.0,0.0,3611,65352,54165,-11187
14984,0.0,0.0,0.0,3611,65356,54165,-11191
14985,0.0,0.0,0.0,3611,65360,54165,-11195
14986,0.0,0.0,0.0,3611,65364,54165,-11199
14987,0.0,0.0,0.0,3611,65368,54165,-11203
14988,0.0,0.0,0.0,3611,65372,54165,-11207
14989,0.0,0.0,0.0,3611,65376,54165,-11211
14991,0.0,0.0,0.0,3611,65380,54165,-11215
14992,0.0,0.0,0.0,3611,65384,54165,-11219
14995,0.0,0.0,0.0,3611,65388,54165,-11223
14996,0.0,0.0,0.0,3611,65392,54165,-11227
14997,0.0,0.0,0.0,3611,65396,54165,-11231
15000,0.0,0.0,0.0,3611,65400,54165,-11235
15001,0.0,0.0,0.0,3611,65404,54165,-11239
15003,0.0,0.0,0.0,3611,65408,54165,-11243
15004,0.0,0.0,0.0,3611,65412,54165,-11247
15005,0.0,0.0,0.0,3611,65416,54165,-11251
15006,0.0,0.0,0.0,3611,65420,54165,-11255
15007,0.0,0.0,0.0,3611,65424,54165,-11259
15008,0.0,0.0,0.0,3611,65428,54165,-11263
15009,0.0,0.0,0.0,3611,65432,54165,-11267
15010,0.0,0.0,0.0,3611,65436,54165,-11271
15012,0.0,0.0,0.0,3611,65440,54165,-11275
15014,0.0,0.0,0.0,3611,65444,54165,-11279
15015,0.0,0.0,0.0,3611,65448,54165,-11283
15017,0.0,0.0,0.0,3611,65452,54165,-11287
15018,0.0,0.0,0.0,3611,65456,54165,-11291
15019,0.0,0.0,0.0,3611,65460,54165,-11295
15020,0.0,0.0,0.0,3611,65464,54165,-11299
15021,0.0,0.0,0.0,3611,65468,54165,-11303
15023,0.0,0.0,0.0,3611,65472,54165,-11307
15024,0.0,0.0,0.0,3611,65476,54165,-11311
15025,0.0,0.0,0.0,3611,65480,54165,-11315
15026,0.0,0.0,0.0,3611,65484,54165,-11319
15027,0.0,0.0,0.0,3611,65488,54165,-11323
15028,0.0,0.0,0.0,3611,65492,54165,-11327
15029,0.0,0.0,0.0,3611,65496,54165,-11331
15030,0.0,0.0,0.0,3611,65500,54165,-11335
15031,0.0,0.0,0.0,3611,65504,54165,-11339
15032,0.0,0.0,0.0,3611,65508,54165,-11343
15034,0.0,0.0,0.0,3611,65512,54165,-11347
15035,0.0,0.0,0.0,3611,65516,54165,-11351
15038,0.0,0.0,0.0,3611,65520,54165,-11355
15039,0.0,0.0,0.0,3611,65524,54165,-11359
15040,0.0,0.0,0.0,3611,65528,54165,-11363
15041,0.0,0.0,0.0,3611,65532,54165,-11367
15043,0.0,0.0,0.0,3611,65536,54165,-11371
15044,0.0,0.0,0.0,3611,65540,54165,-11375
15046,0.0,0.0,0.0,3611,65544,54165,-11379
15047,0.0,0.0,0.0,3611,65548,54165,-11383
15048,0.0,0.0,0.0,3611,65552,54165,-11387
15049,0.0,0.0,0.0,3611,65556,54165,-11391
15052,0.0,0.0,0.0,3611,65560,54165,-11395
15053,0.0,0.0,0.0,3611,65564,54165,-11399
15055,0.0,0.0,0.0,3611,65568,54165,-11403
15057,0.0,0.0,0.0,3611,65572,54165,-11407
15059,0.0,0.0,0.0,3611,65576,54165,-11411
15060,0.0,0.0,0.0,3611,65580,54165,-11415
15061,0.0,0.0,0.0,3611,65584,54165,-11419
15062,0.0,0.0,0.0,3611,65588,54165,-11423
15063,0.0,0.0,0.0,3611,65592,54165,-11427
15064,0.0,0.0,0.0,3611,65596,54165,-11431
15065,0.0,0.0,0.0,3611,65600,54165,-11435
15066,0.0,0.0,0.0,3611,65604,54165,-11439
15067,0.0,0.0,0.0,3611,65608,54165,-11443
15069,0.0,0.0,0.0,3611,65612,54165,-11447
15071,0.0,0.0,0.0,3611,65616,54165,-11451
15072,0.0,0.0,0.0,3611,65620,54165,-11455
15074,0.0,0.0,0.0,3611,65624,54165,-11459
15075,0.0,0.0,0.0,3611,65628,54165,-11463
15076,0.0,0.0,0.0,3611,65632,54165,-11467
15077,0.0,0.0,0.0,3611,65636,54165,-11471
15078,0.0,0.0,0.0,3611,65640,54165,-11475
15079,0.0,0.0,0.0,3611,65644,54165,-11479
15080,0.0,0.0,0.0,3611,65648,54165,-11483
15081,0.0,0.0,0.0,3611,65652,54165,-11487
15082,0.0,0.0,0.0,3611,65656,54165,-11491
15083,0.0,0.0,0.0,3611,65660,54165,-11495
15084,0.0,0.0,0.0,3611,65664,54165,-11499
15085,0.0,0.0,0.0,3611,65668,54165,-11503
15086,0.0,0.0,0.0,3611,65672,54165,-11507
15087,0.0,0.0,0.0,3611,65676,54165,-11511
15088,0.0,0.0,0.0,3611,65680,54165,-11515
15089,0.0,0.0,0.0,3611,65684,54165,-11519
15093,0.0,0.0,0.0,3611,65688,54165,-11523
15094,0.0,0.0,0.0,3611,65692,54165,-11527
15095,0.0,0.0,0.0,3611,65696,54165,-11531
15096,0.0,0.0,0.0,3611,65700,54165,-11535
15097,0.0,0.0,0.0,3611,65704,54165,-11539
15098,0.0,0.0,0.0,3611,65708,54165,-11543
15100,0.0,0.0,0.0,3611,65712,54165,-11547
15103,0.0,0.0,0.0,3611,65716,54165,-11551
15105,0.0,0.0,0.0,3611,65720,54165,-11555
15106,0.0,0.0,0.0,3611,65724,54165,-11559
15108,0.0,0.0,0.0,3611,65728,54165,-11563
15109,0.0,0.0,0.0,3611,65732,54165,-11567
15110,0.0,0.0,0.0,3611,65736,54165,-11571
15111,0.0,0.0,0.0,3611,65740,54165,-11575
15112,0.0,0.0,0.0,3611,65744,54165,-11579
15114,0.0,0.0,0.0,3611,65748,54165,-11583
15116,0.0,0.0,0.0,3611,65752,54165,-11587
15117,0.0,0.0,0.0,3611,65756,54165,-11591
15119,0.0,0.0,0.0,3611,65760,54165,-11595
15120,0.0,0.0,0.0,3611,65764,54165,-11599
15121,0.0,0.0,0.0,3611,65768,54165,-11603
15122,0.0,0.0,0.0,3611,65772,54165,-11607
15123,0.0,0.0,0.0,3611,65776,54165,-11611
15125,0.0,0.0,0.0,3611,65780,54165,-11615
15126,0.0,0.0,0.0,3611,65784,54165,-11619
15127,0.0,0.0,0.0,3611,65788,54165,-11623
15128,0.0,0.0,0.0,3611,65792,54165,-11627
15129,0.0,0.0,0.0,3611,65796,54165,-11631
15130,0.0,0.0,0.0,3611,65800,54165,-11635
15131,0.0,0.0,0.0,3611,65804,54165,-11639
15132,0.0,0.0,0.0,3611,65808,54165,-11643
15133,0.0,0.0,0.0,3611,65812,54165,-11647
15134,0.0,0.0,0.0,3611,65816,54165,-11651
15135,0.0,0.0,0.0,3611,65820,54165,-11655
15136,0.0,0.0,0.0,3611,65824,54165,-11659
15137,0.0,0.0,0.0,3611,65828,54165,-11663
15139,0.0,0.0,0.0,3611,65832,54165,-11667
15140,0.0,0.0,0.0,3611,65836,54165,-11671
15141,0.0,0.0,0.0,3611,65840,54165,-11675
15142,0.0,0.0,0.0,3611,65844,54165,-11679
15145,0.0,0.0,0.0,3611,65848,54165,-11683
15146,0.0,0.0,0.0,3611,65852,54165,-11687
15147,0.0,0.0,0.0,3611,65856,54165,-11691
15149,0.0,0.0,0.0,3611,65860,54165,-11695
15150,0.0,0.0,0.0,3611,65864,54165,-11699
15151,0.0,0.0,0.0,3611,65868,54165,-11703
15152,0.0,0.0,0.0,3611,65872,54165,-11707
15153,0.0,0.0,0.0,3611,65876,54165,-11711
15154,0.0,0.0,0.0,3611,65880,54165,-11715
15156,0.0,0.0,0.0,3611,65884,54165,-11719
15157,0.0,0.0,0.0,3611,65888,54165,-11723
15159,0.0,0.0,0.0,3611,65892,54165,-11727
15160,0.0,0.0,0.0,3611,65896,54165,-11731
15161,0.0,0.0,0.0,3611,65900,54165,-11735
15164,0.0,0.0,0.0,3611,65904,54165,-11739
15165,0.0,0.0,0.0,3611,65908,54165,-11743
15166,0.0,0.0,0.0,3611,65912,54165,-11747
15167,0.0,0.0,0.0,3611,65916,54165,-11751
15168,0.0,0.0,0.0,3611,65920,54165,-11755
15170,0.0,0.0,0.0,3611,65924,54165,-11759
15171,0.0,0.0,0.0,3611,65928,54165,-11763
15173,0.0,0.0,0.0,3611,65932,54165,-11767
15174,0.0,0.0,0.0,3611,65936,54165,-11771
15177,0.0,0.0,0.0,3611,65940,54165,-11775
15178,0.0,0.0,0.0,3611,65944,54165,-11779
15179,0.0,0.0,0.0,3611,65948,54165,-11783
15180,0.0,0.0,0.0,3611,65952,54165,-11787
15181,0.0,0.0,0.0,3611,65956,54165,-11791
15182,0.0,0.0,0.0,3611,65960,54165,-11795
15183,0.0,0.0,0.0,3611,65964,54165,-11799
15184,0.0,0.0,0.0,3611,65968,54165,-11803
15185,0.0,0.0,0.0,3611,65972,54165,-11807
15186,0.0,0.0,0.0,3611,65976,54165,-11811
15188,0.0,0.0,0.0,3611,65980,54165,-11815
15189,0.0,0.0,0.0,3611,65984,54165,-11819
15191,0.0,0.0,0.0,3611,65988,54165,-11823
15192,0.0,0.0,0.0,3611,65992,54165,-11827
15193,0.0,0.0,0.0,3611,65996,54165,-11831
15194,0.0,0.0,0.0,3611,66000,54165,-11835
15195,0.0,0.0,0.0,3611,66004,54165,-11839
15196,0.0,0.0,0.0,3611,66008,54165,-11843
15197,0.0,0.0,0.0,3611,66012,54165,-11847
15198,0.0,0.0,0.0,3611,66016,54165,-11851
15199,0.0,0.0,0.0,3611,66020,54165,-11855
15201,0.0,0.0,0.0,3611,66024,54165,-11859
15202,0.0,0.0,0.0,3611,66028,54165,-11863
15203,0.0,0.0,0.0,3611,66032,54165,-11867
15205,0.0,0.0,0.0,3611,66036,54165,-11871
15206,0.0,0.0,0.0,3611,66040,54165,-11875
15207,0.0,0.0,0.0,3611,66044,54165,-11879
15208,0.0,0.0,0.0,3611,66048,54165,-11883
15209,0.0,0.0,0.0,3611,66052,54165,-11887
15211,0.0,0.0,0.0,3611,66056,54165,-11891
15212,0.0,0.0,0.0,3611,66060,54165,-11895
15213,0.0,0.0,0.0,3611,66064,54165,-11899
15214,0.0,0.0,0.0,3611,66068,54165,-11903
15215,0.0,0.0,0.0,3611,66072,54165,-11907
15216,0.0,0.0,0.0,3611,66076,54165,-11911
15217,0.0,0.0,0.0,3611,66080,54165,-11915
15218,0.0,0.0,0.0,3611,66084,54165,-11919
15221,0.0,0.0,0.0,3611,66088,54165,-11923
15222,0.0,0.0,0.0,3611,66092,54165,-11927
15224,0.0,0.0,0.0,3611,66096,54165,-11931
15225,0.0,0.0,0.0,3611,66100,54165,-11935
15226,0.0,0.0,0.0,3611,66104,54165,-11939
15227,0.0,0.0,0.0,3611,66108,54165,-11943
15229,0.0,0.0,0.0,3611,66112,54165,-11947
15230,0.0,0.0,0.0,3611,66116,54165,-11951
15232,0.0,0.0,0.0,3611,66120,54165,-11955
15234,0.0,0.0,0.0,3611,66124,54165,-11959
15236,0.0,0.0,0.0,3611,66128,54165,-11963
15237,0.0,0.0,0.0,3611,66132,54165,-11967
15238,0.0,0.0,0.0,3611,66136,54165,-11971
15239,0.0,0.0,0.0,3611,66140,54165,-11975
15241,0.0,0.0,0.0,3611,66144,54165,-11979
15244,0.0,0.0,0.0,3611,66148,54165,-11983
15246,0.0,0.0,0.0,3611,66152,54165,-11987
15247,0.0,0.0,0.0,3611,66156,54165,-11991
15248,0.0,0.0,0.0,3611,66160,54165,-11995
15249,0.0,0.0,0.0,3611,66164,54165,-11999
15251,0.0,0.0,0.0,3611,66168,54165,-12003
15252,0.0,0.0,0.0,3611,66172,54165,-12007
15255,0.0,0.0,0.0,3611,66176,54165,-12011
15256,0.0,0.0,0.0,3611,66180,54165,-12015
15257,0.0,0.0,0.0,3611,66184,54165,-12019
15258,0.0,0.0,0.0,3611,66188,54165,-12023
15259,0.0,0.0,0.0,3611,66192,54165,-12027
15260,0.0,0.0,0.0,3611,66196,54165,-12031
15263,0.0,0.0,0.0,3611,66200,54165,-12035
15265,0.0,0.0,0.0,3611,66204,54165,-12039
15266,0.0,0.0,0.0,3611,66208,54165,-12043
15267,0.0,0.0,0.0,3611,66212,54165,-12047
15268,0.0,0.0,0.0,3611,66216,54165,-12051
15269,0.0,0.0,0.0,3611,66220,54165,-12055
15270,0.0,0.0,0.0,3611,66224,54165,-12059
15271,0.0,0.0,0.0,3611,66228,54165,-12063
15272,0.0,0.0,0.0,3611,66232,54165,-12067
15273,0.0,0.0,0.0,3611,66236,54165,-12071
15274,0.0,0.0,0.0,3611,66240,54165,-12075
15276,0.0,0.0,0.0,3611,66244,54165,-12079
15278,0.0,0.0,0.0,3611,66248,54165,-12083
15279,0.0,0.0,0.0,3611,66252,54165,-12087
15280,0.0,0.0,0.0,3611,66256,54165,-12091
15281,0.0,0.0,0.0,3611,66260,54165,-12095
15282,0.0,0.0,0.0,3611,66264,54165,-12099
15283,0.0,0.0,0.0,3611,66268,54165,-12103
15286,0.0,0.0,0.0,3611,66272,54165,-12107
15287,0.0,0.0,0.0,3611,66276,54165,-12111
15288,0.0,0.0,0.0,3611,66280,54165,-12115
15289,0.0,0.0,0.0,3611,66284,54165,-12119
15290,0.0,0.0,0.0,3611,66288,54165,-12123
15291,0.0,0.0,0.0,3611,66292,54165,-12127
15293,0.0,0.0,0.0,3611,66296,54165,-12131
15294,0.0,0.0,0.0,3611,66300,54165,-12135
15295,0.0,0.0,0.0,3611,66304,54165,-12139
15296,0.0,0.0,0.0,3611,66308,54165,-12143
15297,0.0,0.0,0.0,3611,66312,54165,-12147
15300,0.0,0.0,0.0,3611,66316,54165,-12151
15302,0.0,0.0,0.0,3611,66320,54165,-12155
15304,0.0,0.0,0.0,3611,66324,54165,-12159
15305,0.0,0.0,0.0,3611,66328,54165,-12163
15306,0.0,0.0,0.0,3611,66332,54165,-12167
15307,0.0,0.0,0.0,3611,66336,54165,-12171
15309,0.0,0.0,0.0,3611,66340,54165,-12175
15310,0.0,0.0,0.0,3611,66344,54165,-12179
15311,0.0,0.0,0.0,3611,66348,54165,-12183
15312,0.0,0.0,0.0,3611,66352,54165,-12187
15313,0.0,0.0,0.0,3611,66356,54165,-12191
15314,0.0,0.0,0.0,3611,66360,54165,-12195
15315,0.0,0.0,0.0,3611,66364,54165,-12199
15316,0.0,0.0,0.0,3611,66368,54165,-12203
15318,0.0,0.0,0.0,3611,66372,54165,-12207
15319,0.0,0.0,0.0,3611,66376,54165,-12211
15320,0.0,0.0,0.0,3611,66380,54165,-12215
15321,0.0,0.0,0.0,3611,66384,54165,-12219
15322,0.0,0.0,0.0,3611,66388,54165,-12223
15323,0.0,0.0,0.0,3611,66392,54165,-12227
15324,0.0,0.0,0.0,3611,66396,54165,-12231
15325,0.0,0.0,0.0,3611,66400,54165,-12235
15326,0.0,0.0,0.0,3611,66404,54165,-12239
15327,0.0,0.0,0.0,3611,66408,54165,-12243
15328,0.0,0.0,0.0,3611,66412,54165,-12247
15329,0.0,0.0,0.0,3611,66416,54165,-12251
15330,0.0,0.0,0.0,3611,66420,54165,-12255
15331,0.0,0.0,0.0,3611,66424,54165,-12259
15332,0.0,0.0,0.0,3611,66428,54165,-12263
15334,0.0,0.0,0.0,3611,66432,54165,-12267
15335,0.0,0.0,0.0,3611,66436,54165,-12271
15336,0.0,0.0,0.0,3611,66440,54165,-12275
15337,0.0,0.0,0.0,3611,66444,54165,-12279
15338,0.0,0.0,0.0,3611,66448,54165,-12283
15339,0.0,0.0,0.0,3611,66452,54165,-12287
15340,0.0,0.0,0.0,3611,66456,54165,-12291
15342,0.0,0.0,0.0,3611,66460,54165,-12295
15343,0.0,0.0,0.0,3611,66464,54165,-12299
15344,0.0,0.0,0.0,3611,66468,54165,-12303
15345,0.0,0.0,0.0,3611,66472,54165,-12307
15347,0.0,0.0,0.0,3611,66476,54165,-12311
15348,0.0,0.0,0.0,3611,66480,54165,-12315
15349,0.0,0.0,0.0,3611,66484,54165,-12319
15350,0.0,0.0,0.0,3611,66488,54165,-12323
15351,0.0,0.0,0.0,3611,66492,54165,-12327
15352,0.0,0.0,0.0,3611,66496,54165,-12331
15353,0.0,0.0,0.0,3611,66500,54165,-12335
15354,0.0,0.0,0.0,3611,66504,54165,-12339
15355,0.0,0.0,0.0,3611,66508,54165,-12343
15356,0.0,0.0,0.0,3611,66512,54165,-12347
15357,0.0,0.0,0.0,3611,66516,54165,-12351
15361,0.0,0.0,0.0,3611,66520,54165,-12355
15363,0.0,0.0,0.0,3611,66524,54165,-12359
15364,0.0,0.0,0.0,3611,66528,54165,-12363
15365,0.0,0.0,0.0,3611,66532,54165,-12367
15367,0.0,0.0,0.0,3611,66536,54165,-12371
15368,0.0,0.0,0.0,3611,66540,54165,-12375
15369,0.0,0.0,0.0,3611,66544,54165,-12379
15370,0.0,0.0,0.0,3611,66548,54165,-12383
15371,0.0,0.0,0.0,3611,66552,54165,-12387
15372,0.0,0.0,0.0,3611,66556,54165,-12391
15374,0.0,0.0,0.0,3611,66560,54165,-12395
15375,0.0,0.0,0.0,3611,66564,54165,-12399
15378,0.0,0.0,0.0,3611,66568,54165,-12403
15379,0.0,0.0,0.0,3611,66572,54165,-12407
15380,0.0,0.0,0.0,3611,66576,54165,-12411
15382,0.0,0.0,0.0,3611,66580,54165,-12415
15383,0.0,0.0,0.0,3611,66584,54165,-12419
15384,0.0,0.0,0.0,3611,66588,54165,-12423
15387,0.0,0.0,0.0,3611,66592,54165,-12427
15388,0.0,0.0,0.0,3611,66596,54165,-12431
15389,0.0,0.0,0.0,3611,66600,54165,-12435
15390,0.0,0.0,0.0,3611,66604,54165,-12439
15391,0.0,0.0,0.0,3611,66608,54165,-12443
15392,0.0,0.0,0.0,3611,66612,54165,-12447
15393,0.0,0.0,0.0,3611,66616,54165,-12451
15394,0.0,0.0,0.0,3611,66620,54165,-12455
15395,0.0,0.0,0.0,3611,66624,54165,-12459
15396,0.0,0.0,0.0,3611,66628,54165,-12463
15397,0.0,0.0,0.0,3611,66632,54165,-12467
15398,0.0,0.0,0.0,3611,66636,54165,-12471
15400,0.0,0.0,0.0,3611,66640,54165,-12475
15401,0.0,0.0,0.0,3611,66644,54165,-12479
15402,0.0,0.0,0.0,3611,66648,54165,-12483
15403,0.0,0.0,0.0,3611,66652,54165,-12487
15406,0.0,0.0,0.0,3611,66656,54165,-12491
15407,0.0,0.0,0.0,3611,66660,54165,-12495
15408,0.0,0.0,0.0,3611,66664,54165,-12499
15409,0.0,0.0,0.0,3611,66668,54165,-12503
15410,0.0,0.0,0.0,3611,66672,54165,-12507
15411,0.0,0.0,0.0,3611,66676,54165,-12511
15412,0.0,0.0,0.0,3611,66680,54165,-12515
15414,0.0,0.0,0.0,3611,66684,54165,-12519
15415,0.0,0.0,0.0,3611,66688,54165,-12523
15416,0.0,0.0,0.0,3611,66692,54165,-12527
15417,0.0,0.0,0.0,3611,66696,54165,-12531
15418,0.0,0.0,0.0,3611,66700,54165,-12535
15422,0.0,0.0,0.0,3611,66704,54165,-12539
15424,0.0,0.0,0.0,3611,66708,54165,-12543
15425,0.0,0.0,0.0,3611,66712,54165,-12547
15427,0.0,0.0,0.0,3611,66716,54165,-12551
15429,0.0,0.0,0.0,3611,66720,54165,-12555
15430,0.0,0.0,0.0,3611,66724,54165,-12559
15431,0.0,0.0,0.0,3611,66728,54165,-12563
15432,0.0,0.0,0.0,3611,66732,54165,-12567
15433,0.0,0.0,0.0,3611,66736,54165,-12571
15434,0.0,0.0,0.0,3611,66740,54165,-12575
15436,0.0,0.0,0.0,3611,66744,54165,-12579
15438,0.0,0.0,0.0,3611,66748,54165,-12583
15439,0.0,0.0,0.0,3611,66752,54165,-12587
15440,0.0,0.0,0.0,3611,66756,54165,-12591
15441,0.0,0.0,0.0,3611,66760,54165,-12595
15442,0.0,0.0,0.0,3611,66764,54165,-12599
15446,0.0,0.0,0.0,3611,66768,54165,-12603
15448,0.0,0.0,0.0,3611,66772,54165,-12607
15449,0.0,0.0,0.0,3611,66776,54165,-12611
15450,0.0,0.0,0.0,3611,66780,54165,-12615
15451,0.0,0.0,0.0,3611,66784,54165,-12619
15452,0.0,0.0,0.0,3611,66788,54165,-12623
15453,0.0,0.0,0.0,3611,66792,54165,-12627
15454,0.0,0.0,0.0,3611,66796,54165,-12631
15455,0.0,0.0,0.0,3611,66800,54165,-12635
15456,0.0,0.0,0.0,3611,66804,54165,-12639
15457,0.0,0.0,0.0,3611,66808,54165,-12643
15458,0.0,0.0,0.0,3611,66812,54165,-12647
15460,0.0,0.0,0.0,3611,66816,54165,-12651
15461,0.0,0.0,0.0,3611,66820,54165,-12655
15463,0.0,0.0,0.0,3611,66824,54165,-12659
15464,0.0,0.0,0.0,3611,66828,54165,-12663
15465,0.0,0.0,0.0,3611,66832,54165,-12667
15466,0.0,0.0,0.0,3611,66836,54165,-12671
15467,0.0,0.0,0.0,3611,66840,54165,-12675
15468,0.0,0.0,0.0,3611,66844,54165,-12679
15469,0.0,0.0,0.0,3611,66848,54165,-12683
15470,0.0,0.0,0.0,3611,66852,54165,-12687
15471,0.0,0.0,0.0,3611,66856,54165,-12691
15472,0.0,0.0,0.0,3611,66860,54165,-12695
15473,0.0,0.0,0.0,3611,66864,54165,-12699
15474,0.0,0.0,0.0,3611,66868,54165,-12703
15476,0.0,0.0,0.0,3611,66872,54165,-12707
15477,0.0,0.0,0.0,3611,66876,54165,-12711
15478,0.0,0.0,0.0,3611,66880,54165,-12715
15479,0.0,0.0,0.0,3611,66884,54165,-12719
15480,0.0,0.0,0.0,3611,66888,54165,-12723
15481,0.0,0.0,0.0,3611,66892,54165,-12727
15482,0.0,0.0,0.0,3611,66896,54165,-12731
15483,0.0,0.0,0.0,3611,66900,54165,-12735
15485,0.0,0.0,0.0,3611,66904,54165,-12739
15486,0.0,0.0,0.0,3611,66908,54165,-12743
15487,0.0,0.0,0.0,3611,66912,54165,-12747
15488,0.0,0.0,0.0,3611,66916,54165,-12751
15489,0.0,0.0,0.0,3611,66920,54165,-12755
15490,0.0,0.0,0.0,3611,66924,54165,-12759
15491,0.0,0.0,0.0,3611,66928,54165,-12763
15492,0.0,0.0,0.0,3611,66932,54165,-12767
15493,0.0,0.0,0.0,3611,66936,54165,-12771
15494,0.0,0.0,0.0,3611,66940,54165,-12775
15495,0.0,0.0,0.0,3611,66944,54165,-12779
15497,0.0,0.0,0.0,3611,66948,54165,-12783
15498,0.0,0.0,0.0,3611,66952,54165,-12787
15500,0.0,0.0,0.0,3611,66956,54165,-12791
15501,0.0,0.0,0.0,3611,66960,54165,-12795
15502,0.0,0.0,0.0,3611,66964,54165,-12799
15503,0.0,0.0,0.0,3611,66968,54165,-12803
15504,0.0,0.0,0.0,3611,66972,54165,-12807
15506,0.0,0.0,0.0,3611,66976,54165,-12811
15507,0.0,0.0,0.0,3611,66980,54165,-12815
15508,0.0,0.0,0.0,3611,66984,54165,-12819
15509,0.0,0.0,0.0,3611,66988,54165,-12823
15510,0.0,0.0,0.0,3611,66992,54165,-12827
15511,0.0,0.0,0.0,3611,66996,54165,-12831
15512,0.0,0.0,0.0,3611,67000,54165,-12835
15513,0.0,0.0,0.0,3611,67004,54165,-12839
15514,0.0,0.0,0.0,3611,67008,54165,-12843
15517,0.0,0.0,0.0,3611,67012,54165,-12847
15518,0.0,0.0,0.0,3611,67016,54165,-12851
15519,0.0,0.0,0.0,3611,67020,54165,-12855
15520,0.0,0.0,0.0,3611,67024,54165,-12859
15521,0.0,0.0,0.0,3611,67028,54165,-12863
15523,0.0,0.0,0.0,3611,67032,54165,-12867
15524,0.0,0.0,0.0,3611,67036,54165,-12871
15525,0.0,0.0,0.0,3611,67040,54165,-12875
15526,0.0,0.0,0.0,3611,67044,54165,-12879
15527,0.0,0.0,0.0,3611,67048,54165,-12883
15528,0.0,0.0,0.0,3611,67052,54165,-12887
15529,0.0,0.0,0.0,3611,67056,54165,-12891
15530,0.0,0.0,0.0,3611,67060,54165,-12895
15531,0.0,0.0,0.0,3611,67064,54165,-12899
15532,0.0,0.0,0.0,3611,67068,54165,-12903
15533,0.0,0.0,0.0,3611,67072,54165,-12907
15534,0.0,0.0,0.0,3611,67076,54165,-12911
15535,0.0,0.0,0.0,3611,67080,54165,-12915
15536,0.0,0.0,0.0,3611,67084,54165,-12919
15537,0.0,0.0,0.0,3611,67088,54165,-12923
15539,0.0,0.0,0.0,3611,67092,54165,-12927
15540,0.0,0.0,0.0,3611,67096,54165,-12931
15541,0.0,0.0,0.0,3611,67100,54165,-12935
15542,0.0,0.0,0.0,3611,67104,54165,-12939
15543,0.0,0.0,0.0,3611,67108,54165,-12943
15546,0.0,0.0,0.0,3611,67112,54165,-12947
15548,0.0,0.0,0.0,3611,67116,54165,-12951
15549,0.0,0.0,0.0,3611,67120,54165,-12955
15550,0.0,0.0,0.0,3611,67124,54165,-12959
15551,0.0,0.0,0.0,3611,67128,54165,-12963
15552,0.0,0.0,0.0,3611,67132,54165,-12967
15554,0.0,0.0,0.0,3611,67136,54165,-12971
15555,0.0,0.0,0.0,3611,67140,54165,-12975
15556,0.0,0.0,0.0,3611,67144,54165,-12979
15560,0.0,0.0,0.0,3611,67148,54165,-12983
15562,0.0,0.0,0.0,3611,67152,54165,-12987
15563,0.0,0.0,0.0,3611,67156,54165,-12991
15564,0.0,0.0,0.0,3611,67160,54165,-12995
15565,0.0,0.0,0.0,3611,67164,54165,-12999
15566,0.0,0.0,0.0,3611,67168,54165,-13003
15567,0.0,0.0,0.0,3611,67172,54165,-13007
15569,0.0,0.0,0.0,3611,67176,54165,-13011
15570,0.0,0.0,0.0,3611,67180,54165,-13015
15573,0.0,0.0,0.0,3611,67184,54165,-13019
15574,0.0,0.0,0.0,3611,67188,54165,-13023
15575,0.0,0.0,0.0,3611,67192,54165,-13027
15576,0.0,0.0,0.0,3611,67196,54165,-13031
15577,0.0,0.0,0.0,3611,67200,54165,-13035
15578,0.0,0.0,0.0,3611,67204,54165,-13039
15579,0.0,0.0,0.0,3611,67208,54165,-13043
15580,0.0,0.0,0.0,3611,67212,54165,-13047
15581,0.0,0.0,0.0,3611,67216,54165,-13051
15582,0.0,0.0,0.0,3611,67220,54165,-13055
15583,0.0,0.0,0.0,3611,67224,54165,-13059
15584,0.0,0.0,0.0,3611,67228,54165,-13063
15585,0.0,0.0,0.0,3611,67232,54165,-13067
15586,0.0,0.0,0.0,3611,67236,54165,-13071
15587,0.0,0.0,0.0,3611,67240,54165,-13075
15588,0.0,0.0,0.0,3611,67244,54165,-13079
15590,0.0,0.0,0.0,3611,67248,54165,-13083
15591,0.0,0.0,0.0,3611,67252,54165,-13087
15592,0.0,0.0,0.0,3611,67256,54165,-13091
15593,0.0,0.0,0.0,3611,67260,54165,-13095
15594,0.0,0.0,0.0,3611,67264,54165,-13099
15595,0.0,0.0,0.0,3611,67268,54165,-13103
15597,0.0,0.0,0.0,3611,67272,54165,-13107
15598,0.0,0.0,0.0,3611,67276,54165,-13111
15599,0.0,0.0,0.0,3611,67280,54165,-13115
15600,0.0,0.0,0.0,3611,67284,54165,-13119
15601,0.0,0.0,0.0,3611,67288,54165,-13123
15602,0.0,0.0,0.0,3611,67292,54165,-13127
15603,0.0,0.0,0.0,3611,67296,54165,-13131
15604,0.0,0.0,0.0,3611,67300,54165,-13135
15605,0.0,0.0,0.0,3611,67304,54165,-13139
15606,0.0,0.0,0.0,3611,67308,54165,-13143
15607,0.0,0.0,0.0,3611,67312,54165,-13147
15608,0.0,0.0,0.0,3611,67316,54165,-13151
15610,0.0,0.0,0.0,3611,67320,54165,-13155
15612,0.0,0.0,0.0,3611,67324,54165,-13159
15613,0.0,0.0,0.0,3611,67328,54165,-13163
15615,0.0,0.0,0.0,3611,67332,54165,-13167
15616,0.0,0.0,0.0,3611,67336,54165,-13171
15617,0.0,0.0,0.0,3611,67340,54165,-13175
15618,0.0,0.0,0.0,3611,67344,54165,-13179
15619,0.0,0.0,0.0,3611,67348,54165,-13183
15620,0.0,0.0,0.0,3611,67352,54165,-13187
15622,0.0,0.0,0.0,3611,67356,54165,-13191
15624,0.0,0.0,0.0,3611,67360,54165,-13195
15625,0.0,0.0,0.0,3611,67364,54165,-13199
15626,0.0,0.0,0.0,3611,67368,54165,-13203
15627,0.0,0.0,0.0,3611,67372,54165,-13207
15629,0.0,0.0,0.0,3611,67376,54165,-13211
15630,0.0,0.0,0.0,3611,67380,54165,-13215
15633,0.0,0.0,0.0,3611,67384,54165,-13219
15634,0.0,0.0,0.0,3611,67388,54165,-13223
15636,0.0,0.0,0.0,3611,67392,54165,-13227
15638,0.0,0.0,0.0,3611,67396,54165,-13231
15639,0.0,0.0,0.0,3611,67400,54165,-13235
15643,0.0,0.0,0.0,3611,67404,54165,-13239
15644,0.0,0.0,0.0,3611,67408,54165,-13243
15646,0.0,0.0,0.0,3611,67412,54165,-13247
15647,0.0,0.0,0.0,3611,67416,54165,-13251
15648,0.0,0.0,0.0,3611,67420,54165,-13255
15649,0.0,0.0,0.0,3611,67424,54165,-13259
15650,0.0,0.0,0.0,3611,67428,54165,-13263
15652,0.0,0.0,0.0,3611,67432,54165,-13267
15653,0.0,0.0,0.0,3611,67436,54165,-13271
15654,0.0,0.0,0.0,3611,67440,54165,-13275
15655,0.0,0.0,0.0,3611,67444,54165,-13279
15656,0.0,0.0,0.0,3611,67448,54165,-13283
15657,0.0,0.0,0.0,3611,67452,54165,-13287
15658,0.0,0.0,0.0,3611,67456,54165,-13291
15659,0.0,0.0,0.0,3611,67460,54165,-13295
15660,0.0,0.0,0.0,3611,67464,54165,-13299
15661,0.0,0.0,0.0,3611,67468,54165,-13303
15664,0.0,0.0,0.0,3611,67472,54165,-13307
15665,0.0,0.0,0.0,3611,67476,54165,-13311
15666,0.0,0.0,0.0,3611,67480,54165,-13315
15667,0.0,0.0,0.0,3611,67484,54165,-13319
15668,0.0,0.0,0.0,3611,67488,54165,-13323
15669,0.0,0.0,0.0,3611,67492,54165,-13327
15670,0.0,0.0,0.0,3611,67496,54165,-13331
15671,0.0,0.0,0.0,3611,67500,54165,-13335
15672,0.0,0.0,0.0,3611,67504,54165,-13339
15673,0.0,0.0,0.0,3611,67508,54165,-13343
15674,0.0,0.0,0.0,3611,67512,54165,-13347
15675,0.0,0.0,0.0,3611,67516,54165,-13351
15676,0.0,0.0,0.0,3611,67520,54165,-13355
15677,0.0,0.0,0.0,3611,67524,54165,-13359
15678,0.0,0.0,0.0,3611,67528,54165,-13363
15679,0.0,0.0,0.0,3611,67532,54165,-13367
15680,0.0,0.0,0.0,3611,67536,54165,-13371
15681,0.0,0.0,0.0,3611,67540,54165,-13375
15683,0.0,0.0,0.0,3611,67544,54165,-13379
15684,0.0,0.0,0.0,3611,67548,54165,-13383
15685,0.0,0.0,0.0,3611,67552,54165,-13387
15686,0.0,0.0,0.0,3611,67556,54165,-13391
15687,0.0,0.0,0.0,3611,67560,54165,-13395
15689,0.0,0.0,0.0,3611,67564,54165,-13399
15691,0.0,0.0,0.0,3611,67568,54165,-13403
15692,0.0,0.0,0.0,3611,67572,54165,-13407
15696,0.0,0.0,0.0,3611,67576,54165,-13411
15698,0.0,0.0,0.0,3611,67580,54165,-13415
15699,0.0,0.0,0.0,3611,67584,54165,-13419
15700,0.0,0.0,0.0,3611,67588,54165,-13423
15701,0.0,0.0,0.0,3611,67592,54165,-13427
15702,0.0,0.0,0.0,3611,67596,54165,-13431
15703,0.0,0.0,0.0,3611,67600,54165,-13435
15704,0.0,0.0,0.0,3611,67604,54165,-13439
15705,0.0,0.0,0.0,3611,67608,54165,-13443
15706,0.0,0.0,0.0,3611,67612,54165,-13447
15707,0.0,0.0,0.0,3611,67616,54165,-13451
15708,0.0,0.0,0.0,3611,67620,54165,-13455
15710,0.0,0.0,0.0,3611,67624,54165,-13459
15711,0.0,0.0,0.0,3611,67628,54165,-13463
15713,0.0,0.0,0.0,3611,67632,54165,-13467
15715,0.0,0.0,0.0,3611,67636,54165,-13471
15716,0.0,0.0,0.0,3611,67640,54165,-13475
15717,0.0,0.0,0.0,3611,67644,54165,-13479
15718,0.0,0.0,0.0,3611,67648,54165,-13483
15719,0.0,0.0,0.0,3611,67652,54165,-13487
15722,0.0,0.0,0.0,3611,67656,54165,-13491
15723,0.0,0.0,0.0,3611,67660,54165,-13495
15725,0.0,0.0,0.0,3611,67664,54165,-13499
15726,0.0,0.0,0.0,3611,67668,54165,-13503
15727,0.0,0.0,0.0,3611,67672,54165,-13507
15728,0.0,0.0,0.0,3611,67676,54165,-13511
15729,0.0,0.0,0.0,3611,67680,54165,-13515
15730,0.0,0.0,0.0,3611,67684,54165,-13519
15731,0.0,0.0,0.0,3611,67688,54165,-13523
15732,0.0,0.0,0.0,3611,67692,54165,-13527
15733,0.0,0.0,0.0,3611,67696,54165,-13531
15735,0.0,0.0,0.0,3611,67700,54165,-13535
15737,0.0,0.0,0.0,3611,67704,54165,-13539
15738,0.0,0.0,0.0,3611,67708,54165,-13543
15739,0.0,0.0,0.0,3611,67712,54165,-13547
15742,0.0,0.0,0.0,3611,67716,54165,-13551
15743,0.0,0.0,0.0,3611,67720,54165,-13555
15744,0.0,0.0,0.0,3611,67724,54165,-13559
15745,0.0,0.0,0.0,3611,67728,54165,-13563
15746,0.0,0.0,0.0,3611,67732,54165,-13567
15747,0.0,0.0,0.0,3611,67736,54165,-13571
15748,0.0,0.0,0.0,3611,67740,54165,-13575
15751,0.0,0.0,0.0,3611,67744,54165,-13579
15752,0.0,0.0,0.0,3611,67748,54165,-13583
15754,0.0,0.0,0.0,3611,67752,54165,-13587
15755,0.0,0.0,0.0,3611,67756,54165,-13591
15756,0.0,0.0,0.0,3611,67760,54165,-13595
15758,0.0,0.0,0.0,3611,67764,54165,-13599
15759,0.0,0.0,0.0,3611,67768,54165,-13603
15760,0.0,0.0,0.0,3611,67772,54165,-13607
15761,0.0,0.0,0.0,3611,67776,54165,-13611
15762,0.0,0.0,0.0,3611,67780,54165,-13615
15763,0.0,0.0,0.0,3611,67784,54165,-13619
15766,0.0,0.0,0.0,3611,67788,54165,-13623
15768,0.0,0.0,0.0,3611,67792,54165,-13627
15769,0.0,0.0,0.0,3611,67796,54165,-13631
15770,0.0,0.0,0.0,3611,67800,54165,-13635
15772,0.0,0.0,0.0,3611,67804,54165,-13639
15773,0.0,0.0,0.0,3611,67808,54165,-13643
15775,0.0,0.0,0.0,3611,67812,54165,-13647
15776,0.0,0.0,0.0,3611,67816,54165,-13651
15777,0.0,0.0,0.0,3611,67820,54165,-13655
15780,0.0,0.0,0.0,3611,67824,54165,-13659
15781,0.0,0.0,0.0,3611,67828,54165,-13663
15782,0.0,0.0,0.0,3611,67832,54165,-13667
15783,0.0,0.0,0.0,3611,67836,54165,-13671
15784,0.0,0.0,0.0,3611,67840,54165,-13675
15785,0.0,0.0,0.0,3611,67844,54165,-13679
15786,0.0,0.0,0.0,3611,67848,54165,-13683
15789,0.0,0.0,0.0,3611,67852,54165,-13687
15790,0.0,0.0,0.0,3611,67856,54165,-13691
15791,0.0,0.0,0.0,3611,67860,54165,-13695
15793,0.0,0.0,0.0,3611,67864,54165,-13699
15794,0.0,0.0,0.0,3611,67868,54165,-13703
15795,0.0,0.0,0.0,3611,67872,54165,-13707
15796,0.0,0.0,0.0,3611,67876,54165,-13711
15797,0.0,0.0,0.0,3611,67880,54165,-13715
15799,0.0,0.0,0.0,3611,67884,54165,-13719
15801,0.0,0.0,0.0,3611,67888,54165,-13723
15802,0.0,0.0,0.0,3611,67892,54165,-13727
15803,0.0,0.0,0.0,3611,67896,54165,-13731
15805,0.0,0.0,0.0,3611,67900,54165,-13735
15806,0.0,0.0,0.0,3611,67904,54165,-13739
15807,0.0,0.0,0.0,3611,67908,54165,-13743
15808,0.0,0.0,0.0,3611,67912,54165,-13747
15809,0.0,0.0,0.0,3611,67916,54165,-13751
15810,0.0,0.0,0.0,3611,67920,54165,-13755
15812,0.0,0.0,0.0,3611,67924,54165,-13759
15814,0.0,0.0,0.0,3611,67928,54165,-13763
15815,0.0,0.0,0.0,3611,67932,54165,-13767
15816,0.0,0.0,0.0,3611,67936,54165,-13771
15819,0.0,0.0,0.0,3611,67940,54165,-13775
15820,0.0,0.0,0.0,3611,67944,54165,-13779
15821,0.0,0.0,0.0,3611,67948,54165,-13783
15822,0.0,0.0,0.0,3611,67952,54165,-13787
15823,0.0,0.0,0.0,3611,67956,54165,-13791
15824,0.0,0.0,0.0,3611,67960,54165,-13795
15825,0.0,0.0,0.0,3611,67964,54165,-13799
15826,0.0,0.0,0.0,3611,67968,54165,-13803
15827,0.0,0.0,0.0,3611,67972,54165,-13807
15828,0.0,0.0,0.0,3611,67976,54165,-13811
15829,0.0,0.0,0.0,3611,67980,54165,-13815
15830,0.0,0.0,0.0,3611,67984,54165,-13819
15831,0.0,0.0,0.0,3611,67988,54165,-13823
15832,0.0,0.0,0.0,3611,67992,54165,-13827
15833,0.0,0.0,0.0,3611,67996,54165,-13831
15834,0.0,0.0,0.0,3611,68000,54165,-13835
15837,0.0,0.0,0.0,3611,68004,54165,-13839
15838,0.0,0.0,0.0,3611,68008,54165,-13843
15840,0.0,0.0,0.0,3611,68012,54165,-13847
15841,0.0,0.0,0.0,3611,68016,54165,-13851
15845,0.0,0.0,0.0,3611,68020,54165,-13855
15846,0.0,0.0,0.0,3611,68024,54165,-13859
15848,0.0,0.0,0.0,3611,68028,54165,-13863
15849,0.0,0.0,0.0,3611,68032,54165,-13867
15850,0.0,0.0,0.0,3611,68036,54165,-13871
15851,0.0,0.0,0.0,3611,68040,54165,-13875
15853,0.0,0.0,0.0,3611,68044,54165,-13879
15854,0.0,0.0,0.0,3611,68048,54165,-13883
15857,0.0,0.0,0.0,3611,68052,54165,-13887
15859,0.0,0.0,0.0,3611,68056,54165,-13891
15861,0.0,0.0,0.0,3611,68060,54165,-13895
15862,0.0,0.0,0.0,3611,68064,54165,-13899
15863,0.0,0.0,0.0,3611,68068,54165,-13903
15864,0.0,0.0,0.0,3611,68072,54165,-13907
15865,0.0,0.0,0.0,3611,68076,54165,-13911
15867,0.0,0.0,0.0,3611,68080,54165,-13915
15868,0.0,0.0,0.0,3611,68084,54165,-13919
15869,0.0,0.0,0.0,3611,68088,54165,-13923
15870,0.0,0.0,0.0,3611,68092,54165,-13927
15871,0.0,0.0,0.0,3611,68096,54165,-13931
15872,0.0,0.0,0.0,3611,68100,54165,-13935
15873,0.0,0.0,0.0,3611,68104,54165,-13939
15874,0.0,0.0,0.0,3611,68108,54165,-13943
15877,0.0,0.0,0.0,3611,68112,54165,-13947
15878,0.0,0.0,0.0,3611,68116,54165,-13951
15879,0.0,0.0,0.0,3611,68120,54165,-13955
15880,0.0,0.0,0.0,3611,68124,54165,-13959
15881,0.0,0.0,0.0,3611,68128,54165,-13963
15882,0.0,0.0,0.0,3611,68132,54165,-13967
15884,0.0,0.0,0.0,3611,68136,54165,-13971
15885,0.0,0.0,0.0,3611,68140,54165,-13975
15886,0.0,0.0,0.0,3611,68144,54165,-13979
15887,0.0,0.0,0.0,3611,68148,54165,-13983
15888,0.0,0.0,0.0,3611,68152,54165,-13987
15889,0.0,0.0,0.0,3611,68156,54165,-13991
15890,0.0,0.0,0.0,3611,68160,54165,-13995
15891,0.0,0.0,0.0,3611,68164,54165,-13999
15892,0.0,0.0,0.0,3611,68168,54165,-14003
15893,0.0,0.0,0.0,3611,68172,54165,-14007
15894,0.0,0.0,0.0,3611,68176,54165,-14011
15895,0.0,0.0,0.0,3611,68180,54165,-14015
15896,0.0,0.0,0.0,3611,68184,54165,-14019
15897,0.0,0.0,0.0,3611,68188,54165,-14023
15898,0.0,0.0,0.0,3611,68192,54165,-14027
15900,0.0,0.0,0.0,3611,68196,54165,-14031
15902,0.0,0.0,0.0,3611,68200,54165,-14035
15903,0.0,0.0,0.0,3611,68204,54165,-14039
15904,0.0,0.0,0.0,3611,68208,54165,-14043
15905,0.0,0.0,0.0,3611,68212,54165,-14047
15906,0.0,0.0,0.0,3611,68216,54165,-14051
15907,0.0,0.0,0.0,3611,68220,54165,-14055
15909,0.0,0.0,0.0,3611,68224,54165,-14059
15910,0.0,0.0,0.0,3611,68228,54165,-14063
15912,0.0,0.0,0.0,3611,68232,54165,-14067
15913,0.0,0.0,0.0,3611,68236,54165,-14071
15914,0.0,0.0,0.0,3611,68240,54165,-14075
15915,0.0,0.0,0.0,3611,68244,54165,-14079
15916,0.0,0.0,0.0,3611,68248,54165,-14083
15917,0.0,0.0,0.0,3611,68252,54165,-14087
15918,0.0,0.0,0.0,3611,68256,54165,-14091
15919,0.0,0.0,0.0,3611,68260,54165,-14095
15921,0.0,0.0,0.0,3611,68264,54165,-14099
15922,0.0,0.0,0.0,3611,68268,54165,-14103
15923,0.0,0.0,0.0,3611,68272,54165,-14107
15924,0.0,0.0,0.0,3611,68276,54165,-14111
15925,0.0,0.0,0.0,3611,68280,54165,-14115
15926,0.0,0.0,0.0,3611,68284,54165,-14119
15927,0.0,0.0,0.0,3611,68288,54165,-14123
15928,0.0,0.0,0.0,3611,68292,54165,-14127
15929,0.0,0.0,0.0,3611,68296,54165,-14131
15931,0.0,0.0,0.0,3611,68300,54165,-14135
15932,0.0,0.0,0.0,3611,68304,54165,-14139
15933,0.0,0.0,0.0,3611,68308,54165,-14143
15934,0.0,0.0,0.0,3611,68312,54165,-14147
15935,0.0,0.0,0.0,3611,68316,54165,-14151
15936,0.0,0.0,0.0,3611,68320,54165,-14155
15937,0.0,0.0,0.0,3611,68324,54165,-14159
15938,0.0,0.0,0.0,3611,68328,54165,-14163
15939,0.0,0.0,0.0,3611,68332,54165,-14167
15940,0.0,0.0,0.0,3611,68336,54165,-14171
15941,0.0,0.0,0.0,3611,68340,54165,-14175
15942,0.0,0.0,0.0,3611,68344,54165,-14179
15943,0.0,0.0,0.0,3611,68348,54165,-14183
15945,0.0,0.0,0.0,3611,68352,54165,-14187
15946,0.0,0.0,0.0,3611,68356,54165,-14191
15948,0.0,0.0,0.0,3611,68360,54165,-14195
15949,0.0,0.0,0.0,3611,68364,54165,-14199
15950,0.0,0.0,0.0,3611,68368,54165,-14203
15951,0.0,0.0,0.0,3611,68372,54165,-14207
15953,0.0,0.0,0.0,3611,68376,54165,-14211
15954,0.0,0.0,0.0,3611,68380,54165,-14215
15955,0.0,0.0,0.0,3611,68384,54165,-14219
15956,0.0,0.0,0.0,3611,68388,54165,-14223
15963,0.0,0.0,0.0,3611,68392,54165,-14227
15964,0.0,0.0,0.0,3611,68396,54165,-14231
15965,0.0,0.0,0.0,3611,68400,54165,-14235
15966,0.0,0.0,0.0,3611,68404,54165,-14239
15968,0.0,0.0,0.0,3611,68408,54165,-14243
15970,0.0,0.0,0.0,3611,68412,54165,-14247
15971,0.0,0.0,0.0,3611,68416,54165,-14251
15972,0.0,0.0,0.0,3611,68420,54165,-14255
15973,0.0,0.0,0.0,3611,68424,54165,-14259
15974,0.0,0.0,0.0,3611,68428,54165,-14263
15975,0.0,0.0,0.0,3611,68432,54165,-14267
15976,0.0,0.0,0.0,3611,68436,54165,-14271
15977,0.0,0.0,0.0,3611,68440,54165,-14275
15978,0.0,0.0,0.0,3611,68444,54165,-14279
15980,0.0,0.0,0.0,3611,68448,54165,-14283
15981,0.0,0.0,0.0,3611,68452,54165,-14287
15982,0.0,0.0,0.0,3611,68456,54165,-14291
15983,0.0,0.0,0.0,3611,68460,54165,-14295
15985,0.0,0.0,0.0,3611,68464,54165,-14299
15986,0.0,0.0,0.0,3611,68468,54165,-14303
15987,0.0,0.0,0.0,3611,68472,54165,-14307
15988,0.0,0.0,0.0,3611,68476,54165,-14311
15989,0.0,0.0,0.0,3611,68480,54165,-14315
15990,0.0,0.0,0.0,3611,68484,54165,-14319
15991,0.0,0.0,0.0,3611,68488,54165,-14323
15994,0.0,0.0,0.0,3611,68492,54165,-14327
15996,0.0,0.0,0.0,3611,68496,54165,-14331
15998,0.0,0.0,0.0,3611,68500,54165,-14335
15999,0.0,0.0,0.0,3611,68504,54165,-14339
16000,0.0,0.0,0.0,3611,68508,54165,-14343
16001,0.0,0.0,0.0,3611,68512,54165,-14347
16002,0.0,0.0,0.0,3611,68516,54165,-14351
16003,0.0,0.0,0.0,3611,68520,54165,-14355
16004,0.0,0.0,0.0,3611,68524,54165,-14359
16005,0.0,0.0,0.0,3611,68528,54165,-14363
16006,0.0,0.0,0.0,3611,68532,54165,-14367
16007,0.0,0.0,0.0,3611,68536,54165,-14371
16008,0.0,0.0,0.0,3611,68540,54165,-14375
16010,0.0,0.0,0.0,3611,68544,54165,-14379
16011,0.0,0.0,0.0,3611,68548,54165,-14383
16013,0.0,0.0,0.0,3611,68552,54165,-14387
16014,0.0,0.0,0.0,3611,68556,54165,-14391
16016,0.0,0.0,0.0,3611,68560,54165,-14395
16017,0.0,0.0,0.0,3611,68564,54165,-14399
16020,0.0,0.0,0.0,3611,68568,54165,-14403
16022,0.0,0.0,0.0,3611,68572,54165,-14407
16023,0.0,0.0,0.0,3611,68576,54165,-14411
16024,0.0,0.0,0.0,3611,68580,54165,-14415
16025,0.0,0.0,0.0,3611,68584,54165,-14419
16026,0.0,0.0,0.0,3611,68588,54165,-14423
16027,0.0,0.0,0.0,3611,68592,54165,-14427
16029,0.0,0.0,0.0,3611,68596,54165,-14431
16030,0.0,0.0,0.0,3611,68600,54165,-14435
16031,0.0,0.0,0.0,3611,68604,54165,-14439
16033,0.0,0.0,0.0,3611,68608,54165,-14443
16034,0.0,0.0,0.0,3611,68612,54165,-14447
16036,0.0,0.0,0.0,3611,68616,54165,-14451
16037,0.0,0.0,0.0,3611,68620,54165,-14455
16040,0.0,0.0,0.0,3611,68624,54165,-14459
16041,0.0,0.0,0.0,3611,68628,54165,-14463
16042,0.0,0.0,0.0,3611,68632,54165,-14467
16043,0.0,0.0,0.0,3611,68636,54165,-14471
16044,0.0,0.0,0.0,3611,68640,54165,-14475
16045,0.0,0.0,0.0,3611,68644,54165,-14479
16046,0.0,0.0,0.0,3611,68648,54165,-14483
16047,0.0,0.0,0.0,3611,68652,54165,-14487
16048,0.0,0.0,0.0,3611,68656,54165,-14491
16049,0.0,0.0,0.0,3611,68660,54165,-14495
16050,0.0,0.0,0.0,3611,68664,54165,-14499
16052,0.0,0.0,0.0,3611,68668,54165,-14503
16053,0.0,0.0,0.0,3611,68672,54165,-14507
16054,0.0,0.0,0.0,3611,68676,54165,-14511
16057,0.0,0.0,0.0,3611,68680,54165,-14515
16058,0.0,0.0,0.0,3611,68684,54165,-14519
16059,0.0,0.0,0.0,3611,68688,54165,-14523
16060,0.0,0.0,0.0,3611,68692,54165,-14527
16062,0.0,0.0,0.0,3611,68696,54165,-14531
16064,0.0,0.0,0.0,3611,68700,54165,-14535
16065,0.0,0.0,0.0,3611,68704,54165,-14539
16067,0.0,0.0,0.0,3611,68708,54165,-14543
16069,0.0,0.0,0.0,3611,68712,54165,-14547
16070,0.0,0.0,0.0,3611,68716,54165,-14551
16071,0.0,0.0,0.0,3611,68720,54165,-14555
16073,0.0,0.0,0.0,3611,68724,54165,-14559
16074,0.0,0.0,0.0,3611,68728,54165,-14563
16075,0.0,0.0,0.0,3611,68732,54165,-14567
16077,0.0,0.0,0.0,3611,68736,54165,-14571
16078,0.0,0.0,0.0,3611,68740,54165,-14575
16079,0.0,0.0,0.0,3611,68744,54165,-14579
16080,0.0,0.0,0.0,3611,68748,54165,-14583
16082,0.0,0.0,0.0,3611,68752,54165,-14587
16083,0.0,0.0,0.0,3611,68756,54165,-14591
16084,0.0,0.0,0.0,3611,68760,54165,-14595
16086,0.0,0.0,0.0,3611,68764,54165,-14599
16087,0.0,0.0,0.0,3611,68768,54165,-14603
16089,0.0,0.0,0.0,3611,68772,54165,-14607
16090,0.0,0.0,0.0,3611,68776,54165,-14611
16093,0.0,0.0,0.0,3611,68780,54165,-14615
16094,0.0,0.0,0.0,3611,68784,54165,-14619
16095,0.0,0.0,0.0,3611,68788,54165,-14623
16096,0.0,0.0,0.0,3611,68792,54165,-14627
16097,0.0,0.0,0.0,3611,68796,54165,-14631
16098,0.0,0.0,0.0,3611,68800,54165,-14635
16099,0.0,0.0,0.0,3611,68804,54165,-14639
16100,0.0,0.0,0.0,3611,68808,54165,-14643
16101,0.0,0.0,0.0,3611,68812,54165,-14647
16103,0.0,0.0,0.0,3611,68816,54165,-14651
16104,0.0,0.0,0.0,3611,68820,54165,-14655
16106,0.0,0.0,0.0,3611,68824,54165,-14659
16108,0.0,0.0,0.0,3611,68828,54165,-14663
16109,0.0,0.0,0.0,3611,68832,54165,-14667
16110,0.0,0.0,0.0,3611,68836,54165,-14671
16112,0.0,0.0,0.0,3611,68840,54165,-14675
16115,0.0,0.0,0.0,3611,68844,54165,-14679
16117,0.0,0.0,0.0,3611,68848,54165,-14683
16119,0.0,0.0,0.0,3611,68852,54165,-14687
16120,0.0,0.0,0.0,3611,68856,54165,-14691
16121,0.0,0.0,0.0,3611,68860,54165,-14695
16122,0.0,0.0,0.0,3611,68864,54165,-14699
16123,0.0,0.0,0.0,3611,68868,54165,-14703
16124,0.0,0.0,0.0,3611,68872,54165,-14707
16126,0.0,0.0,0.0,3611,68876,54165,-14711
16127,0.0,0.0,0.0,3611,68880,54165,-14715
16128,0.0,0.0,0.0,3611,68884,54165,-14719
16131,0.0,0.0,0.0,3611,68888,54165,-14723
16137,0.0,0.0,0.0,3611,68892,54165,-14727
16141,0.0,0.0,0.0,3611,68896,54165,-14731
16142,0.0,0.0,0.0,3611,68900,54165,-14735
16145,0.0,0.0,0.0,3611,68904,54165,-14739
16146,0.0,0.0,0.0,3611,68908,54165,-14743
16147,0.0,0.0,0.0,3611,68912,54165,-14747
16148,0.0,0.0,0.0,3611,68916,54165,-14751
16149,0.0,0.0,0.0,3611,68920,54165,-14755
16150,0.0,0.0,0.0,3611,68924,54165,-14759
16151,0.0,0.0,0.0,3611,68928,54165,-14763
16153,0.0,0.0,0.0,3611,68932,54165,-14767
16154,0.0,0.0,0.0,3611,68936,54165,-14771
16156,0.0,0.0,0.0,3611,68940,54165,-14775
16157,0.0,0.0,0.0,3611,68944,54165,-14779
16158,0.0,0.0,0.0,3611,68948,54165,-14783
16159,0.0,0.0,0.0,3611,68952,54165,-14787
16160,0.0,0.0,0.0,3611,68956,54165,-14791
16161,0.0,0.0,0.0,3611,68960,54165,-14795
16163,0.0,0.0,0.0,3611,68964,54165,-14799
16164,0.0,0.0,0.0,3611,68968,54165,-14803
16167,0.0,0.0,0.0,3611,68972,54165,-14807
16169,0.0,0.0,0.0,3611,68976,54165,-14811
16170,0.0,0.0,0.0,3611,68980,54165,-14815
16171,0.0,0.0,0.0,3611,68984,54165,-14819
16172,0.0,0.0,0.0,3611,68988,54165,-14823
16173,0.0,0.0,0.0,3611,68992,54165,-14827
16174,0.0,0.0,0.0,3611,68996,54165,-14831
16176,0.0,0.0,0.0,3611,69000,54165,-14835
16178,0.0,0.0,0.0,3611,69004,54165,-14839
16180,0.0,0.0,0.0,3611,69008,54165,-14843
16181,0.0,0.0,0.0,3611,69012,54165,-14847
16182,0.0,0.0,0.0,3611,69016,54165,-14851
16183,0.0,0.0,0.0,3611,69020,54165,-14855
16184,0.0,0.0,0.0,3611,69024,54165,-14859
16185,0.0,0.0,0.0,3611,69028,54165,-14863
16186,0.0,0.0,0.0,3611,69032,54165,-14867
16187,0.0,0.0,0.0,3611,69036,54165,-14871
16188,0.0,0.0,0.0,3611,69040,54165,-14875
16189,0.0,0.0,0.0,3611,69044,54165,-14879
16193,0.0,0.0,0.0,3611,69048,54165,-14883
16194,0.0,0.0,0.0,3611,69052,54165,-14887
16195,0.0,0.0,0.0,3611,69056,54165,-14891
16196,0.0,0.0,0.0,3611,69060,54165,-14895
16197,0.0,0.0,0.0,3611,69064,54165,-14899
16198,0.0,0.0,0.0,3611,69068,54165,-14903
16199,0.0,0.0,0.0,3611,69072,54165,-14907
16200,0.0,0.0,0.0,3611,69076,54165,-14911
16201,0.0,0.0,0.0,3611,69080,54165,-14915
16202,0.0,0.0,0.0,3611,69084,54165,-14919
16203,0.0,0.0,0.0,3611,69088,54165,-14923
16204,0.0,0.0,0.0,3611,69092,54165,-14927
16205,0.0,0.0,0.0,3611,69096,54165,-14931
16206,0.0,0.0,0.0,3611,69100,54165,-14935
16207,0.0,0.0,0.0,3611,69104,54165,-14939
16208,0.0,0.0,0.0,3611,69108,54165,-14943
16209,0.0,0.0,0.0,3611,69112,54165,-14947
16210,0.0,0.0,0.0,3611,69116,54165,-14951
16211,0.0,0.0,0.0,3611,69120,54165,-14955
16212,0.0,0.0,0.0,3611,69124,54165,-14959
16214,0.0,0.0,0.0,3611,69128,54165,-14963
16216,0.0,0.0,0.0,3611,69132,54165,-14967
16218,0.0,0.0,0.0,3611,69136,54165,-14971
16219,0.0,0.0,0.0,3611,69140,54165,-14975
16220,0.0,0.0,0.0,3611,69144,54165,-14979
16222,0.0,0.0,0.0,3611,69148,54165,-14983
16224,0.0,0.0,0.0,3611,69152,54165,-14987
16225,0.0,0.0,0.0,3611,69156,54165,-14991
16226,0.0,0.0,0.0,3611,69160,54165,-14995
16227,0.0,0.0,0.0,3611,69164,54165,-14999
16228,0.0,0.0,0.0,3611,69168,54165,-15003
16231,0.0,0.0,0.0,3611,69172,54165,-15007
16232,0.0,0.0,0.0,3611,69176,54165,-15011
16233,0.0,0.0,0.0,3611,69180,54165,-15015
16235,0.0,0.0,0.0,3611,69184,54165,-15019
16238,0.0,0.0,0.0,3611,69188,54165,-15023
16239,0.0,0.0,0.0,3611,69192,54165,-15027
16240,0.0,0.0,0.0,3611,69196,54165,-15031
16241,0.0,0.0,0.0,3611,69200,54165,-15035
16245,0.0,0.0,0.0,3611,69204,54165,-15039
16249,0.0,0.0,0.0,3611,69208,54165,-15043
16250,0.0,0.0,0.0,3611,69212,54165,-15047
16251,0.0,0.0,0.0,3611,69216,54165,-15051
16253,0.0,0.0,0.0,3611,69220,54165,-15055
16254,0.0,0.0,0.0,3611,69224,54165,-15059
16256,0.0,0.0,0.0,3611,69228,54165,-15063
16257,0.0,0.0,0.0,3611,69232,54165,-15067
16259,0.0,0.0,0.0,3611,69236,54165,-15071
16261,0.0,0.0,0.0,3611,69240,54165,-15075
16262,0.0,0.0,0.0,3611,69244,54165,-15079
16263,0.0,0.0,0.0,3611,69248,54165,-15083
16264,0.0,0.0,0.0,3611,69252,54165,-15087
16266,0.0,0.0,0.0,3611,69256,54165,-15091
16268,0.0,0.0,0.0,3611,69260,54165,-15095
16269,0.0,0.0,0.0,3611,69264,54165,-15099
16270,0.0,0.0,0.0,3611,69268,54165,-15103
16274,0.0,0.0,0.0,3611,69272,54165,-15107
16276,0.0,0.0,0.0,3611,69276,54165,-15111
16277,0.0,0.0,0.0,3611,69280,54165,-15115
16278,0.0,0.0,0.0,3611,69284,54165,-15119
16279,0.0,0.0,0.0,3611,69288,54165,-15123
16281,0.0,0.0,0.0,3611,69292,54165,-15127
16282,0.0,0.0,0.0,3611,69296,54165,-15131
16283,0.0,0.0,0.0,3611,69300,54165,-15135
16285,0.0,0.0,0.0,3611,69304,54165,-15139
16287,0.0,0.0,0.0,3611,69308,54165,-15143
16288,0.0,0.0,0.0,3611,69312,54165,-15147
16289,0.0,0.0,0.0,3611,69316,54165,-15151
16290,0.0,0.0,0.0,3611,69320,54165,-15155
16291,0.0,0.0,0.0,3611,69324,54165,-15159
16292,0.0,0.0,0.0,3611,69328,54165,-15163
16293,0.0,0.0,0.0,3611,69332,54165,-15167
16294,0.0,0.0,0.0,3611,69336,54165,-15171
16295,0.0,0.0,0.0,3611,69340,54165,-15175
16297,0.0,0.0,0.0,3611,69344,54165,-15179
16298,0.0,0.0,0.0,3611,69348,54165,-15183
16299,0.0,0.0,0.0,3611,69352,54165,-15187
16300,0.0,0.0,0.0,3611,69356,54165,-15191
16302,0.0,0.0,0.0,3611,69360,54165,-15195
16304,0.0,0.0,0.0,3611,69364,54165,-15199
16306,0.0,0.0,0.0,3611,69368,54165,-15203
16307,0.0,0.0,0.0,3611,69372,54165,-15207
16310,0.0,0.0,0.0,3611,69376,54165,-15211
16312,0.0,0.0,0.0,3611,69380,54165,-15215
16314,0.0,0.0,0.0,3611,69384,54165,-15219
16315,0.0,0.0,0.0,3611,69388,54165,-15223
16316,0.0,0.0,0.0,3611,69392,54165,-15227
16318,0.0,0.0,0.0,3611,69396,54165,-15231
16319,0.0,0.0,0.0,3611,69400,54165,-15235
16320,0.0,0.0,0.0,3611,69404,54165,-15239
16321,0.0,0.0,0.0,3611,69408,54165,-15243
16322,0.0,0.0,0.0,3611,69412,54165,-15247
16323,0.0,0.0,0.0,3611,69416,54165,-15251
16324,0.0,0.0,0.0,3611,69420,54165,-15255
16326,0.0,0.0,0.0,3611,69424,54165,-15259
16327,0.0,0.0,0.0,3611,69428,54165,-15263
16329,0.0,0.0,0.0,3611,69432,54165,-15267
16330,0.0,0.0,0.0,3611,69436,54165,-15271
16331,0.0,0.0,0.0,3611,69440,54165,-15275
16332,0.0,0.0,0.0,3611,69444,54165,-15279
16333,0.0,0.0,0.0,3611,69448,54165,-15283
16334,0.0,0.0,0.0,3611,69452,54165,-15287
16335,0.0,0.0,0.0,3611,69456,54165,-15291
16336,0.0,0.0,0.0,3611,69460,54165,-15295
16337,0.0,0.0,0.0,3611,69464,54165,-15299
16339,0.0,0.0,0.0,3611,69468,54165,-15303
16340,0.0,0.0,0.0,3611,69472,54165,-15307
16341,0.0,0.0,0.0,3611,69476,54165,-15311
16343,0.0,0.0,0.0,3611,69480,54165,-15315
16344,0.0,0.0,0.0,3611,69484,54165,-15319
16345,0.0,0.0,0.0,3611,69488,54165,-15323
16346,0.0,0.0,0.0,3611,69492,54165,-15327
16347,0.0,0.0,0.0,3611,69496,54165,-15331
16348,0.0,0.0,0.0,3611,69500,54165,-15335
16349,0.0,0.0,0.0,3611,69504,54165,-15339
16350,0.0,0.0,0.0,3611,69508,54165,-15343
16351,0.0,0.0,0.0,3611,69512,54165,-15347
16352,0.0,0.0,0.0,3611,69516,54165,-15351
16353,0.0,0.0,0.0,3611,69520,54165,-15355
16354,0.0,0.0,0.0,3611,69524,54165,-15359
16355,0.0,0.0,0.0,3611,69528,54165,-15363
16356,0.0,0.0,0.0,3611,69532,54165,-15367
16357,0.0,0.0,0.0,3611,69536,54165,-15371
16358,0.0,0.0,0.0,3611,69540,54165,-15375
16359,0.0,0.0,0.0,3611,69544,54165,-15379
16361,0.0,0.0,0.0,3611,69548,54165,-15383
16362,0.0,0.0,0.0,3611,69552,54165,-15387
16363,0.0,0.0,0.0,3611,69556,54165,-15391
16364,0.0,0.0,0.0,3611,69560,54165,-15395
16365,0.0,0.0,0.0,3611,69564,54165,-15399
16366,0.0,0.0,0.0,3611,69568,54165,-15403
16367,0.0,0.0,0.0,3611,69572,54165,-15407
16368,0.0,0.0,0.0,3611,69576,54165,-15411
16369,0.0,0.0,0.0,3611,69580,54165,-15415
16372,0.0,0.0,0.0,3611,69584,54165,-15419
16373,0.0,0.0,0.0,3611,69588,54165,-15423
16375,0.0,0.0,0.0,3611,69592,54165,-15427
16376,0.0,0.0,0.0,3611,69596,54165,-15431
16378,0.0,0.0,0.0,3611,69600,54165,-15435
16379,0.0,0.0,0.0,3611,69604,54165,-15439
16380,0.0,0.0,0.0,3611,69608,54165,-15443
16381,0.0,0.0,0.0,3611,69612,54165,-15447
16382,0.0,0.0,0.0,3611,69616,54165,-15451
16383,0.0,0.0,0.0,3611,69620,54165,-15455
16385,0.0,0.0,0.0,3611,69624,54165,-15459
16386,0.0,0.0,0.0,3611,69628,54165,-15463
16387,0.0,0.0,0.0,3611,69632,54165,-15467
16388,0.0,0.0,0.0,3611,69636,54165,-15471
16389,0.0,0.0,0.0,3611,69640,54165,-15475
16390,0.0,0.0,0.0,3611,69644,54165,-15479
16391,0.0,0.0,0.0,3611,69648,54165,-15483
16392,0.0,0.0,0.0,3611,69652,54165,-15487
16393,0.0,0.0,0.0,3611,69656,54165,-15491
16397,0.0,0.0,0.0,3611,69660,54165,-15495
16398,0.0,0.0,0.0,3611,69664,54165,-15499
16399,0.0,0.0,0.0,3611,69668,54165,-15503
16401,0.0,0.0,0.0,3611,69672,54165,-15507
16402,0.0,0.0,0.0,3611,69676,54165,-15511
16403,0.0,0.0,0.0,3611,69680,54165,-15515
16404,0.0,0.0,0.0,3611,69684,54165,-15519
16405,0.0,0.0,0.0,3611,69688,54165,-15523
16406,0.0,0.0,0.0,3611,69692,54165,-15527
16407,0.0,0.0,0.0,3611,69696,54165,-15531
16408,0.0,0.0,0.0,3611,69700,54165,-15535
16409,0.0,0.0,0.0,3611,69704,54165,-15539
16411,0.0,0.0,0.0,3611,69708,54165,-15543
16412,0.0,0.0,0.0,3611,69712,54165,-15547
16413,0.0,0.0,0.0,3611,69716,54165,-15551
16414,0.0,0.0,0.0,3611,69720,54165,-15555
16418,0.0,0.0,0.0,3611,69724,54165,-15559
16419,0.0,0.0,0.0,3611,69728,54165,-15563
16421,0.0,0.0,0.0,3611,69732,54165,-15567
16422,0.0,0.0,0.0,3611,69736,54165,-15571
16423,0.0,0.0,0.0,3611,69740,54165,-15575
16427,0.0,0.0,0.0,3611,69744,54165,-15579
16428,0.0,0.0,0.0,3611,69748,54165,-15583
16429,0.0,0.0,0.0,3611,69752,54165,-15587
16433,0.0,0.0,0.0,3611,69756,54165,-15591
16434,0.0,0.0,0.0,3611,69760,54165,-15595
16435,0.0,0.0,0.0,3611,69764,54165,-15599
16436,0.0,0.0,0.0,3611,69768,54165,-15603
16437,0.0,0.0,0.0,3611,69772,54165,-15607
16439,0.0,0.0,0.0,3611,69776,54165,-15611
16440,0.0,0.0,0.0,3611,69780,54165,-15615
16442,0.0,0.0,0.0,3611,69784,54165,-15619
16443,0.0,0.0,0.0,3611,69788,54165,-15623
16444,0.0,0.0,0.0,3611,69792,54165,-15627
16449,0.0,0.0,0.0,3611,69796,54165,-15631
16450,0.0,0.0,0.0,3611,69800,54165,-15635
16451,0.0,0.0,0.0,3611,69804,54165,-15639
16453,0.0,0.0,0.0,3611,69808,54165,-15643
16454,0.0,0.0,0.0,3611,69812,54165,-15647
16455,0.0,0.0,0.0,3611,69816,54165,-15651
16457,0.0,0.0,0.0,3611,69820,54165,-15655
16458,0.0,0.0,0.0,3611,69824,54165,-15659
16460,0.0,0.0,0.0,3611,69828,54165,-15663
16461,0.0,0.0,0.0,3611,69832,54165,-15667
16463,0.0,0.0,0.0,3611,69836,54165,-15671
16465,0.0,0.0,0.0,3611,69840,54165,-15675
16467,0.0,0.0,0.0,3611,69844,54165,-15679
16468,0.0,0.0,0.0,3611,69848,54165,-15683
16470,0.0,0.0,0.0,3611,69852,54165,-15687
16471,0.0,0.0,0.0,3611,69856,54165,-15691
16472,0.0,0.0,0.0,3611,69860,54165,-15695
16474,0.0,0.0,0.0,3611,69864,54165,-15699
16476,0.0,0.0,0.0,3611,69868,54165,-15703
16477,0.0,0.0,0.0,3611,69872,54165,-15707
16478,0.0,0.0,0.0,3611,69876,54165,-15711
16479,0.0,0.0,0.0,3611,69880,54165,-15715
16480,0.0,0.0,0.0,3611,69884,54165,-15719
16481,0.0,0.0,0.0,3611,69888,54165,-15723
16482,0.0,0.0,0.0,3611,69892,54165,-15727
16484,0.0,0.0,0.0,3611,69896,54165,-15731
16488,0.0,0.0,0.0,3611,69900,54165,-15735
16489,0.0,0.0,0.0,3611,69904,54165,-15739
16490,0.0,0.0,0.0,3611,69908,54165,-15743
16491,0.0,0.0,0.0,3611,69912,54165,-15747
16494,0.0,0.0,0.0,3611,69916,54165,-15751
16496,0.0,0.0,0.0,3611,69920,54165,-15755
16498,0.0,0.0,0.0,3611,69924,54165,-15759
16500,0.0,0.0,0.0,3611,69928,54165,-15763
16501,0.0,0.0,0.0,3611,69932,54165,-15767
16502,0.0,0.0,0.0,3611,69936,54165,-15771
16503,0.0,0.0,0.0,3611,69940,54165,-15775
16504,0.0,0.0,0.0,3611,69944,54165,-15779
16507,0.0,0.0,0.0,3611,69948,54165,-15783
16508,0.0,0.0,0.0,3611,69952,54165,-15787
16511,0.0,0.0,0.0,3611,69956,54165,-15791
16512,0.0,0.0,0.0,3611,69960,54165,-15795
16513,0.0,0.0,0.0,3611,69964,54165,-15799
16514,0.0,0.0,0.0,3611,69968,54165,-15803
16516,0.0,0.0,0.0,3611,69972,54165,-15807
16517,0.0,0.0,0.0,3611,69976,54165,-15811
16518,0.0,0.0,0.0,3611,69980,54165,-15815
16519,0.0,0.0,0.0,3611,69984,54165,-15819
16522,0.0,0.0,0.0,3611,69988,54165,-15823
16523,0.0,0.0,0.0,3611,69992,54165,-15827
16524,0.0,0.0,0.0,3611,69996,54165,-15831
16525,0.0,0.0,0.0,3611,70000,54165,-15835
16526,0.0,0.0,0.0,3611,70004,54165,-15839
16528,0.0,0.0,0.0,3611,70008,54165,-15843
16529,0.0,0.0,0.0,3611,70012,54165,-15847
16530,0.0,0.0,0.0,3611,70016,54165,-15851
16531,0.0,0.0,0.0,3611,70020,54165,-15855
16532,0.0,0.0,0.0,3611,70024,54165,-15859
16533,0.0,0.0,0.0,3611,70028,54165,-15863
16534,0.0,0.0,0.0,3611,70032,54165,-15867
16535,0.0,0.0,0.0,3611,70036,54165,-15871
16536,0.0,0.0,0.0,3611,70040,54165,-15875
16537,0.0,0.0,0.0,3611,70044,54165,-15879
16539,0.0,0.0,0.0,3611,70048,54165,-15883
16540,0.0,0.0,0.0,3611,70052,54165,-15887
16541,0.0,0.0,0.0,3611,70056,54165,-15891
16542,0.0,0.0,0.0,3611,70060,54165,-15895
16543,0.0,0.0,0.0,3611,70064,54165,-15899
16544,0.0,0.0,0.0,3611,70068,54165,-15903
16545,0.0,0.0,0.0,3611,70072,54165,-15907
16546,0.0,0.0,0.0,3611,70076,54165,-15911
16547,0.0,0.0,0.0,3611,70080,54165,-15915
16548,0.0,0.0,0.0,3611,70084,54165,-15919
16551,0.0,0.0,0.0,3611,70088,54165,-15923
16552,0.0,0.0,0.0,3611,70092,54165,-15927
16554,0.0,0.0,0.0,3611,70096,54165,-15931
16555,0.0,0.0,0.0,3611,70100,54165,-15935
16556,0.0,0.0,0.0,3611,70104,54165,-15939
16557,0.0,0.0,0.0,3611,70108,54165,-15943
16558,0.0,0.0,0.0,3611,70112,54165,-15947
16559,0.0,0.0,0.0,3611,70116,54165,-15951
16561,0.0,0.0,0.0,3611,70120,54165,-15955
16563,0.0,0.0,0.0,3611,70124,54165,-15959
16564,0.0,0.0,0.0,3611,70128,54165,-15963
16565,0.0,0.0,0.0,3611,70132,54165,-15967
16566,0.0,0.0,0.0,3611,70136,54165,-15971
16568,0.0,0.0,0.0,3611,70140,54165,-15975
16570,0.0,0.0,0.0,3611,70144,54165,-15979
16571,0.0,0.0,0.0,3611,70148,54165,-15983
16572,0.0,0.0,0.0,3611,70152,54165,-15987
16574,0.0,0.0,0.0,3611,70156,54165,-15991
16575,0.0,0.0,0.0,3611,70160,54165,-15995
16576,0.0,0.0,0.0,3611,70164,54165,-15999
16577,0.0,0.0,0.0,3611,70168,54165,-16003
16579,0.0,0.0,0.0,3611,70172,54165,-16007
16581,0.0,0.0,0.0,3611,70176,54165,-16011
16582,0.0,0.0,0.0,3611,70180,54165,-16015
16583,0.0,0.0,0.0,3611,70184,54165,-16019
16584,0.0,0.0,0.0,3611,70188,54165,-16023
16585,0.0,0.0,0.0,3611,70192,54165,-16027
16586,0.0,0.0,0.0,3611,70196,54165,-16031
16587,0.0,0.0,0.0,3611,70200,54165,-16035
16588,0.0,0.0,0.0,3611,70204,54165,-16039
16589,0.0,0.0,0.0,3611,70208,54165,-16043
16590,0.0,0.0,0.0,3611,70212,54165,-16047
16591,0.0,0.0,0.0,3611,70216,54165,-16051
16592,0.0,0.0,0.0,3611,70220,54165,-16055
16593,0.0,0.0,0.0,3611,70224,54165,-16059
16596,0.0,0.0,0.0,3611,70228,54165,-16063
16597,0.0,0.0,0.0,3611,70232,54165,-16067
16600,0.0,0.0,0.0,3611,70236,54165,-16071
16601,0.0,0.0,0.0,3611,70240,54165,-16075
16603,0.0,0.0,0.0,3611,70244,54165,-16079
16604,0.0,0.0,0.0,3611,70248,54165,-16083
16605,0.0,0.0,0.0,3611,70252,54165,-16087
16606,0.0,0.0,0.0,3611,70256,54165,-16091
16608,0.0,0.0,0.0,3611,70260,54165,-16095
16610,0.0,0.0,0.0,3611,70264,54165,-16099
16611,0.0,0.0,0.0,3611,70268,54165,-16103
16612,0.0,0.0,0.0,3611,70272,54165,-16107
16618,0.0,0.0,0.0,3611,70276,54165,-16111
16619,0.0,0.0,0.0,3611,70280,54165,-16115
16621,0.0,0.0,0.0,3611,70284,54165,-16119
16622,0.0,0.0,0.0,3611,70288,54165,-16123
16625,0.0,0.0,0.0,3611,70292,54165,-16127
16626,0.0,0.0,0.0,3611,70296,54165,-16131
16627,0.0,0.0,0.0,3611,70300,54165,-16135
16629,0.0,0.0,0.0,3611,70304,54165,-16139
16630,0.0,0.0,0.0,3611,70308,54165,-16143
16631,0.0,0.0,0.0,3611,70312,54165,-16147
16632,0.0,0.0,0.0,3611,70316,54165,-16151
16633,0.0,0.0,0.0,3611,70320,54165,-16155
16634,0.0,0.0,0.0,3611,70324,54165,-16159
16635,0.0,0.0,0.0,3611,70328,54165,-16163
16636,0.0,0.0,0.0,3611,70332,54165,-16167
16637,0.0,0.0,0.0,3611,70336,54165,-16171
16639,0.0,0.0,0.0,3611,70340,54165,-16175
16640,0.0,0.0,0.0,3611,70344,54165,-16179
16641,0.0,0.0,0.0,3611,70348,54165,-16183
16643,0.0,0.0,0.0,3611,70352,54165,-16187
16647,0.0,0.0,0.0,3611,70356,54165,-16191
16648,0.0,0.0,0.0,3611,70360,54165,-16195
16649,0.0,0.0,0.0,3611,70364,54165,-16199
16650,0.0,0.0,0.0,3611,70368,54165,-16203
16651,0.0,0.0,0.0,3611,70372,54165,-16207
16652,0.0,0.0,0.0,3611,70376,54165,-16211
16653,0.0,0.0,0.0,3611,70380,54165,-16215
16654,0.0,0.0,0.0,3611,70384,54165,-16219
16655,0.0,0.0,0.0,3611,70388,54165,-16223
16657,0.0,0.0,0.0,3611,70392,54165,-16227
16658,0.0,0.0,0.0,3611,70396,54165,-16231
16659,0.0,0.0,0.0,3611,70400,54165,-16235
16660,0.0,0.0,0.0,3611,70404,54165,-16239
16664,0.0,0.0,0.0,3611,70408,54165,-16243
16665,0.0,0.0,0.0,3611,70412,54165,-16247
16666,0.0,0.0,0.0,3611,70416,54165,-16251
16667,0.0,0.0,0.0,3611,70420,54165,-16255
16668,0.0,0.0,0.0,3611,70424,54165,-16259
16669,0.0,0.0,0.0,3611,70428,54165,-16263
16670,0.0,0.0,0.0,3611,70432,54165,-16267
16672,0.0,0.0,0.0,3611,70436,54165,-16271
16673,0.0,0.0,0.0,3611,70440,54165,-16275
16676,0.0,0.0,0.0,3611,70444,54165,-16279
16678,0.0,0.0,0.0,3611,70448,54165,-16283
16679,0.0,0.0,0.0,3611,70452,54165,-16287
16680,0.0,0.0,0.0,3611,70456,54165,-16291
16681,0.0,0.0,0.0,3611,70460,54165,-16295
16682,0.0,0.0,0.0,3611,70464,54165,-16299
16684,0.0,0.0,0.0,3611,70468,54165,-16303
16686,0.0,0.0,0.0,3611,70472,54165,-16307
16687,0.0,0.0,0.0,3611,70476,54165,-16311
16688,0.0,0.0,0.0,3611,70480,54165,-16315
16689,0.0,0.0,0.0,3611,70484,54165,-16319
16692,0.0,0.0,0.0,3611,70488,54165,-16323
16693,0.0,0.0,0.0,3611,70492,54165,-16327
16694,0.0,0.0,0.0,3611,70496,54165,-16331
16695,0.0,0.0,0.0,3611,70500,54165,-16335
16696,0.0,0.0,0.0,3611,70504,54165,-16339
16697,0.0,0.0,0.0,3611,70508,54165,-16343
16698,0.0,0.0,0.0,3611,70512,54165,-16347
16699,0.0,0.0,0.0,3611,70516,54165,-16351
16700,0.0,0.0,0.0,3611,70520,54165,-16355
16702,0.0,0.0,0.0,3611,70524,54165,-16359
16703,0.0,0.0,0.0,3611,70528,54165,-16363
16704,0.0,0.0,0.0,3611,70532,54165,-16367
16705,0.0,0.0,0.0,3611,70536,54165,-16371
16708,0.0,0.0,0.0,3611,70540,54165,-16375
16710,0.0,0.0,0.0,3611,70544,54165,-16379
16711,0.0,0.0,0.0,3611,70548,54165,-16383
16712,0.0,0.0,0.0,3611,70552,54165,-16387
16713,0.0,0.0,0.0,3611,70556,54165,-16391
16715,0.0,0.0,0.0,3611,70560,54165,-16395
16716,0.0,0.0,0.0,3611,70564,54165,-16399
16717,0.0,0.0,0.0,3611,70568,54165,-16403
16718,0.0,0.0,0.0,3611,70572,54165,-16407
16719,0.0,0.0,0.0,3611,70576,54165,-16411
16721,0.0,0.0,0.0,3611,70580,54165,-16415
16722,0.0,0.0,0.0,3611,70584,54165,-16419
16724,0.0,0.0,0.0,3611,70588,54165,-16423
16726,0.0,0.0,0.0,3611,70592,54165,-16427
16727,0.0,0.0,0.0,3611,70596,54165,-16431
16728,0.0,0.0,0.0,3611,70600,54165,-16435
16729,0.0,0.0,0.0,3611,70604,54165,-16439
16730,0.0,0.0,0.0,3611,70608,54165,-16443
16731,0.0,0.0,0.0,3611,70612,54165,-16447
16733,0.0,0.0,0.0,3611,70616,54165,-16451
16738,0.0,0.0,0.0,3611,70620,54165,-16455
16739,0.0,0.0,0.0,3611,70624,54165,-16459
16740,0.0,0.0,0.0,3611,70628,54165,-16463
16741,0.0,0.0,0.0,3611,70632,54165,-16467
16742,0.0,0.0,0.0,3611,70636,54165,-16471
16743,0.0,0.0,0.0,3611,70640,54165,-16475
16744,0.0,0.0,0.0,3611,70644,54165,-16479
16745,0.0,0.0,0.0,3611,70648,54165,-16483
16747,0.0,0.0,0.0,3611,70652,54165,-16487
16748,0.0,0.0,0.0,3611,70656,54165,-16491
16752,0.0,0.0,0.0,3611,70660,54165,-16495
16754,0.0,0.0,0.0,3611,70664,54165,-16499
16755,0.0,0.0,0.0,3611,70668,54165,-16503
16756,0.0,0.0,0.0,3611,70672,54165,-16507
16758,0.0,0.0,0.0,3611,70676,54165,-16511
16759,0.0,0.0,0.0,3611,70680,54165,-16515
16760,0.0,0.0,0.0,3611,70684,54165,-16519
16762,0.0,0.0,0.0,3611,70688,54165,-16523
16765,0.0,0.0,0.0,3611,70692,54165,-16527
16766,0.0,0.0,0.0,3611,70696,54165,-16531
16768,0.0,0.0,0.0,3611,70700,54165,-16535
16769,0.0,0.0,0.0,3611,70704,54165,-16539
16770,0.0,0.0,0.0,3611,70708,54165,-16543
16771,0.0,0.0,0.0,3611,70712,54165,-16547
16772,0.0,0.0,0.0,3611,70716,54165,-16551
16774,0.0,0.0,0.0,3611,70720,54165,-16555
16775,0.0,0.0,0.0,3611,70724,54165,-16559
16776,0.0,0.0,0.0,3611,70728,54165,-16563
16777,0.0,0.0,0.0,3611,70732,54165,-16567
16779,0.0,0.0,0.0,3611,70736,54165,-16571
16780,0.0,0.0,0.0,3611,70740,54165,-16575
16782,0.0,0.0,0.0,3611,70744,54165,-16579
16783,0.0,0.0,0.0,3611,70748,54165,-16583
16784,0.0,0.0,0.0,3611,70752,54165,-16587
16785,0.0,0.0,0.0,3611,70756,54165,-16591
16786,0.0,0.0,0.0,3611,70760,54165,-16595
16787,0.0,0.0,0.0,3611,70764,54165,-16599
16788,0.0,0.0,0.0,3611,70768,54165,-16603
16789,0.0,0.0,0.0,3611,70772,54165,-16607
16790,0.0,0.0,0.0,3611,70776,54165,-16611
16792,0.0,0.0,0.0,3611,70780,54165,-16615
16797,0.0,0.0,0.0,3611,70784,54165,-16619
16798,0.0,0.0,0.0,3611,70788,54165,-16623
16799,0.0,0.0,0.0,3611,70792,54165,-16627
16800,0.0,0.0,0.0,3611,70796,54165,-16631
16801,0.0,0.0,0.0,3611,70800,54165,-16635
16802,0.0,0.0,0.0,3611,70804,54165,-16639
16804,0.0,0.0,0.0,3611,70808,54165,-16643
16805,0.0,0.0,0.0,3611,70812,54165,-16647
16806,0.0,0.0,0.0,3611,70816,54165,-16651
16807,0.0,0.0,0.0,3611,70820,54165,-16655
16808,0.0,0.0,0.0,3611,70824,54165,-16659
16809,0.0,0.0,0.0,3611,70828,54165,-16663
16810,0.0,0.0,0.0,3611,70832,54165,-16667
16811,0.0,0.0,0.0,3611,70836,54165,-16671
16813,0.0,0.0,0.0,3611,70840,54165,-16675
16815,0.0,0.0,0.0,3611,70844,54165,-16679
16817,0.0,0.0,0.0,3611,70848,54165,-16683
16818,0.0,0.0,0.0,3611,70852,54165,-16687
16819,0.0,0.0,0.0,3611,70856,54165,-16691
16821,0.0,0.0,0.0,3611,70860,54165,-16695
16822,0.0,0.0,0.0,3611,70864,54165,-16699
16823,0.0,0.0,0.0,3611,70868,54165,-16703
16824,0.0,0.0,0.0,3611,70872,54165,-16707
16825,0.0,0.0,0.0,3611,70876,54165,-16711
16826,0.0,0.0,0.0,3611,70880,54165,-16715
16827,0.0,0.0,0.0,3611,70884,54165,-16719
16828,0.0,0.0,0.0,3611,70888,54165,-16723
16829,0.0,0.0,0.0,3611,70892,54165,-16727
16831,0.0,0.0,0.0,3611,70896,54165,-16731
16832,0.0,0.0,0.0,3611,70900,54165,-16735
16833,0.0,0.0,0.0,3611,70904,54165,-16739
16834,0.0,0.0,0.0,3611,70908,54165,-16743
16835,0.0,0.0,0.0,3611,70912,54165,-16747
16836,0.0,0.0,0.0,3611,70916,54165,-16751
16837,0.0,0.0,0.0,3611,70920,54165,-16755
16838,0.0,0.0,0.0,3611,70924,54165,-16759
16839,0.0,0.0,0.0,3611,70928,54165,-16763
16841,0.0,0.0,0.0,3611,70932,54165,-16767
16842,0.0,0.0,0.0,3611,70936,54165,-16771
16843,0.0,0.0,0.0,3611,70940,54165,-16775
16846,0.0,0.0,0.0,3611,70944,54165,-16779
16848,0.0,0.0,0.0,3611,70948,54165,-16783
16849,0.0,0.0,0.0,3611,70952,54165,-16787
16852,0.0,0.0,0.0,3611,70956,54165,-16791
16853,0.0,0.0,0.0,3611,70960,54165,-16795
16854,0.0,0.0,0.0,3611,70964,54165,-16799
16855,0.0,0.0,0.0,3611,70968,54165,-16803
16856,0.0,0.0,0.0,3611,70972,54165,-16807
16859,0.0,0.0,0.0,3611,70976,54165,-16811
16860,0.0,0.0,0.0,3611,70980,54165,-16815
16861,0.0,0.0,0.0,3611,70984,54165,-16819
16862,0.0,0.0,0.0,3611,70988,54165,-16823
16864,0.0,0.0,0.0,3611,70992,54165,-16827
16865,0.0,0.0,0.0,3611,70996,54165,-16831
16866,0.0,0.0,0.0,3611,71000,54165,-16835
16867,0.0,0.0,0.0,3611,71004,54165,-16839
16868,0.0,0.0,0.0,3611,71008,54165,-16843
16869,0.0,0.0,0.0,3611,71012,54165,-16847
16870,0.0,0.0,0.0,3611,71016,54165,-16851
16871,0.0,0.0,0.0,3611,71020,54165,-16855
16872,0.0,0.0,0.0,3611,71024,54165,-16859
16873,0.0,0.0,0.0,3611,71028,54165,-16863
16874,0.0,0.0,0.0,3611,71032,54165,-16867
16875,0.0,0.0,0.0,3611,71036,54165,-16871
16876,0.0,0.0,0.0,3611,71040,54165,-16875
16877,0.0,0.0,0.0,3611,71044,54165,-16879
16878,0.0,0.0,0.0,3611,71048,54165,-16883
16879,0.0,0.0,0.0,3611,71052,54165,-16887
16880,0.0,0.0,0.0,3611,71056,54165,-16891
16882,0.0,0.0,0.0,3611,71060,54165,-16895
16883,0.0,0.0,0.0,3611,71064,54165,-16899
16884,0.0,0.0,0.0,3611,71068,54165,-16903
16885,0.0,0.0,0.0,3611,71072,54165,-16907
16886,0.0,0.0,0.0,3611,71076,54165,-16911
16887,0.0,0.0,0.0,3611,71080,54165,-16915
16888,0.0,0.0,0.0,3611,71084,54165,-16919
16889,0.0,0.0,0.0,3611,71088,54165,-16923
16890,0.0,0.0,0.0,3611,71092,54165,-16927
16891,0.0,0.0,0.0,3611,71096,54165,-16931
16892,0.0,0.0,0.0,3611,71100,54165,-16935
16893,0.0,0.0,0.0,3611,71104,54165,-16939
16895,0.0,0.0,0.0,3611,71108,54165,-16943
16896,0.0,0.0,0.0,3611,71112,54165,-16947
16897,0.0,0.0,0.0,3611,71116,54165,-16951
16898,0.0,0.0,0.0,3611,71120,54165,-16955
16899,0.0,0.0,0.0,3611,71124,54165,-16959
16900,0.0,0.0,0.0,3611,71128,54165,-16963
16901,0.0,0.0,0.0,3611,71132,54165,-16967
16902,0.0,0.0,0.0,3611,71136,54165,-16971
16903,0.0,0.0,0.0,3611,71140,54165,-16975
16904,0.0,0.0,0.0,3611,71144,54165,-16979
16905,0.0,0.0,0.0,3611,71148,54165,-16983
16906,0.0,0.0,0.0,3611,71152,54165,-16987
16907,0.0,0.0,0.0,3611,71156,54165,-16991
16908,0.0,0.0,0.0,3611,71160,54165,-16995
16909,0.0,0.0,0.0,3611,71164,54165,-16999
16910,0.0,0.0,0.0,3611,71168,54165,-17003
16911,0.0,0.0,0.0,3611,71172,54165,-17007
16912,0.0,0.0,0.0,3611,71176,54165,-17011
16913,0.0,0.0,0.0,3611,71180,54165,-17015
16916,0.0,0.0,0.0,3611,71184,54165,-17019
16917,0.0,0.0,0.0,3611,71188,54165,-17023
16919,0.0,0.0,0.0,3611,71192,54165,-17027
16921,0.0,0.0,0.0,3611,71196,54165,-17031
16922,0.0,0.0,0.0,3611,71200,54165,-17035
16923,0.0,0.0,0.0,3611,71204,54165,-17039
16924,0.0,0.0,0.0,3611,71208,54165,-17043
16925,0.0,0.0,0.0,3611,71212,54165,-17047
16926,0.0,0.0,0.0,3611,71216,54165,-17051
16927,0.0,0.0,0.0,3611,71220,54165,-17055
16928,0.0,0.0,0.0,3611,71224,54165,-17059
16929,0.0,0.0,0.0,3611,71228,54165,-17063
16930,0.0,0.0,0.0,3611,71232,54165,-17067
16931,0.0,0.0,0.0,3611,71236,54165,-17071
16932,0.0,0.0,0.0,3611,71240,54165,-17075
16933,0.0,0.0,0.0,3611,71244,54165,-17079
16934,0.0,0.0,0.0,3611,71248,54165,-17083
16935,0.0,0.0,0.0,3611,71252,54165,-17087
16936,0.0,0.0,0.0,3611,71256,54165,-17091
16937,0.0,0.0,0.0,3611,71260,54165,-17095
16938,0.0,0.0,0.0,3611,71264,54165,-17099
16939,0.0,0.0,0.0,3611,71268,54165,-17103
16941,0.0,0.0,0.0,3611,71272,54165,-17107
16946,0.0,0.0,0.0,3611,71276,54165,-17111
16947,0.0,0.0,0.0,3611,71280,54165,-17115
16948,0.0,0.0,0.0,3611,71284,54165,-17119
16949,0.0,0.0,0.0,3611,71288,54165,-17123
16951,0.0,0.0,0.0,3611,71292,54165,-17127
16952,0.0,0.0,0.0,3611,71296,54165,-17131
16953,0.0,0.0,0.0,3611,71300,54165,-17135
16954,0.0,0.0,0.0,3611,71304,54165,-17139
16955,0.0,0.0,0.0,3611,71308,54165,-17143
16956,0.0,0.0,0.0,3611,71312,54165,-17147
16957,0.0,0.0,0.0,3611,71316,54165,-17151
16960,0.0,0.0,0.0,3611,71320,54165,-17155
16961,0.0,0.0,0.0,3611,71324,54165,-17159
16962,0.0,0.0,0.0,3611,71328,54165,-17163
16963,0.0,0.0,0.0,3611,71332,54165,-17167
16964,0.0,0.0,0.0,3611,71336,54165,-17171
16965,0.0,0.0,0.0,3611,71340,54165,-17175
16966,0.0,0.0,0.0,3611,71344,54165,-17179
16967,0.0,0.0,0.0,3611,71348,54165,-17183
16968,0.0,0.0,0.0,3611,71352,54165,-17187
16969,0.0,0.0,0.0,3611,71356,54165,-17191
16970,0.0,0.0,0.0,3611,71360,54165,-17195
16971,0.0,0.0,0.0,3611,71364,54165,-17199
16972,0.0,0.0,0.0,3611,71368,54165,-17203
16974,0.0,0.0,0.0,3611,71372,54165,-17207
16976,0.0,0.0,0.0,3611,71376,54165,-17211
16978,0.0,0.0,0.0,3611,71380,54165,-17215
16979,0.0,0.0,0.0,3611,71384,54165,-17219
16980,0.0,0.0,0.0,3611,71388,54165,-17223
16981,0.0,0.0,0.0,3611,71392,54165,-17227
16983,0.0,0.0,0.0,3611,71396,54165,-17231
16984,0.0,0.0,0.0,3611,71400,54165,-17235
16985,0.0,0.0,0.0,3611,71404,54165,-17239
16986,0.0,0.0,0.0,3611,71408,54165,-17243
16989,0.0,0.0,0.0,3611,71412,54165,-17247
16990,0.0,0.0,0.0,3611,71416,54165,-17251
16991,0.0,0.0,0.0,3611,71420,54165,-17255
16992,0.0,0.0,0.0,3611,71424,54165,-17259
16994,0.0,0.0,0.0,3611,71428,54165,-17263
16996,0.0,0.0,0.0,3611,71432,54165,-17267
16997,0.0,0.0,0.0,3611,71436,54165,-17271
16998,0.0,0.0,0.0,3611,71440,54165,-17275
16999,0.0,0.0,0.0,3611,71444,54165,-17279
17000,0.0,0.0,0.0,3611,71448,54165,-17283
17001,0.0,0.0,0.0,3611,71452,54165,-17287
17002,0.0,0.0,0.0,3611,71456,54165,-17291
17003,0.0,0.0,0.0,3611,71460,54165,-17295
17005,0.0,0.0,0.0,3611,71464,54165,-17299
17006,0.0,0.0,0.0,3611,71468,54165,-17303
17007,0.0,0.0,0.0,3611,71472,54165,-17307
17008,0.0,0.0,0.0,3611,71476,54165,-17311
17009,0.0,0.0,0.0,3611,71480,54165,-17315
17010,0.0,0.0,0.0,3611,71484,54165,-17319
17011,0.0,0.0,0.0,3611,71488,54165,-17323
17012,0.0,0.0,0.0,3611,71492,54165,-17327
17013,0.0,0.0,0.0,3611,71496,54165,-17331
17014,0.0,0.0,0.0,3611,71500,54165,-17335
17016,0.0,0.0,0.0,3611,71504,54165,-17339
17018,0.0,0.0,0.0,3611,71508,54165,-17343
17019,0.0,0.0,0.0,3611,71512,54165,-17347
17020,0.0,0.0,0.0,3611,71516,54165,-17351
17022,0.0,0.0,0.0,3611,71520,54165,-17355
17023,0.0,0.0,0.0,3611,71524,54165,-17359
17024,0.0,0.0,0.0,3611,71528,54165,-17363
17025,0.0,0.0,0.0,3611,71532,54165,-17367
17027,0.0,0.0,0.0,3611,71536,54165,-17371
17028,0.0,0.0,0.0,3611,71540,54165,-17375
17029,0.0,0.0,0.0,3611,71544,54165,-17379
17030,0.0,0.0,0.0,3611,71548,54165,-17383
17031,0.0,0.0,0.0,3611,71552,54165,-17387
17033,0.0,0.0,0.0,3611,71556,54165,-17391
17034,0.0,0.0,0.0,3611,71560,54165,-17395
17035,0.0,0.0,0.0,3611,71564,54165,-17399
17036,0.0,0.0,0.0,3611,71568,54165,-17403
17038,0.0,0.0,0.0,3611,71572,54165,-17407
17039,0.0,0.0,0.0,3611,71576,54165,-17411
17040,0.0,0.0,0.0,3611,71580,54165,-17415
17041,0.0,0.0,0.0,3611,71584,54165,-17419
17042,0.0,0.0,0.0,3611,71588,54165,-17423
17043,0.0,0.0,0.0,3611,71592,54165,-17427
17044,0.0,0.0,0.0,3611,71596,54165,-17431
17045,0.0,0.0,0.0,3611,71600,54165,-17435
17047,0.0,0.0,0.0,3611,71604,54165,-17439
17048,0.0,0.0,0.0,3611,71608,54165,-17443
17049,0.0,0.0,0.0,3611,71612,54165,-17447
17051,0.0,0.0,0.0,3611,71616,54165,-17451
17054,0.0,0.0,0.0,3611,71620,54165,-17455
17055,0.0,0.0,0.0,3611,71624,54165,-17459
17056,0.0,0.0,0.0,3611,71628,54165,-17463
17057,0.0,0.0,0.0,3611,71632,54165,-17467
17058,0.0,0.0,0.0,3611,71636,54165,-17471
17060,0.0,0.0,0.0,3611,71640,54165,-17475
17063,0.0,0.0,0.0,3611,71644,54165,-17479
17064,0.0,0.0,0.0,3611,71648,54165,-17483
17066,0.0,0.0,0.0,3611,71652,54165,-17487
17067,0.0,0.0,0.0,3611,71656,54165,-17491
17068,0.0,0.0,0.0,3611,71660,54165,-17495
17070,0.0,0.0,0.0,3611,71664,54165,-17499
17071,0.0,0.0,0.0,3611,71668,54165,-17503
17073,0.0,0.0,0.0,3611,71672,54165,-17507
17074,0.0,0.0,0.0,3611,71676,54165,-17511
17075,0.0,0.0,0.0,3611,71680,54165,-17515
17076,0.0,0.0,0.0,3611,71684,54165,-17519
17077,0.0,0.0,0.0,3611,71688,54165,-17523
17078,0.0,0.0,0.0,3611,71692,54165,-17527
17079,0.0,0.0,0.0,3611,71696,54165,-17531
17080,0.0,0.0,0.0,3611,71700,54165,-17535
17081,0.0,0.0,0.0,3611,71704,54165,-17539
17082,0.0,0.0,0.0,3611,71708,54165,-17543
17083,0.0,0.0,0.0,3611,71712,54165,-17547
17084,0.0,0.0,0.0,3611,71716,54165,-17551
17085,0.0,0.0,0.0,3611,71720,54165,-17555
17086,0.0,0.0,0.0,3611,71724,54165,-17559
17089,0.0,0.0,0.0,3611,71728,54165,-17563
17090,0.0,0.0,0.0,3611,71732,54165,-17567
17091,0.0,0.0,0.0,3611,71736,54165,-17571
17092,0.0,0.0,0.0,3611,71740,54165,-17575
17093,0.0,0.0,0.0,3611,71744,54165,-17579
17094,0.0,0.0,0.0,3611,71748,54165,-17583
17095,0.0,0.0,0.0,3611,71752,54165,-17587
17096,0.0,0.0,0.0,3611,71756,54165,-17591
17097,0.0,0.0,0.0,3611,71760,54165,-17595
17098,0.0,0.0,0.0,3611,71764,54165,-17599
17099,0.0,0.0,0.0,3611,71768,54165,-17603
17101,0.0,0.0,0.0,3611,71772,54165,-17607
17102,0.0,0.0,0.0,3611,71776,54165,-17611
17103,0.0,0.0,0.0,3611,71780,54165,-17615
17105,0.0,0.0,0.0,3611,71784,54165,-17619
17107,0.0,0.0,0.0,3611,71788,54165,-17623
17108,0.0,0.0,0.0,3611,71792,54165,-17627
17110,0.0,0.0,0.0,3611,71796,54165,-17631
17111,0.0,0.0,0.0,3611,71800,54165,-17635
17112,0.0,0.0,0.0,3611,71804,54165,-17639
17113,0.0,0.0,0.0,3611,71808,54165,-17643
17114,0.0,0.0,0.0,3611,71812,54165,-17647
17115,0.0,0.0,0.0,3611,71816,54165,-17651
17116,0.0,0.0,0.0,3611,71820,54165,-17655
17117,0.0,0.0,0.0,3611,71824,54165,-17659
17118,0.0,0.0,0.0,3611,71828,54165,-17663
17119,0.0,0.0,0.0,3611,71832,54165,-17667
17120,0.0,0.0,0.0,3611,71836,54165,-17671
17121,0.0,0.0,0.0,3611,71840,54165,-17675
17122,0.0,0.0,0.0,3611,71844,54165,-17679
17123,0.0,0.0,0.0,3611,71848,54165,-17683
17124,0.0,0.0,0.0,3611,71852,54165,-17687
17126,0.0,0.0,0.0,3611,71856,54165,-17691
17127,0.0,0.0,0.0,3611,71860,54165,-17695
17128,0.0,0.0,0.0,3611,71864,54165,-17699
17129,0.0,0.0,0.0,3611,71868,54165,-17703
17132,0.0,0.0,0.0,3611,71872,54165,-17707
17133,0.0,0.0,0.0,3611,71876,54165,-17711
17134,0.0,0.0,0.0,3611,71880,54165,-17715
17135,0.0,0.0,0.0,3611,71884,54165,-17719
17136,0.0,0.0,0.0,3611,71888,54165,-17723
17137,0.0,0.0,0.0,3611,71892,54165,-17727
17138,0.0,0.0,0.0,3611,71896,54165,-17731
17139,0.0,0.0,0.0,3611,71900,54165,-17735
17141,0.0,0.0,0.0,3611,71904,54165,-17739
17142,0.0,0.0,0.0,3611,71908,54165,-17743
17143,0.0,0.0,0.0,3611,71912,54165,-17747
17144,0.0,0.0,0.0,3611,71916,54165,-17751
17145,0.0,0.0,0.0,3611,71920,54165,-17755
17146,0.0,0.0,0.0,3611,71924,54165,-17759
17147,0.0,0.0,0.0,3611,71928,54165,-17763
17148,0.0,0.0,0.0,3611,71932,54165,-17767
17149,0.0,0.0,0.0,3611,71936,54165,-17771
17151,0.0,0.0,0.0,3611,71940,54165,-17775
17152,0.0,0.0,0.0,3611,71944,54165,-17779
17154,0.0,0.0,0.0,3611,71948,54165,-17783
17156,0.0,0.0,0.0,3611,71952,54165,-17787
17158,0.0,0.0,0.0,3611,71956,54165,-17791
17159,0.0,0.0,0.0,3611,71960,54165,-17795
17161,0.0,0.0,0.0,3611,71964,54165,-17799
17162,0.0,0.0,0.0,3611,71968,54165,-17803
17163,0.0,0.0,0.0,3611,71972,54165,-17807
17164,0.0,0.0,0.0,3611,71976,54165,-17811
17165,0.0,0.0,0.0,3611,71980,54165,-17815
17166,0.0,0.0,0.0,3611,71984,54165,-17819
17167,0.0,0.0,0.0,3611,71988,54165,-17823
17168,0.0,0.0,0.0,3611,71992,54165,-17827
17169,0.0,0.0,0.0,3611,71996,54165,-17831
17170,0.0,0.0,0.0,3611,72000,54165,-17835
17171,0.0,0.0,0.0,3611,72004,54165,-17839
17172,0.0,0.0,0.0,3611,72008,54165,-17843
17174,0.0,0.0,0.0,3611,72012,54165,-17847
17175,0.0,0.0,0.0,3611,72016,54165,-17851
17176,0.0,0.0,0.0,3611,72020,54165,-17855
17177,0.0,0.0,0.0,3611,72024,54165,-17859
17178,0.0,0.0,0.0,3611,72028,54165,-17863
17179,0.0,0.0,0.0,3611,72032,54165,-17867
17180,0.0,0.0,0.0,3611,72036,54165,-17871
17184,0.0,0.0,0.0,3611,72040,54165,-17875
17185,0.0,0.0,0.0,3611,72044,54165,-17879
17186,0.0,0.0,0.0,3611,72048,54165,-17883
17187,0.0,0.0,0.0,3611,72052,54165,-17887
17188,0.0,0.0,0.0,3611,72056,54165,-17891
17190,0.0,0.0,0.0,3611,72060,54165,-17895
17192,0.0,0.0,0.0,3611,72064,54165,-17899
17195,0.0,0.0,0.0,3611,72068,54165,-17903
17196,0.0,0.0,0.0,3611,72072,54165,-17907
17197,0.0,0.0,0.0,3611,72076,54165,-17911
17199,0.0,0.0,0.0,3611,72080,54165,-17915
17200,0.0,0.0,0.0,3611,72084,54165,-17919
17201,0.0,0.0,0.0,3611,72088,54165,-17923
17202,0.0,0.0,0.0,3611,72092,54165,-17927
17203,0.0,0.0,0.0,3611,72096,54165,-17931
17204,0.0,0.0,0.0,3611,72100,54165,-17935
17206,0.0,0.0,0.0,3611,72104,54165,-17939
17207,0.0,0.0,0.0,3611,72108,54165,-17943
17209,0.0,0.0,0.0,3611,72112,54165,-17947
17210,0.0,0.0,0.0,3611,72116,54165,-17951
17211,0.0,0.0,0.0,3611,72120,54165,-17955
17212,0.0,0.0,0.0,3611,72124,54165,-17959
17213,0.0,0.0,0.0,3611,72128,54165,-17963
17214,0.0,0.0,0.0,3611,72132,54165,-17967
17216,0.0,0.0,0.0,3611,72136,54165,-17971
17217,0.0,0.0,0.0,3611,72140,54165,-17975
17218,0.0,0.0,0.0,3611,72144,54165,-17979
17219,0.0,0.0,0.0,3611,72148,54165,-17983
17220,0.0,0.0,0.0,3611,72152,54165,-17987
17221,0.0,0.0,0.0,3611,72156,54165,-17991
17222,0.0,0.0,0.0,3611,72160,54165,-17995
17225,0.0,0.0,0.0,3611,72164,54165,-17999
17226,0.0,0.0,0.0,3611,72168,54165,-18003
17227,0.0,0.0,0.0,3611,72172,54165,-18007
17229,0.0,0.0,0.0,3611,72176,54165,-18011
17231,0.0,0.0,0.0,3611,72180,54165,-18015
17232,0.0,0.0,0.0,3611,72184,54165,-18019
17233,0.0,0.0,0.0,3611,72188,54165,-18023
17234,0.0,0.0,0.0,3611,72192,54165,-18027
17235,0.0,0.0,0.0,3611,72196,54165,-18031
17239,0.0,0.0,0.0,3611,72200,54165,-18035
17240,0.0,0.0,0.0,3611,72204,54165,-18039
17241,0.0,0.0,0.0,3611,72208,54165,-18043
17242,0.0,0.0,0.0,3611,72212,54165,-18047
17244,0.0,0.0,0.0,3611,72216,54165,-18051
17246,0.0,0.0,0.0,3611,72220,54165,-18055
17247,0.0,0.0,0.0,3611,72224,54165,-18059
17249,0.0,0.0,0.0,3611,72228,54165,-18063
17250,0.0,0.0,0.0,3611,72232,54165,-18067
17251,0.0,0.0,0.0,3611,72236,54165,-18071
17253,0.0,0.0,0.0,3611,72240,54165,-18075
17254,0.0,0.0,0.0,3611,72244,54165,-18079
17255,0.0,0.0,0.0,3611,72248,54165,-18083
17256,0.0,0.0,0.0,3611,72252,54165,-18087
17257,0.0,0.0,0.0,3611,72256,54165,-18091
17258,0.0,0.0,0.0,3611,72260,54165,-18095
17260,0.0,0.0,0.0,3611,72264,54165,-18099
17261,0.0,0.0,0.0,3611,72268,54165,-18103
17262,0.0,0.0,0.0,3611,72272,54165,-18107
17264,0.0,0.0,0.0,3611,72276,54165,-18111
17265,0.0,0.0,0.0,3611,72280,54165,-18115
17266,0.0,0.0,0.0,3611,72284,54165,-18119
17267,0.0,0.0,0.0,3611,72288,54165,-18123
17268,0.0,0.0,0.0,3611,72292,54165,-18127
17269,0.0,0.0,0.0,3611,72296,54165,-18131
17270,0.0,0.0,0.0,3611,72300,54165,-18135
17271,0.0,0.0,0.0,3611,72304,54165,-18139
17272,0.0,0.0,0.0,3611,72308,54165,-18143
17273,0.0,0.0,0.0,3611,72312,54165,-18147
17274,0.0,0.0,0.0,3611,72316,54165,-18151
17276,0.0,0.0,0.0,3611,72320,54165,-18155
17278,0.0,0.0,0.0,3611,72324,54165,-18159
17279,0.0,0.0,0.0,3611,72328,54165,-18163
17280,0.0,0.0,0.0,3611,72332,54165,-18167
17282,0.0,0.0,0.0,3611,72336,54165,-18171
17283,0.0,0.0,0.0,3611,72340,54165,-18175
17284,0.0,0.0,0.0,3611,72344,54165,-18179
17286,0.0,0.0,0.0,3611,72348,54165,-18183
17288,0.0,0.0,0.0,3611,72352,54165,-18187
17289,0.0,0.0,0.0,3611,72356,54165,-18191
17290,0.0,0.0,0.0,3611,72360,54165,-18195
17292,0.0,0.0,0.0,3611,72364,54165,-18199
17293,0.0,0.0,0.0,3611,72368,54165,-18203
17294,0.0,0.0,0.0,3611,72372,54165,-18207
17295,0.0,0.0,0.0,3611,72376,54165,-18211
17296,0.0,0.0,0.0,3611,72380,54165,-18215
17298,0.0,0.0,0.0,3611,72384,54165,-18219
17299,0.0,0.0,0.0,3611,72388,54165,-18223
17300,0.0,0.0,0.0,3611,72392,54165,-18227
17302,0.0,0.0,0.0,3611,72396,54165,-18231
17304,0.0,0.0,0.0,3611,72400,54165,-18235
17305,0.0,0.0,0.0,3611,72404,54165,-18239
17306,0.0,0.0,0.0,3611,72408,54165,-18243
17307,0.0,0.0,0.0,3611,72412,54165,-18247
17309,0.0,0.0,0.0,3611,72416,54165,-18251
17311,0.0,0.0,0.0,3611,72420,54165,-18255
17312,0.0,0.0,0.0,3611,72424,54165,-18259
17313,0.0,0.0,0.0,3611,72428,54165,-18263
17314,0.0,0.0,0.0,3611,72432,54165,-18267
17315,0.0,0.0,0.0,3611,72436,54165,-18271
17316,0.0,0.0,0.0,3611,72440,54165,-18275
17318,0.0,0.0,0.0,3611,72444,54165,-18279
17320,0.0,0.0,0.0,3611,72448,54165,-18283
17321,0.0,0.0,0.0,3611,72452,54165,-18287
17322,0.0,0.0,0.0,3611,72456,54165,-18291
17323,0.0,0.0,0.0,3611,72460,54165,-18295
17324,0.0,0.0,0.0,3611,72464,54165,-18299
17325,0.0,0.0,0.0,3611,72468,54165,-18303
17326,0.0,0.0,0.0,3611,72472,54165,-18307
17327,0.0,0.0,0.0,3611,72476,54165,-18311
17329,0.0,0.0,0.0,3611,72480,54165,-18315
17330,0.0,0.0,0.0,3611,72484,54165,-18319
17331,0.0,0.0,0.0,3611,72488,54165,-18323
17333,0.0,0.0,0.0,3611,72492,54165,-18327
17334,0.0,0.0,0.0,3611,72496,54165,-18331
17336,0.0,0.0,0.0,3611,72500,54165,-18335
17337,0.0,0.0,0.0,3611,72504,54165,-18339
17338,0.0,0.0,0.0,3611,72508,54165,-18343
17339,0.0,0.0,0.0,3611,72512,54165,-18347
17341,0.0,0.0,0.0,3611,72516,54165,-18351
17342,0.0,0.0,0.0,3611,72520,54165,-18355
17343,0.0,0.0,0.0,3611,72524,54165,-18359
17344,0.0,0.0,0.0,3611,72528,54165,-18363
17345,0.0,0.0,0.0,3611,72532,54165,-18367
17346,0.0,0.0,0.0,3611,72536,54165,-18371
17347,0.0,0.0,0.0,3611,72540,54165,-18375
17348,0.0,0.0,0.0,3611,72544,54165,-18379
17349,0.0,0.0,0.0,3611,72548,54165,-18383
17351,0.0,0.0,0.0,3611,72552,54165,-18387
17352,0.0,0.0,0.0,3611,72556,54165,-18391
17353,0.0,0.0,0.0,3611,72560,54165,-18395
17354,0.0,0.0,0.0,3611,72564,54165,-18399
17355,0.0,0.0,0.0,3611,72568,54165,-18403
17356,0.0,0.0,0.0,3611,72572,54165,-18407
17357,0.0,0.0,0.0,3611,72576,54165,-18411
17358,0.0,0.0,0.0,3611,72580,54165,-18415
17359,0.0,0.0,0.0,3611,72584,54165,-18419
17360,0.0,0.0,0.0,3611,72588,54165,-18423
17361,0.0,0.0,0.0,3611,72592,54165,-18427
17362,0.0,0.0,0.0,3611,72596,54165,-18431
17363,0.0,0.0,0.0,3611,72600,54165,-18435
17364,0.0,0.0,0.0,3611,72604,54165,-18439
17365,0.0,0.0,0.0,3611,72608,54165,-18443
17366,0.0,0.0,0.0,3611,72612,54165,-18447
17367,0.0,0.0,0.0,3611,72616,54165,-18451
17369,0.0,0.0,0.0,3611,72620,54165,-18455
17370,0.0,0.0,0.0,3611,72624,54165,-18459
17371,0.0,0.0,0.0,3611,72628,54165,-18463
17372,0.0,0.0,0.0,3611,72632,54165,-18467
17373,0.0,0.0,0.0,3611,72636,54165,-18471
17374,0.0,0.0,0.0,3611,72640,54165,-18475
17375,0.0,0.0,0.0,3611,72644,54165,-18479
17376,0.0,0.0,0.0,3611,72648,54165,-18483
17377,0.0,0.0,0.0,3611,72652,54165,-18487
17379,0.0,0.0,0.0,3611,72656,54165,-18491
17380,0.0,0.0,0.0,3611,72660,54165,-18495
17381,0.0,0.0,0.0,3611,72664,54165,-18499
17382,0.0,0.0,0.0,3611,72668,54165,-18503
17383,0.0,0.0,0.0,3611,72672,54165,-18507
17384,0.0,0.0,0.0,3611,72676,54165,-18511
17385,0.0,0.0,0.0,3611,72680,54165,-18515
17388,0.0,0.0,0.0,3611,72684,54165,-18519
17389,0.0,0.0,0.0,3611,72688,54165,-18523
17390,0.0,0.0,0.0,3611,72692,54165,-18527
17391,0.0,0.0,0.0,3611,72696,54165,-18531
17392,0.0,0.0,0.0,3611,72700,54165,-18535
17393,0.0,0.0,0.0,3611,72704,54165,-18539
17394,0.0,0.0,0.0,3611,72708,54165,-18543
17395,0.0,0.0,0.0,3611,72712,54165,-18547
17396,0.0,0.0,0.0,3611,72716,54165,-18551
17397,0.0,0.0,0.0,3611,72720,54165,-18555
17399,0.0,0.0,0.0,3611,72724,54165,-18559
17400,0.0,0.0,0.0,3611,72728,54165,-18563
17401,0.0,0.0,0.0,3611,72732,54165,-18567
17402,0.0,0.0,0.0,3611,72736,54165,-18571
17403,0.0,0.0,0.0,3611,72740,54165,-18575
17404,0.0,0.0,0.0,3611,72744,54165,-18579
17405,0.0,0.0,0.0,3611,72748,54165,-18583
17406,0.0,0.0,0.0,3611,72752,54165,-18587
17407,0.0,0.0,0.0,3611,72756,54165,-18591
17409,0.0,0.0,0.0,3611,72760,54165,-18595
17410,0.0,0.0,0.0,3611,72764,54165,-18599
17411,0.0,0.0,0.0,3611,72768,54165,-18603
17412,0.0,0.0,0.0,3611,72772,54165,-18607
17413,0.0,0.0,0.0,3611,72776,54165,-18611
17414,0.0,0.0,0.0,3611,72780,54165,-18615
17415,0.0,0.0,0.0,3611,72784,54165,-18619
17416,0.0,0.0,0.0,3611,72788,54165,-18623
17417,0.0,0.0,0.0,3611,72792,54165,-18627
17418,0.0,0.0,0.0,3611,72796,54165,-18631
17419,0.0,0.0,0.0,3611,72800,54165,-18635
17421,0.0,0.0,0.0,3611,72804,54165,-18639
17422,0.0,0.0,0.0,3611,72808,54165,-18643
17423,0.0,0.0,0.0,3611,72812,54165,-18647
17424,0.0,0.0,0.0,3611,72816,54165,-18651
17425,0.0,0.0,0.0,3611,72820,54165,-18655
17426,0.0,0.0,0.0,3611,72824,54165,-18659
17427,0.0,0.0,0.0,3611,72828,54165,-18663
17429,0.0,0.0,0.0,3611,72832,54165,-18667
17430,0.0,0.0,0.0,3611,72836,54165,-18671
17431,0.0,0.0,0.0,3611,72840,54165,-18675
17432,0.0,0.0,0.0,3611,72844,54165,-18679
17433,0.0,0.0,0.0,3611,72848,54165,-18683
17434,0.0,0.0,0.0,3611,72852,54165,-18687
17436,0.0,0.0,0.0,3611,72856,54165,-18691
17437,0.0,0.0,0.0,3611,72860,54165,-18695
17439,0.0,0.0,0.0,3611,72864,54165,-18699
17440,0.0,0.0,0.0,3611,72868,54165,-18703
17441,0.0,0.0,0.0,3611,72872,54165,-18707
17442,0.0,0.0,0.0,3611,72876,54165,-18711
17443,0.0,0.0,0.0,3611,72880,54165,-18715
17444,0.0,0.0,0.0,3611,72884,54165,-18719
17447,0.0,0.0,0.0,3611,72888,54165,-18723
17449,0.0,0.0,0.0,3611,72892,54165,-18727
17450,0.0,0.0,0.0,3611,72896,54165,-18731
17454,0.0,0.0,0.0,3611,72900,54165,-18735
17455,0.0,0.0,0.0,3611,72904,54165,-18739
17458,0.0,0.0,0.0,3611,72908,54165,-18743
17460,0.0,0.0,0.0,3611,72912,54165,-18747
17461,0.0,0.0,0.0,3611,72916,54165,-18751
17463,0.0,0.0,0.0,3611,72920,54165,-18755
17464,0.0,0.0,0.0,3611,72924,54165,-18759
17465,0.0,0.0,0.0,3611,72928,54165,-18763
17466,0.0,0.0,0.0,3611,72932,54165,-18767
17467,0.0,0.0,0.0,3611,72936,54165,-18771
17468,0.0,0.0,0.0,3611,72940,54165,-18775
17469,0.0,0.0,0.0,3611,72944,54165,-18779
17470,0.0,0.0,0.0,3611,72948,54165,-18783
17471,0.0,0.0,0.0,3611,72952,54165,-18787
17472,0.0,0.0,0.0,3611,72956,54165,-18791
17473,0.0,0.0,0.0,3611,72960,54165,-18795
17474,0.0,0.0,0.0,3611,72964,54165,-18799
17475,0.0,0.0,0.0,3611,72968,54165,-18803
17476,0.0,0.0,0.0,3611,72972,54165,-18807
17477,0.0,0.0,0.0,3611,72976,54165,-18811
17478,0.0,0.0,0.0,3611,72980,54165,-18815
17479,0.0,0.0,0.0,3611,72984,54165,-18819
17480,0.0,0.0,0.0,3611,72988,54165,-18823
17482,0.0,0.0,0.0,3611,72992,54165,-18827
17483,0.0,0.0,0.0,3611,72996,54165,-18831
17484,0.0,0.0,0.0,3611,73000,54165,-18835
17485,0.0,0.0,0.0,3611,73004,54165,-18839
17486,0.0,0.0,0.0,3611,73008,54165,-18843
17488,0.0,0.0,0.0,3611,73012,54165,-18847
17490,0.0,0.0,0.0,3611,73016,54165,-18851
17491,0.0,0.0,0.0,3611,73020,54165,-18855
17492,0.0,0.0,0.0,3611,73024,54165,-18859
17495,0.0,0.0,0.0,3611,73028,54165,-18863
17496,0.0,0.0,0.0,3611,73032,54165,-18867
17497,0.0,0.0,0.0,3611,73036,54165,-18871
17499,0.0,0.0,0.0,3611,73040,54165,-18875
17501,0.0,0.0,0.0,3611,73044,54165,-18879
17502,0.0,0.0,0.0,3611,73048,54165,-18883
17504,0.0,0.0,0.0,3611,73052,54165,-18887
17505,0.0,0.0,0.0,3611,73056,54165,-18891
17506,0.0,0.0,0.0,3611,73060,54165,-18895
17508,0.0,0.0,0.0,3611,73064,54165,-18899
17509,0.0,0.0,0.0,3611,73068,54165,-18903
17510,0.0,0.0,0.0,3611,73072,54165,-18907
17511,0.0,0.0,0.0,3611,73076,54165,-18911
17513,0.0,0.0,0.0,3611,73080,54165,-18915
17514,0.0,0.0,0.0,3611,73084,54165,-18919
17515,0.0,0.0,0.0,3611,73088,54165,-18923
17516,0.0,0.0,0.0,3611,73092,54165,-18927
17517,0.0,0.0,0.0,3611,73096,54165,-18931
17518,0.0,0.0,0.0,3611,73100,54165,-18935
17520,0.0,0.0,0.0,3611,73104,54165,-18939
17521,0.0,0.0,0.0,3611,73108,54165,-18943
17522,0.0,0.0,0.0,3611,73112,54165,-18947
17523,0.0,0.0,0.0,3611,73116,54165,-18951
17526,0.0,0.0,0.0,3611,73120,54165,-18955
17527,0.0,0.0,0.0,3611,73124,54165,-18959
17528,0.0,0.0,0.0,3611,73128,54165,-18963
17529,0.0,0.0,0.0,3611,73132,54165,-18967
17530,0.0,0.0,0.0,3611,73136,54165,-18971
17531,0.0,0.0,0.0,3611,73140,54165,-18975
17533,0.0,0.0,0.0,3611,73144,54165,-18979
17534,0.0,0.0,0.0,3611,73148,54165,-18983
17535,0.0,0.0,0.0,3611,73152,54165,-18987
17536,0.0,0.0,0.0,3611,73156,54165,-18991
17537,0.0,0.0,0.0,3611,73160,54165,-18995
17538,0.0,0.0,0.0,3611,73164,54165,-18999
17539,0.0,0.0,0.0,3611,73168,54165,-19003
17541,0.0,0.0,0.0,3611,73172,54165,-19007
17545,0.0,0.0,0.0,3611,73176,54165,-19011
17548,0.0,0.0,0.0,3611,73180,54165,-19015
17549,0.0,0.0,0.0,3611,73184,54165,-19019
17550,0.0,0.0,0.0,3611,73188,54165,-19023
17551,0.0,0.0,0.0,3611,73192,54165,-19027
17552,0.0,0.0,0.0,3611,73196,54165,-19031
17553,0.0,0.0,0.0,3611,73200,54165,-19035
17554,0.0,0.0,0.0,3611,73204,54165,-19039
17557,0.0,0.0,0.0,3611,73208,54165,-19043
17558,0.0,0.0,0.0,3611,73212,54165,-19047
17559,0.0,0.0,0.0,3611,73216,54165,-19051
17560,0.0,0.0,0.0,3611,73220,54165,-19055
17561,0.0,0.0,0.0,3611,73224,54165,-19059
17562,0.0,0.0,0.0,3611,73228,54165,-19063
17563,0.0,0.0,0.0,3611,73232,54165,-19067
17564,0.0,0.0,0.0,3611,73236,54165,-19071
17565,0.0,0.0,0.0,3611,73240,54165,-19075
17566,0.0,0.0,0.0,3611,73244,54165,-19079
17568,0.0,0.0,0.0,3611,73248,54165,-19083
17569,0.0,0.0,0.0,3611,73252,54165,-19087
17570,0.0,0.0,0.0,3611,73256,54165,-19091
17571,0.0,0.0,0.0,3611,73260,54165,-19095
17572,0.0,0.0,0.0,3611,73264,54165,-19099
17573,0.0,0.0,0.0,3611,73268,54165,-19103
17574,0.0,0.0,0.0,3611,73272,54165,-19107
17576,0.0,0.0,0.0,3611,73276,54165,-19111
17577,0.0,0.0,0.0,3611,73280,54165,-19115
17578,0.0,0.0,0.0,3611,73284,54165,-19119
17580,0.0,0.0,0.0,3611,73288,54165,-19123
17581,0.0,0.0,0.0,3611,73292,54165,-19127
17582,0.0,0.0,0.0,3611,73296,54165,-19131
17584,0.0,0.0,0.0,3611,73300,54165,-19135
17587,0.0,0.0,0.0,3611,73304,54165,-19139
17589,0.0,0.0,0.0,3611,73308,54165,-19143
17591,0.0,0.0,0.0,3611,73312,54165,-19147
17593,0.0,0.0,0.0,3611,73316,54165,-19151
17594,0.0,0.0,0.0,3611,73320,54165,-19155
17595,0.0,0.0,0.0,3611,73324,54165,-19159
17597,0.0,0.0,0.0,3611,73328,54165,-19163
17599,0.0,0.0,0.0,3611,73332,54165,-19167
17600,0.0,0.0,0.0,3611,73336,54165,-19171
17601,0.0,0.0,0.0,3611,73340,54165,-19175
17602,0.0,0.0,0.0,3611,73344,54165,-19179
17603,0.0,0.0,0.0,3611,73348,54165,-19183
17604,0.0,0.0,0.0,3611,73352,54165,-19187
17605,0.0,0.0,0.0,3611,73356,54165,-19191
17607,0.0,0.0,0.0,3611,73360,54165,-19195
17608,0.0,0.0,0.0,3611,73364,54165,-19199
17609,0.0,0.0,0.0,3611,73368,54165,-19203
17610,0.0,0.0,0.0,3611,73372,54165,-19207
17611,0.0,0.0,0.0,3611,73376,54165,-19211
17612,0.0,0.0,0.0,3611,73380,54165,-19215
17613,0.0,0.0,0.0,3611,73384,54165,-19219
17614,0.0,0.0,0.0,3611,73388,54165,-19223
17615,0.0,0.0,0.0,3611,73392,54165,-19227
17618,0.0,0.0,0.0,3611,73396,54165,-19231
17619,0.0,0.0,0.0,3611,73400,54165,-19235
17620,0.0,0.0,0.0,3611,73404,54165,-19239
17621,0.0,0.0,0.0,3611,73408,54165,-19243
17622,0.0,0.0,0.0,3611,73412,54165,-19247
17624,0.0,0.0,0.0,3611,73416,54165,-19251
17625,0.0,0.0,0.0,3611,73420,54165,-19255
17626,0.0,0.0,0.0,3611,73424,54165,-19259
17627,0.0,0.0,0.0,3611,73428,54165,-19263
17628,0.0,0.0,0.0,3611,73432,54165,-19267
17629,0.0,0.0,0.0,3611,73436,54165,-19271
17630,0.0,0.0,0.0,3611,73440,54165,-19275
17631,0.0,0.0,0.0,3611,73444,54165,-19279
17633,0.0,0.0,0.0,3611,73448,54165,-19283
17634,0.0,0.0,0.0,3611,73452,54165,-19287
17635,0.0,0.0,0.0,3611,73456,54165,-19291
17636,0.0,0.0,0.0,3611,73460,54165,-19295
17637,0.0,0.0,0.0,3611,73464,54165,-19299
17638,0.0,0.0,0.0,3611,73468,54165,-19303
17641,0.0,0.0,0.0,3611,73472,54165,-19307
17642,0.0,0.0,0.0,3611,73476,54165,-19311
17643,0.0,0.0,0.0,3611,73480,54165,-19315
17644,0.0,0.0,0.0,3611,73484,54165,-19319
17645,0.0,0.0,0.0,3611,73488,54165,-19323
17647,0.0,0.0,0.0,3611,73492,54165,-19327
17648,0.0,0.0,0.0,3611,73496,54165,-19331
17649,0.0,0.0,0.0,3611,73500,54165,-19335
17650,0.0,0.0,0.0,3611,73504,54165,-19339
17651,0.0,0.0,0.0,3611,73508,54165,-19343
17652,0.0,0.0,0.0,3611,73512,54165,-19347
17653,0.0,0.0,0.0,3611,73516,54165,-19351
17654,0.0,0.0,0.0,3611,73520,54165,-19355
17657,0.0,0.0,0.0,3611,73524,54165,-19359
17658,0.0,0.0,0.0,3611,73528,54165,-19363
17659,0.0,0.0,0.0,3611,73532,54165,-19367
17660,0.0,0.0,0.0,3611,73536,54165,-19371
17661,0.0,0.0,0.0,3611,73540,54165,-19375
17663,0.0,0.0,0.0,3611,73544,54165,-19379
17664,0.0,0.0,0.0,3611,73548,54165,-19383
17665,0.0,0.0,0.0,3611,73552,54165,-19387
17667,0.0,0.0,0.0,3611,73556,54165,-19391
17668,0.0,0.0,0.0,3611,73560,54165,-19395
17669,0.0,0.0,0.0,3611,73564,54165,-19399
17670,0.0,0.0,0.0,3611,73568,54165,-19403
17671,0.0,0.0,0.0,3611,73572,54165,-19407
17673,0.0,0.0,0.0,3611,73576,54165,-19411
17674,0.0,0.0,0.0,3611,73580,54165,-19415
17676,0.0,0.0,0.0,3611,73584,54165,-19419
17677,0.0,0.0,0.0,3611,73588,54165,-19423
17678,0.0,0.0,0.0,3611,73592,54165,-19427
17679,0.0,0.0,0.0,3611,73596,54165,-19431
17681,0.0,0.0,0.0,3611,73600,54165,-19435
17683,0.0,0.0,0.0,3611,73604,54165,-19439
17684,0.0,0.0,0.0,3611,73608,54165,-19443
17686,0.0,0.0,0.0,3611,73612,54165,-19447
17687,0.0,0.0,0.0,3611,73616,54165,-19451
17688,0.0,0.0,0.0,3611,73620,54165,-19455
17690,0.0,0.0,0.0,3611,73624,54165,-19459
17691,0.0,0.0,0.0,3611,73628,54165,-19463
17692,0.0,0.0,0.0,3611,73632,54165,-19467
17693,0.0,0.0,0.0,3611,73636,54165,-19471
17694,0.0,0.0,0.0,3611,73640,54165,-19475
17695,0.0,0.0,0.0,3611,73644,54165,-19479
17696,0.0,0.0,0.0,3611,73648,54165,-19483
17697,0.0,0.0,0.0,3611,73652,54165,-19487
17699,0.0,0.0,0.0,3611,73656,54165,-19491
17700,0.0,0.0,0.0,3611,73660,54165,-19495
17701,0.0,0.0,0.0,3611,73664,54165,-19499
17702,0.0,0.0,0.0,3611,73668,54165,-19503
17704,0.0,0.0,0.0,3611,73672,54165,-19507
17705,0.0,0.0,0.0,3611,73676,54165,-19511
17706,0.0,0.0,0.0,3611,73680,54165,-19515
17707,0.0,0.0,0.0,3611,73684,54165,-19519
17708,0.0,0.0,0.0,3611,73688,54165,-19523
17709,0.0,0.0,0.0,3611,73692,54165,-19527
17710,0.0,0.0,0.0,3611,73696,54165,-19531
17712,0.0,0.0,0.0,3611,73700,54165,-19535
17713,0.0,0.0,0.0,3611,73704,54165,-19539
17714,0.0,0.0,0.0,3611,73708,54165,-19543
17715,0.0,0.0,0.0,3611,73712,54165,-19547
17716,0.0,0.0,0.0,3611,73716,54165,-19551
17717,0.0,0.0,0.0,3611,73720,54165,-19555
17718,0.0,0.0,0.0,3611,73724,54165,-19559
17719,0.0,0.0,0.0,3611,73728,54165,-19563
17720,0.0,0.0,0.0,3611,73732,54165,-19567
17721,0.0,0.0,0.0,3611,73736,54165,-19571
17722,0.0,0.0,0.0,3611,73740,54165,-19575
17723,0.0,0.0,0.0,3611,73744,54165,-19579
17724,0.0,0.0,0.0,3611,73748,54165,-19583
17725,0.0,0.0,0.0,3611,73752,54165,-19587
17726,0.0,0.0,0.0,3611,73756,54165,-19591
17727,0.0,0.0,0.0,3611,73760,54165,-19595
17728,0.0,0.0,0.0,3611,73764,54165,-19599
17730,0.0,0.0,0.0,3611,73768,54165,-19603
17731,0.0,0.0,0.0,3611,73772,54165,-19607
17732,0.0,0.0,0.0,3611,73776,54165,-19611
17733,0.0,0.0,0.0,3611,73780,54165,-19615
17734,0.0,0.0,0.0,3611,73784,54165,-19619
17737,0.0,0.0,0.0,3611,73788,54165,-19623
17738,0.0,0.0,0.0,3611,73792,54165,-19627
17739,0.0,0.0,0.0,3611,73796,54165,-19631
17740,0.0,0.0,0.0,3611,73800,54165,-19635
17741,0.0,0.0,0.0,3611,73804,54165,-19639
17742,0.0,0.0,0.0,3611,73808,54165,-19643
17743,0.0,0.0,0.0,3611,73812,54165,-19647
17744,0.0,0.0,0.0,3611,73816,54165,-19651
17745,0.0,0.0,0.0,3611,73820,54165,-19655
17746,0.0,0.0,0.0,3611,73824,54165,-19659
17747,0.0,0.0,0.0,3611,73828,54165,-19663
17748,0.0,0.0,0.0,3611,73832,54165,-19667
17749,0.0,0.0,0.0,3611,73836,54165,-19671
17752,0.0,0.0,0.0,3611,73840,54165,-19675
17753,0.0,0.0,0.0,3611,73844,54165,-19679
17754,0.0,0.0,0.0,3611,73848,54165,-19683
17755,0.0,0.0,0.0,3611,73852,54165,-19687
17756,0.0,0.0,0.0,3611,73856,54165,-19691
17757,0.0,0.0,0.0,3611,73860,54165,-19695
17758,0.0,0.0,0.0,3611,73864,54165,-19699
17759,0.0,0.0,0.0,3611,73868,54165,-19703
17761,0.0,0.0,0.0,3611,73872,54165,-19707
17763,0.0,0.0,0.0,3611,73876,54165,-19711
17764,0.0,0.0,0.0,3611,73880,54165,-19715
17765,0.0,0.0,0.0,3611,73884,54165,-19719
17768,0.0,0.0,0.0,3611,73888,54165,-19723
17770,0.0,0.0,0.0,3611,73892,54165,-19727
17771,0.0,0.0,0.0,3611,73896,54165,-19731
17773,0.0,0.0,0.0,3611,73900,54165,-19735
17774,0.0,0.0,0.0,3611,73904,54165,-19739
17775,0.0,0.0,0.0,3611,73908,54165,-19743
17776,0.0,0.0,0.0,3611,73912,54165,-19747
17777,0.0,0.0,0.0,3611,73916,54165,-19751
17778,0.0,0.0,0.0,3611,73920,54165,-19755
17779,0.0,0.0,0.0,3611,73924,54165,-19759
17780,0.0,0.0,0.0,3611,73928,54165,-19763
17781,0.0,0.0,0.0,3611,73932,54165,-19767
17782,0.0,0.0,0.0,3611,73936,54165,-19771
17784,0.0,0.0,0.0,3611,73940,54165,-19775
17786,0.0,0.0,0.0,3611,73944,54165,-19779
17787,0.0,0.0,0.0,3611,73948,54165,-19783
17788,0.0,0.0,0.0,3611,73952,54165,-19787
17789,0.0,0.0,0.0,3611,73956,54165,-19791
17790,0.0,0.0,0.0,3611,73960,54165,-19795
17791,0.0,0.0,0.0,3611,73964,54165,-19799
17792,0.0,0.0,0.0,3611,73968,54165,-19803
17793,0.0,0.0,0.0,3611,73972,54165,-19807
17794,0.0,0.0,0.0,3611,73976,54165,-19811
17795,0.0,0.0,0.0,3611,73980,54165,-19815
17796,0.0,0.0,0.0,3611,73984,54165,-19819
17797,0.0,0.0,0.0,3611,73988,54165,-19823
17798,0.0,0.0,0.0,3611,73992,54165,-19827
17799,0.0,0.0,0.0,3611,73996,54165,-19831
17800,0.0,0.0,0.0,3611,74000,54165,-19835
17801,0.0,0.0,0.0,3611,74004,54165,-19839
17802,0.0,0.0,0.0,3611,74008,54165,-19843
17803,0.0,0.0,0.0,3611,74012,54165,-19847
17804,0.0,0.0,0.0,3611,74016,54165,-19851
17806,0.0,0.0,0.0,3611,74020,54165,-19855
17807,0.0,0.0,0.0,3611,74024,54165,-19859
17808,0.0,0.0,0.0,3611,74028,54165,-19863
17809,0.0,0.0,0.0,3611,74032,54165,-19867
17810,0.0,0.0,0.0,3611,74036,54165,-19871
17811,0.0,0.0,0.0,3611,74040,54165,-19875
17812,0.0,0.0,0.0,3611,74044,54165,-19879
17813,0.0,0.0,0.0,3611,74048,54165,-19883
17814,0.0,0.0,0.0,3611,74052,54165,-19887
17815,0.0,0.0,0.0,3611,74056,54165,-19891
17816,0.0,0.0,0.0,3611,74060,54165,-19895
17817,0.0,0.0,0.0,3611,74064,54165,-19899
17818,0.0,0.0,0.0,3611,74068,54165,-19903
17820,0.0,0.0,0.0,3611,74072,54165,-19907
17822,0.0,0.0,0.0,3611,74076,54165,-19911
17824,0.0,0.0,0.0,3611,74080,54165,-19915
17825,0.0,0.0,0.0,3611,74084,54165,-19919
17826,0.0,0.0,0.0,3611,74088,54165,-19923
17828,0.0,0.0,0.0,3611,74092,54165,-19927
17829,0.0,0.0,0.0,3611,74096,54165,-19931
17831,0.0,0.0,0.0,3611,74100,54165,-19935
17832,0.0,0.0,0.0,3611,74104,54165,-19939
17833,0.0,0.0,0.0,3611,74108,54165,-19943
17834,0.0,0.0,0.0,3611,74112,54165,-19947
17836,0.0,0.0,0.0,3611,74116,54165,-19951
17837,0.0,0.0,0.0,3611,74120,54165,-19955
17839,0.0,0.0,0.0,3611,74124,54165,-19959
17840,0.0,0.0,0.0,3611,74128,54165,-19963
17841,0.0,0.0,0.0,3611,74132,54165,-19967
17842,0.0,0.0,0.0,3611,74136,54165,-19971
17843,0.0,0.0,0.0,3611,74140,54165,-19975
17844,0.0,0.0,0.0,3611,74144,54165,-19979
17845,0.0,0.0,0.0,3611,74148,54165,-19983
17847,0.0,0.0,0.0,3611,74152,54165,-19987
17851,0.0,0.0,0.0,3611,74156,54165,-19991
17852,0.0,0.0,0.0,3611,74160,54165,-19995
17853,0.0,0.0,0.0,3611,74164,54165,-19999
17854,0.0,0.0,0.0,3611,74168,54165,-20003
17855,0.0,0.0,0.0,3611,74172,54165,-20007
17856,0.0,0.0,0.0,3611,74176,54165,-20011
17857,0.0,0.0,0.0,3611,74180,54165,-20015
17858,0.0,0.0,0.0,3611,74184,54165,-20019
17860,0.0,0.0,0.0,3611,74188,54165,-20023
17861,0.0,0.0,0.0,3611,74192,54165,-20027
17862,0.0,0.0,0.0,3611,74196,54165,-20031
17863,0.0,0.0,0.0,3611,74200,54165,-20035
17864,0.0,0.0,0.0,3611,74204,54165,-20039
17865,0.0,0.0,0.0,3611,74208,54165,-20043
17867,0.0,0.0,0.0,3611,74212,54165,-20047
17868,0.0,0.0,0.0,3611,74216,54165,-20051
17869,0.0,0.0,0.0,3611,74220,54165,-20055
17870,0.0,0.0,0.0,3611,74224,54165,-20059
17871,0.0,0.0,0.0,3611,74228,54165,-20063
17872,0.0,0.0,0.0,3611,74232,54165,-20067
17873,0.0,0.0,0.0,3611,74236,54165,-20071
17874,0.0,0.0,0.0,3611,74240,54165,-20075
17875,0.0,0.0,0.0,3611,74244,54165,-20079
17876,0.0,0.0,0.0,3611,74248,54165,-20083
17877,0.0,0.0,0.0,3611,74252,54165,-20087
17878,0.0,0.0,0.0,3611,74256,54165,-20091
17879,0.0,0.0,0.0,3611,74260,54165,-20095
17880,0.0,0.0,0.0,3611,74264,54165,-20099
17881,0.0,0.0,0.0,3611,74268,54165,-20103
17882,0.0,0.0,0.0,3611,74272,54165,-20107
17883,0.0,0.0,0.0,3611,74276,54165,-20111
17884,0.0,0.0,0.0,3611,74280,54165,-20115
17885,0.0,0.0,0.0,3611,74284,54165,-20119
17887,0.0,0.0,0.0,3611,74288,54165,-20123
17888,0.0,0.0,0.0,3611,74292,54165,-20127
17889,0.0,0.0,0.0,3611,74296,54165,-20131
17890,0.0,0.0,0.0,3611,74300,54165,-20135
17891,0.0,0.0,0.0,3611,74304,54165,-20139
17892,0.0,0.0,0.0,3611,74308,54165,-20143
17894,0.0,0.0,0.0,3611,74312,54165,-20147
17895,0.0,0.0,0.0,3611,74316,54165,-20151
17896,0.0,0.0,0.0,3611,74320,54165,-20155
17897,0.0,0.0,0.0,3611,74324,54165,-20159
17898,0.0,0.0,0.0,3611,74328,54165,-20163
17899,0.0,0.0,0.0,3611,74332,54165,-20167
17901,0.0,0.0,0.0,3611,74336,54165,-20171
17902,0.0,0.0,0.0,3611,74340,54165,-20175
17903,0.0,0.0,0.0,3611,74344,54165,-20179
17904,0.0,0.0,0.0,3611,74348,54165,-20183
17905,0.0,0.0,0.0,3611,74352,54165,-20187
17906,0.0,0.0,0.0,3611,74356,54165,-20191
17907,0.0,0.0,0.0,3611,74360,54165,-20195
17908,0.0,0.0,0.0,3611,74364,54165,-20199
17910,0.0,0.0,0.0,3611,74368,54165,-20203
17911,0.0,0.0,0.0,3611,74372,54165,-20207
17912,0.0,0.0,0.0,3611,74376,54165,-20211
17913,0.0,0.0,0.0,3611,74380,54165,-20215
17914,0.0,0.0,0.0,3611,74384,54165,-20219
17915,0.0,0.0,0.0,3611,74388,54165,-20223
17918,0.0,0.0,0.0,3611,74392,54165,-20227
17919,0.0,0.0,0.0,3611,74396,54165,-20231
17920,0.0,0.0,0.0,3611,74400,54165,-20235
17922,0.0,0.0,0.0,3611,74404,54165,-20239
17923,0.0,0.0,0.0,3611,74408,54165,-20243
17926,0.0,0.0,0.0,3611,74412,54165,-20247
17929,0.0,0.0,0.0,3611,74416,54165,-20251
17930,0.0,0.0,0.0,3611,74420,54165,-20255
17933,0.0,0.0,0.0,3611,74424,54165,-20259
17934,0.0,0.0,0.0,3611,74428,54165,-20263
17937,0.0,0.0,0.0,3611,74432,54165,-20267
17938,0.0,0.0,0.0,3611,74436,54165,-20271
17939,0.0,0.0,0.0,3611,74440,54165,-20275
17940,0.0,0.0,0.0,3611,74444,54165,-20279
17942,0.0,0.0,0.0,3611,74448,54165,-20283
17943,0.0,0.0,0.0,3611,74452,54165,-20287
17944,0.0,0.0,0.0,3611,74456,54165,-20291
17945,0.0,0.0,0.0,3611,74460,54165,-20295
17946,0.0,0.0,0.0,3611,74464,54165,-20299
17947,0.0,0.0,0.0,3611,74468,54165,-20303
17948,0.0,0.0,0.0,3611,74472,54165,-20307
17949,0.0,0.0,0.0,3611,74476,54165,-20311
17950,0.0,0.0,0.0,3611,74480,54165,-20315
17952,0.0,0.0,0.0,3611,74484,54165,-20319
17953,0.0,0.0,0.0,3611,74488,54165,-20323
17954,0.0,0.0,0.0,3611,74492,54165,-20327
17955,0.0,0.0,0.0,3611,74496,54165,-20331
17956,0.0,0.0,0.0,3611,74500,54165,-20335
17957,0.0,0.0,0.0,3611,74504,54165,-20339
17958,0.0,0.0,0.0,3611,74508,54165,-20343
17959,0.0,0.0,0.0,3611,74512,54165,-20347
17960,0.0,0.0,0.0,3611,74516,54165,-20351
17962,0.0,0.0,0.0,3611,74520,54165,-20355
17963,0.0,0.0,0.0,3611,74524,54165,-20359
17964,0.0,0.0,0.0,3611,74528,54165,-20363
17965,0.0,0.0,0.0,3611,74532,54165,-20367
17966,0.0,0.0,0.0,3611,74536,54165,-20371
17967,0.0,0.0,0.0,3611,74540,54165,-20375
17968,0.0,0.0,0.0,3611,74544,54165,-20379
17969,0.0,0.0,0.0,3611,74548,54165,-20383
17970,0.0,0.0,0.0,3611,74552,54165,-20387
17972,0.0,0.0,0.0,3611,74556,54165,-20391
17973,0.0,0.0,0.0,3611,74560,54165,-20395
17974,0.0,0.0,0.0,3611,74564,54165,-20399
17975,0.0,0.0,0.0,3611,74568,54165,-20403
17976,0.0,0.0,0.0,3611,74572,54165,-20407
17977,0.0,0.0,0.0,3611,74576,54165,-20411
17978,0.0,0.0,0.0,3611,74580,54165,-20415
17979,0.0,0.0,0.0,3611,74584,54165,-20419
17980,0.0,0.0,0.0,3611,74588,54165,-20423
17982,0.0,0.0,0.0,3611,74592,54165,-20427
17983,0.0,0.0,0.0,3611,74596,54165,-20431
17985,0.0,0.0,0.0,3611,74600,54165,-20435
17986,0.0,0.0,0.0,3611,74604,54165,-20439
17987,0.0,0.0,0.0,3611,74608,54165,-20443
17988,0.0,0.0,0.0,3611,74612,54165,-20447
17989,0.0,0.0,0.0,3611,74616,54165,-20451
17990,0.0,0.0,0.0,3611,74620,54165,-20455
17992,0.0,0.0,0.0,3611,74624,54165,-20459
17993,0.0,0.0,0.0,3611,74628,54165,-20463
17994,0.0,0.0,0.0,3611,74632,54165,-20467
17995,0.0,0.0,0.0,3611,74636,54165,-20471
17996,0.0,0.0,0.0,3611,74640,54165,-20475
17997,0.0,0.0,0.0,3611,74644,54165,-20479
17998,0.0,0.0,0.0,3611,74648,54165,-20483
17999,0.0,0.0,0.0,3611,74652,54165,-20487
18000,0.0,0.0,0.0,3611,74656,54165,-20491
18001,0.0,0.0,0.0,3611,74660,54165,-20495
18002,0.0,0.0,0.0,3611,74664,54165,-20499
18003,0.0,0.0,0.0,3611,74668,54165,-20503
18004,0.0,0.0,0.0,3611,74672,54165,-20507
18005,0.0,0.0,0.0,3611,74676,54165,-20511
18006,0.0,0.0,0.0,3611,74680,54165,-20515
18007,0.0,0.0,0.0,3611,74684,54165,-20519
18008,0.0,0.0,0.0,3611,74688,54165,-20523
18009,0.0,0.0,0.0,3611,74692,54165,-20527
18011,0.0,0.0,0.0,3611,74696,54165,-20531
18013,0.0,0.0,0.0,3611,74700,54165,-20535
18014,0.0,0.0,0.0,3611,74704,54165,-20539
18015,0.0,0.0,0.0,3611,74708,54165,-20543
18016,0.0,0.0,0.0,3611,74712,54165,-20547
18017,0.0,0.0,0.0,3611,74716,54165,-20551
18018,0.0,0.0,0.0,3611,74720,54165,-20555
18019,0.0,0.0,0.0,3611,74724,54165,-20559
18020,0.0,0.0,0.0,3611,74728,54165,-20563
18021,0.0,0.0,0.0,3611,74732,54165,-20567
18022,0.0,0.0,0.0,3611,74736,54165,-20571
18024,0.0,0.0,0.0,3611,74740,54165,-20575
18025,0.0,0.0,0.0,3611,74744,54165,-20579
18026,0.0,0.0,0.0,3611,74748,54165,-20583
18027,0.0,0.0,0.0,3611,74752,54165,-20587
18028,0.0,0.0,0.0,3611,74756,54165,-20591
18029,0.0,0.0,0.0,3611,74760,54165,-20595
18030,0.0,0.0,0.0,3611,74764,54165,-20599
18031,0.0,0.0,0.0,3611,74768,54165,-20603
18034,0.0,0.0,0.0,3611,74772,54165,-20607
18035,0.0,0.0,0.0,3611,74776,54165,-20611
18036,0.0,0.0,0.0,3611,74780,54165,-20615
18037,0.0,0.0,0.0,3611,74784,54165,-20619
18038,0.0,0.0,0.0,3611,74788,54165,-20623
18039,0.0,0.0,0.0,3611,74792,54165,-20627
18040,0.0,0.0,0.0,3611,74796,54165,-20631
18041,0.0,0.0,0.0,3611,74800,54165,-20635
18042,0.0,0.0,0.0,3611,74804,54165,-20639
18043,0.0,0.0,0.0,3611,74808,54165,-20643
18044,0.0,0.0,0.0,3611,74812,54165,-20647
18045,0.0,0.0,0.0,3611,74816,54165,-20651
18046,0.0,0.0,0.0,3611,74820,54165,-20655
18048,0.0,0.0,0.0,3611,74824,54165,-20659
18049,0.0,0.0,0.0,3611,74828,54165,-20663
18050,0.0,0.0,0.0,3611,74832,54165,-20667
18051,0.0,0.0,0.0,3611,74836,54165,-20671
18052,0.0,0.0,0.0,3611,74840,54165,-20675
18053,0.0,0.0,0.0,3611,74844,54165,-20679
18054,0.0,0.0,0.0,3611,74848,54165,-20683
18055,0.0,0.0,0.0,3611,74852,54165,-20687
18056,0.0,0.0,0.0,3611,74856,54165,-20691
18057,0.0,0.0,0.0,3611,74860,54165,-20695
18058,0.0,0.0,0.0,3611,74864,54165,-20699
18059,0.0,0.0,0.0,3611,74868,54165,-20703
18060,0.0,0.0,0.0,3611,74872,54165,-20707
18061,0.0,0.0,0.0,3611,74876,54165,-20711
18062,0.0,0.0,0.0,3611,74880,54165,-20715
18063,0.0,0.0,0.0,3611,74884,54165,-20719
18064,0.0,0.0,0.0,3611,74888,54165,-20723
18065,0.0,0.0,0.0,3611,74892,54165,-20727
18066,0.0,0.0,0.0,3611,74896,54165,-20731
18067,0.0,0.0,0.0,3611,74900,54165,-20735
18068,0.0,0.0,0.0,3611,74904,54165,-20739
18070,0.0,0.0,0.0,3611,74908,54165,-20743
18071,0.0,0.0,0.0,3611,74912,54165,-20747
18072,0.0,0.0,0.0,3611,74916,54165,-20751
18073,0.0,0.0,0.0,3611,74920,54165,-20755
18074,0.0,0.0,0.0,3611,74924,54165,-20759
18075,0.0,0.0,0.0,3611,74928,54165,-20763
18076,0.0,0.0,0.0,3611,74932,54165,-20767
18077,0.0,0.0,0.0,3611,74936,54165,-20771
18078,0.0,0.0,0.0,3611,74940,54165,-20775
18079,0.0,0.0,0.0,3611,74944,54165,-20779
18080,0.0,0.0,0.0,3611,74948,54165,-20783
18081,0.0,0.0,0.0,3611,74952,54165,-20787
18082,0.0,0.0,0.0,3611,74956,54165,-20791
18083,0.0,0.0,0.0,3611,74960,54165,-20795
18084,0.0,0.0,0.0,3611,74964,54165,-20799
18085,0.0,0.0,0.0,3611,74968,54165,-20803
18086,0.0,0.0,0.0,3611,74972,54165,-20807
18087,0.0,0.0,0.0,3611,74976,54165,-20811
18088,0.0,0.0,0.0,3611,74980,54165,-20815
18089,0.0,0.0,0.0,3611,74984,54165,-20819
18091,0.0,0.0,0.0,3611,74988,54165,-20823
18092,0.0,0.0,0.0,3611,74992,54165,-20827
18093,0.0,0.0,0.0,3611,74996,54165,-20831
18094,0.0,0.0,0.0,3611,75000,54165,-20835
18095,0.0,0.0,0.0,3611,75004,54165,-20839
18096,0.0,0.0,0.0,3611,75008,54165,-20843
18098,0.0,0.0,0.0,3611,75012,54165,-20847
18099,0.0,0.0,0.0,3611,75016,54165,-20851
18100,0.0,0.0,0.0,3611,75020,54165,-20855
18101,0.0,0.0,0.0,3611,75024,54165,-20859
18102,0.0,0.0,0.0,3611,75028,54165,-20863
18103,0.0,0.0,0.0,3611,75032,54165,-20867
18104,0.0,0.0,0.0,3611,75036,54165,-20871
18105,0.0,0.0,0.0,3611,75040,54165,-20875
18106,0.0,0.0,0.0,3611,75044,54165,-20879
18107,0.0,0.0,0.0,3611,75048,54165,-20883
18109,0.0,0.0,0.0,3611,75052,54165,-20887
18110,0.0,0.0,0.0,3611,75056,54165,-20891
18111,0.0,0.0,0.0,3611,75060,54165,-20895
18112,0.0,0.0,0.0,3611,75064,54165,-20899
18113,0.0,0.0,0.0,3611,75068,54165,-20903
18114,0.0,0.0,0.0,3611,75072,54165,-20907
18115,0.0,0.0,0.0,3611,75076,54165,-20911
18116,0.0,0.0,0.0,3611,75080,54165,-20915
18117,0.0,0.0,0.0,3611,75084,54165,-20919
18118,0.0,0.0,0.0,3611,75088,54165,-20923
18119,0.0,0.0,0.0,3611,75092,54165,-20927
18120,0.0,0.0,0.0,3611,75096,54165,-20931
18122,0.0,0.0,0.0,3611,75100,54165,-20935
18124,0.0,0.0,0.0,3611,75104,54165,-20939
18125,0.0,0.0,0.0,3611,75108,54165,-20943
18126,0.0,0.0,0.0,3611,75112,54165,-20947
18127,0.0,0.0,0.0,3611,75116,54165,-20951
18128,0.0,0.0,0.0,3611,75120,54165,-20955
18129,0.0,0.0,0.0,3611,75124,54165,-20959
18130,0.0,0.0,0.0,3611,75128,54165,-20963
18131,0.0,0.0,0.0,3611,75132,54165,-20967
18132,0.0,0.0,0.0,3611,75136,54165,-20971
18134,0.0,0.0,0.0,3611,75140,54165,-20975
18135,0.0,0.0,0.0,3611,75144,54165,-20979
18136,0.0,0.0,0.0,3611,75148,54165,-20983
18137,0.0,0.0,0.0,3611,75152,54165,-20987
18138,0.0,0.0,0.0,3611,75156,54165,-20991
18139,0.0,0.0,0.0,3611,75160,54165,-20995
18140,0.0,0.0,0.0,3611,75164,54165,-20999
18141,0.0,0.0,0.0,3611,75168,54165,-21003
18142,0.0,0.0,0.0,3611,75172,54165,-21007
18143,0.0,0.0,0.0,3611,75176,54165,-21011
18144,0.0,0.0,0.0,3611,75180,54165,-21015
18146,0.0,0.0,0.0,3611,75184,54165,-21019
18148,0.0,0.0,0.0,3611,75188,54165,-21023
18149,0.0,0.0,0.0,3611,75192,54165,-21027
18150,0.0,0.0,0.0,3611,75196,54165,-21031
18151,0.0,0.0,0.0,3611,75200,54165,-21035
18152,0.0,0.0,0.0,3611,75204,54165,-21039
18153,0.0,0.0,0.0,3611,75208,54165,-21043
18154,0.0,0.0,0.0,3611,75212,54165,-21047
18155,0.0,0.0,0.0,3611,75216,54165,-21051
18156,0.0,0.0,0.0,3611,75220,54165,-21055
18157,0.0,0.0,0.0,3611,75224,54165,-21059
18158,0.0,0.0,0.0,3611,75228,54165,-21063
18159,0.0,0.0,0.0,3611,75232,54165,-21067
18160,0.0,0.0,0.0,3611,75236,54165,-21071
18161,0.0,0.0,0.0,3611,75240,54165,-21075
18162,0.0,0.0,0.0,3611,75244,54165,-21079
18163,0.0,0.0,0.0,3611,75248,54165,-21083
18164,0.0,0.0,0.0,3611,75252,54165,-21087
18165,0.0,0.0,0.0,3611,75256,54165,-21091
18166,0.0,0.0,0.0,3611,75260,54165,-21095
18167,0.0,0.0,0.0,3611,75264,54165,-21099
18168,0.0,0.0,0.0,3611,75268,54165,-21103
18170,0.0,0.0,0.0,3611,75272,54165,-21107
18171,0.0,0.0,0.0,3611,75276,54165,-21111
18172,0.0,0.0,0.0,3611,75280,54165,-21115
18173,0.0,0.0,0.0,3611,75284,54165,-21119
18174,0.0,0.0,0.0,3611,75288,54165,-21123
18175,0.0,0.0,0.0,3611,75292,54165,-21127
18177,0.0,0.0,0.0,3611,75296,54165,-21131
18180,0.0,0.0,0.0,3611,75300,54165,-21135
18181,0.0,0.0,0.0,3611,75304,54165,-21139
18182,0.0,0.0,0.0,3611,75308,54165,-21143
18184,0.0,0.0,0.0,3611,75312,54165,-21147
18185,0.0,0.0,0.0,3611,75316,54165,-21151
18186,0.0,0.0,0.0,3611,75320,54165,-21155
18187,0.0,0.0,0.0,3611,75324,54165,-21159
18188,0.0,0.0,0.0,3611,75328,54165,-21163
18189,0.0,0.0,0.0,3611,75332,54165,-21167
18190,0.0,0.0,0.0,3611,75336,54165,-21171
18191,0.0,0.0,0.0,3611,75340,54165,-21175
18192,0.0,0.0,0.0,3611,75344,54165,-21179
18193,0.0,0.0,0.0,3611,75348,54165,-21183
18194,0.0,0.0,0.0,3611,75352,54165,-21187
18195,0.0,0.0,0.0,3611,75356,54165,-21191
18196,0.0,0.0,0.0,3611,75360,54165,-21195
18197,0.0,0.0,0.0,3611,75364,54165,-21199
18198,0.0,0.0,0.0,3611,75368,54165,-21203
18199,0.0,0.0,0.0,3611,75372,54165,-21207
18201,0.0,0.0,0.0,3611,75376,54165,-21211
18203,0.0,0.0,0.0,3611,75380,54165,-21215
18204,0.0,0.0,0.0,3611,75384,54165,-21219
18205,0.0,0.0,0.0,3611,75388,54165,-21223
18206,0.0,0.0,0.0,3611,75392,54165,-21227
18207,0.0,0.0,0.0,3611,75396,54165,-21231
18208,0.0,0.0,0.0,3611,75400,54165,-21235
18209,0.0,0.0,0.0,3611,75404,54165,-21239
18210,0.0,0.0,0.0,3611,75408,54165,-21243
18211,0.0,0.0,0.0,3611,75412,54165,-21247
18213,0.0,0.0,0.0,3611,75416,54165,-21251
18214,0.0,0.0,0.0,3611,75420,54165,-21255
18217,0.0,0.0,0.0,3611,75424,54165,-21259
18218,0.0,0.0,0.0,3611,75428,54165,-21263
18219,0.0,0.0,0.0,3611,75432,54165,-21267
18220,0.0,0.0,0.0,3611,75436,54165,-21271
18221,0.0,0.0,0.0,3611,75440,54165,-21275
18222,0.0,0.0,0.0,3611,75444,54165,-21279
18223,0.0,0.0,0.0,3611,75448,54165,-21283
18224,0.0,0.0,0.0,3611,75452,54165,-21287
18225,0.0,0.0,0.0,3611,75456,54165,-21291
18226,0.0,0.0,0.0,3611,75460,54165,-21295
18227,0.0,0.0,0.0,3611,75464,54165,-21299
18228,0.0,0.0,0.0,3611,75468,54165,-21303
18229,0.0,0.0,0.0,3611,75472,54165,-21307
18230,0.0,0.0,0.0,3611,75476,54165,-21311
18231,0.0,0.0,0.0,3611,75480,54165,-21315
18232,0.0,0.0,0.0,3611,75484,54165,-21319
18233,0.0,0.0,0.0,3611,75488,54165,-21323
18235,0.0,0.0,0.0,3611,75492,54165,-21327
18236,0.0,0.0,0.0,3611,75496,54165,-21331
18238,0.0,0.0,0.0,3611,75500,54165,-21335
18239,0.0,0.0,0.0,3611,75504,54165,-21339
18240,0.0,0.0,0.0,3611,75508,54165,-21343
18241,0.0,0.0,0.0,3611,75512,54165,-21347
18242,0.0,0.0,0.0,3611,75516,54165,-21351
18243,0.0,0.0,0.0,3611,75520,54165,-21355
18244,0.0,0.0,0.0,3611,75524,54165,-21359
18245,0.0,0.0,0.0,3611,75528,54165,-21363
18246,0.0,0.0,0.0,3611,75532,54165,-21367
18247,0.0,0.0,0.0,3611,75536,54165,-21371
18248,0.0,0.0,0.0,3611,75540,54165,-21375
18249,0.0,0.0,0.0,3611,75544,54165,-21379
18250,0.0,0.0,0.0,3611,75548,54165,-21383
18251,0.0,0.0,0.0,3611,75552,54165,-21387
18252,0.0,0.0,0.0,3611,75556,54165,-21391
18253,0.0,0.0,0.0,3611,75560,54165,-21395
18255,0.0,0.0,0.0,3611,75564,54165,-21399
18257,0.0,0.0,0.0,3611,75568,54165,-21403
18259,0.0,0.0,0.0,3611,75572,54165,-21407
18260,0.0,0.0,0.0,3611,75576,54165,-21411
18261,0.0,0.0,0.0,3611,75580,54165,-21415
18262,0.0,0.0,0.0,3611,75584,54165,-21419
18265,0.0,0.0,0.0,3611,75588,54165,-21423
18267,0.0,0.0,0.0,3611,75592,54165,-21427
18268,0.0,0.0,0.0,3611,75596,54165,-21431
18269,0.0,0.0,0.0,3611,75600,54165,-21435
18270,0.0,0.0,0.0,3611,75604,54165,-21439
18271,0.0,0.0,0.0,3611,75608,54165,-21443
18272,0.0,0.0,0.0,3611,75612,54165,-21447
18274,0.0,0.0,0.0,3611,75616,54165,-21451
18275,0.0,0.0,0.0,3611,75620,54165,-21455
18276,0.0,0.0,0.0,3611,75624,54165,-21459
18277,0.0,0.0,0.0,3611,75628,54165,-21463
18278,0.0,0.0,0.0,3611,75632,54165,-21467
18280,0.0,0.0,0.0,3611,75636,54165,-21471
18282,0.0,0.0,0.0,3611,75640,54165,-21475
18284,0.0,0.0,0.0,3611,75644,54165,-21479
18286,0.0,0.0,0.0,3611,75648,54165,-21483
18287,0.0,0.0,0.0,3611,75652,54165,-21487
18289,0.0,0.0,0.0,3611,75656,54165,-21491
18290,0.0,0.0,0.0,3611,75660,54165,-21495
18291,0.0,0.0,0.0,3611,75664,54165,-21499
18292,0.0,0.0,0.0,3611,75668,54165,-21503
18293,0.0,0.0,0.0,3611,75672,54165,-21507
18294,0.0,0.0,0.0,3611,75676,54165,-21511
18295,0.0,0.0,0.0,3611,75680,54165,-21515
18296,0.0,0.0,0.0,3611,75684,54165,-21519
18297,0.0,0.0,0.0,3611,75688,54165,-21523
18298,0.0,0.0,0.0,3611,75692,54165,-21527
18300,0.0,0.0,0.0,3611,75696,54165,-21531
18301,0.0,0.0,0.0,3611,75700,54165,-21535
18302,0.0,0.0,0.0,3611,75704,54165,-21539
18303,0.0,0.0,0.0,3611,75708,54165,-21543
18304,0.0,0.0,0.0,3611,75712,54165,-21547
18306,0.0,0.0,0.0,3611,75716,54165,-21551
18307,0.0,0.0,0.0,3611,75720,54165,-21555
18308,0.0,0.0,0.0,3611,75724,54165,-21559
18309,0.0,0.0,0.0,3611,75728,54165,-21563
18310,0.0,0.0,0.0,3611,75732,54165,-21567
18311,0.0,0.0,0.0,3611,75736,54165,-21571
18312,0.0,0.0,0.0,3611,75740,54165,-21575
18313,0.0,0.0,0.0,3611,75744,54165,-21579
18314,0.0,0.0,0.0,3611,75748,54165,-21583
18315,0.0,0.0,0.0,3611,75752,54165,-21587
18318,0.0,0.0,0.0,3611,75756,54165,-21591
18319,0.0,0.0,0.0,3611,75760,54165,-21595
18320,0.0,0.0,0.0,3611,75764,54165,-21599
18321,0.0,0.0,0.0,3611,75768,54165,-21603
18323,0.0,0.0,0.0,3611,75772,54165,-21607
18324,0.0,0.0,0.0,3611,75776,54165,-21611
18325,0.0,0.0,0.0,3611,75780,54165,-21615
18326,0.0,0.0,0.0,3611,75784,54165,-21619
18327,0.0,0.0,0.0,3611,75788,54165,-21623
18329,0.0,0.0,0.0,3611,75792,54165,-21627
18330,0.0,0.0,0.0,3611,75796,54165,-21631
18331,0.0,0.0,0.0,3611,75800,54165,-21635
18332,0.0,0.0,0.0,3611,75804,54165,-21639
18335,0.0,0.0,0.0,3611,75808,54165,-21643
18336,0.0,0.0,0.0,3611,75812,54165,-21647
18337,0.0,0.0,0.0,3611,75816,54165,-21651
18338,0.0,0.0,0.0,3611,75820,54165,-21655
18339,0.0,0.0,0.0,3611,75824,54165,-21659
18340,0.0,0.0,0.0,3611,75828,54165,-21663
18342,0.0,0.0,0.0,3611,75832,54165,-21667
18343,0.0,0.0,0.0,3611,75836,54165,-21671
18344,0.0,0.0,0.0,3611,75840,54165,-21675
18345,0.0,0.0,0.0,3611,75844,54165,-21679
18346,0.0,0.0,0.0,3611,75848,54165,-21683
18348,0.0,0.0,0.0,3611,75852,54165,-21687
18350,0.0,0.0,0.0,3611,75856,54165,-21691
18351,0.0,0.0,0.0,3611,75860,54165,-21695
18352,0.0,0.0,0.0,3611,75864,54165,-21699
18353,0.0,0.0,0.0,3611,75868,54165,-21703
18354,0.0,0.0,0.0,3611,75872,54165,-21707
18355,0.0,0.0,0.0,3611,75876,54165,-21711
18356,0.0,0.0,0.0,3611,75880,54165,-21715
18357,0.0,0.0,0.0,3611,75884,54165,-21719
18358,0.0,0.0,0.0,3611,75888,54165,-21723
18359,0.0,0.0,0.0,3611,75892,54165,-21727
18360,0.0,0.0,0.0,3611,75896,54165,-21731
18361,0.0,0.0,0.0,3611,75900,54165,-21735
18362,0.0,0.0,0.0,3611,75904,54165,-21739
18364,0.0,0.0,0.0,3611,75908,54165,-21743
18365,0.0,0.0,0.0,3611,75912,54165,-21747
18367,0.0,0.0,0.0,3611,75916,54165,-21751
18368,0.0,0.0,0.0,3611,75920,54165,-21755
18369,0.0,0.0,0.0,3611,75924,54165,-21759
18370,0.0,0.0,0.0,3611,75928,54165,-21763
18371,0.0,0.0,0.0,3611,75932,54165,-21767
18372,0.0,0.0,0.0,3611,75936,54165,-21771
18373,0.0,0.0,0.0,3611,75940,54165,-21775
18374,0.0,0.0,0.0,3611,75944,54165,-21779
18375,0.0,0.0,0.0,3611,75948,54165,-21783
18377,0.0,0.0,0.0,3611,75952,54165,-21787
18378,0.0,0.0,0.0,3611,75956,54165,-21791
18379,0.0,0.0,0.0,3611,75960,54165,-21795
18380,0.0,0.0,0.0,3611,75964,54165,-21799
18382,0.0,0.0,0.0,3611,75968,54165,-21803
18384,0.0,0.0,0.0,3611,75972,54165,-21807
18385,0.0,0.0,0.0,3611,75976,54165,-21811
18386,0.0,0.0,0.0,3611,75980,54165,-21815
18387,0.0,0.0,0.0,3611,75984,54165,-21819
18388,0.0,0.0,0.0,3611,75988,54165,-21823
18390,0.0,0.0,0.0,3611,75992,54165,-21827
18391,0.0,0.0,0.0,3611,75996,54165,-21831
18392,0.0,0.0,0.0,3611,76000,54165,-21835
18393,0.0,0.0,0.0,3611,76004,54165,-21839
18395,0.0,0.0,0.0,3611,76008,54165,-21843
18397,0.0,0.0,0.0,3611,76012,54165,-21847
18398,0.0,0.0,0.0,3611,76016,54165,-21851
18399,0.0,0.0,0.0,3611,76020,54165,-21855
18400,0.0,0.0,0.0,3611,76024,54165,-21859
18402,0.0,0.0,0.0,3611,76028,54165,-21863
18403,0.0,0.0,0.0,3611,76032,54165,-21867
18404,0.0,0.0,0.0,3611,76036,54165,-21871
18405,0.0,0.0,0.0,3611,76040,54165,-21875
18406,0.0,0.0,0.0,3611,76044,54165,-21879
18407,0.0,0.0,0.0,3611,76048,54165,-21883
18408,0.0,0.0,0.0,3611,76052,54165,-21887
18409,0.0,0.0,0.0,3611,76056,54165,-21891
18410,0.0,0.0,0.0,3611,76060,54165,-21895
18412,0.0,0.0,0.0,3611,76064,54165,-21899
18413,0.0,0.0,0.0,3611,76068,54165,-21903
18414,0.0,0.0,0.0,3611,76072,54165,-21907
18415,0.0,0.0,0.0,3611,76076,54165,-21911
18416,0.0,0.0,0.0,3611,76080,54165,-21915
18417,0.0,0.0,0.0,3611,76084,54165,-21919
18418,0.0,0.0,0.0,3611,76088,54165,-21923
18420,0.0,0.0,0.0,3611,76092,54165,-21927
18421,0.0,0.0,0.0,3611,76096,54165,-21931
18422,0.0,0.0,0.0,3611,76100,54165,-21935
18423,0.0,0.0,0.0,3611,76104,54165,-21939
18424,0.0,0.0,0.0,3611,76108,54165,-21943
18425,0.0,0.0,0.0,3611,76112,54165,-21947
18426,0.0,0.0,0.0,3611,76116,54165,-21951
18427,0.0,0.0,0.0,3611,76120,54165,-21955
18428,0.0,0.0,0.0,3611,76124,54165,-21959
18429,0.0,0.0,0.0,3611,76128,54165,-21963
18430,0.0,0.0,0.0,3611,76132,54165,-21967
18431,0.0,0.0,0.0,3611,76136,54165,-21971
18433,0.0,0.0,0.0,3611,76140,54165,-21975
18434,0.0,0.0,0.0,3611,76144,54165,-21979
18435,0.0,0.0,0.0,3611,76148,54165,-21983
18436,0.0,0.0,0.0,3611,76152,54165,-21987
18437,0.0,0.0,0.0,3611,76156,54165,-21991
18438,0.0,0.0,0.0,3611,76160,54165,-21995
18439,0.0,0.0,0.0,3611,76164,54165,-21999
18440,0.0,0.0,0.0,3611,76168,54165,-22003
18441,0.0,0.0,0.0,3611,76172,54165,-22007
18443,0.0,0.0,0.0,3611,76176,54165,-22011
18444,0.0,0.0,0.0,3611,76180,54165,-22015
18445,0.0,0.0,0.0,3611,76184,54165,-22019
18446,0.0,0.0,0.0,3611,76188,54165,-22023
18447,0.0,0.0,0.0,3611,76192,54165,-22027
18448,0.0,0.0,0.0,3611,76196,54165,-22031
18449,0.0,0.0,0.0,3611,76200,54165,-22035
18450,0.0,0.0,0.0,3611,76204,54165,-22039
18452,0.0,0.0,0.0,3611,76208,54165,-22043
18453,0.0,0.0,0.0,3611,76212,54165,-22047
18454,0.0,0.0,0.0,3611,76216,54165,-22051
18455,0.0,0.0,0.0,3611,76220,54165,-22055
18456,0.0,0.0,0.0,3611,76224,54165,-22059
18457,0.0,0.0,0.0,3611,76228,54165,-22063
18458,0.0,0.0,0.0,3611,76232,54165,-22067
18459,0.0,0.0,0.0,3611,76236,54165,-22071
18460,0.0,0.0,0.0,3611,76240,54165,-22075
18463,0.0,0.0,0.0,3611,76244,54165,-22079
18464,0.0,0.0,0.0,3611,76248,54165,-22083
18465,0.0,0.0,0.0,3611,76252,54165,-22087
18466,0.0,0.0,0.0,3611,76256,54165,-22091
18467,0.0,0.0,0.0,3611,76260,54165,-22095
18468,0.0,0.0,0.0,3611,76264,54165,-22099
18469,0.0,0.0,0.0,3611,76268,54165,-22103
18470,0.0,0.0,0.0,3611,76272,54165,-22107
18471,0.0,0.0,0.0,3611,76276,54165,-22111
18472,0.0,0.0,0.0,3611,76280,54165,-22115
18473,0.0,0.0,0.0,3611,76284,54165,-22119
18476,0.0,0.0,0.0,3611,76288,54165,-22123
18477,0.0,0.0,0.0,3611,76292,54165,-22127
18478,0.0,0.0,0.0,3611,76296,54165,-22131
18479,0.0,0.0,0.0,3611,76300,54165,-22135
18480,0.0,0.0,0.0,3611,76304,54165,-22139
18485,0.0,0.0,0.0,3611,76308,54165,-22143
18486,0.0,0.0,0.0,3611,76312,54165,-22147
18487,0.0,0.0,0.0,3611,76316,54165,-22151
18488,0.0,0.0,0.0,3611,76320,54165,-22155
18490,0.0,0.0,0.0,3611,76324,54165,-22159
18491,0.0,0.0,0.0,3611,76328,54165,-22163
18492,0.0,0.0,0.0,3611,76332,54165,-22167
18493,0.0,0.0,0.0,3611,76336,54165,-22171
18494,0.0,0.0,0.0,3611,76340,54165,-22175
18495,0.0,0.0,0.0,3611,76344,54165,-22179
18496,0.0,0.0,0.0,3611,76348,54165,-22183
18498,0.0,0.0,0.0,3611,76352,54165,-22187
18499,0.0,0.0,0.0,3611,76356,54165,-22191
18500,0.0,0.0,0.0,3611,76360,54165,-22195
18501,0.0,0.0,0.0,3611,76364,54165,-22199
18502,0.0,0.0,0.0,3611,76368,54165,-22203
18503,0.0,0.0,0.0,3611,76372,54165,-22207
18504,0.0,0.0,0.0,3611,76376,54165,-22211
18505,0.0,0.0,0.0,3611,76380,54165,-22215
18506,0.0,0.0,0.0,3611,76384,54165,-22219
18507,0.0,0.0,0.0,3611,76388,54165,-22223
18508,0.0,0.0,0.0,3611,76392,54165,-22227
18509,0.0,0.0,0.0,3611,76396,54165,-22231
18510,0.0,0.0,0.0,3611,76400,54165,-22235
18511,0.0,0.0,0.0,3611,76404,54165,-22239
18512,0.0,0.0,0.0,3611,76408,54165,-22243
18513,0.0,0.0,0.0,3611,76412,54165,-22247
18514,0.0,0.0,0.0,3611,76416,54165,-22251
18515,0.0,0.0,0.0,3611,76420,54165,-22255
18516,0.0,0.0,0.0,3611,76424,54165,-22259
18517,0.0,0.0,0.0,3611,76428,54165,-22263
18518,0.0,0.0,0.0,3611,76432,54165,-22267
18519,0.0,0.0,0.0,3611,76436,54165,-22271
18520,0.0,0.0,0.0,3611,76440,54165,-22275
18521,0.0,0.0,0.0,3611,76444,54165,-22279
18522,0.0,0.0,0.0,3611,76448,54165,-22283
18523,0.0,0.0,0.0,3611,76452,54165,-22287
18524,0.0,0.0,0.0,3611,76456,54165,-22291
18525,0.0,0.0,0.0,3611,76460,54165,-22295
18527,0.0,0.0,0.0,3611,76464,54165,-22299
18528,0.0,0.0,0.0,3611,76468,54165,-22303
18529,0.0,0.0,0.0,3611,76472,54165,-22307
18530,0.0,0.0,0.0,3611,76476,54165,-22311
18532,0.0,0.0,0.0,3611,76480,54165,-22315
18533,0.0,0.0,0.0,3611,76484,54165,-22319
18534,0.0,0.0,0.0,3611,76488,54165,-22323
18535,0.0,0.0,0.0,3611,76492,54165,-22327
18536,0.0,0.0,0.0,3611,76496,54165,-22331
18537,0.0,0.0,0.0,3611,76500,54165,-22335
18540,0.0,0.0,0.0,3611,76504,54165,-22339
18541,0.0,0.0,0.0,3611,76508,54165,-22343
18542,0.0,0.0,0.0,3611,76512,54165,-22347
18543,0.0,0.0,0.0,3611,76516,54165,-22351
18544,0.0,0.0,0.0,3611,76520,54165,-22355
18545,0.0,0.0,0.0,3611,76524,54165,-22359
18546,0.0,0.0,0.0,3611,76528,54165,-22363
18547,0.0,0.0,0.0,3611,76532,54165,-22367
18548,0.0,0.0,0.0,3611,76536,54165,-22371
18550,0.0,0.0,0.0,3611,76540,54165,-22375
18551,0.0,0.0,0.0,3611,76544,54165,-22379
18552,0.0,0.0,0.0,3611,76548,54165,-22383
18553,0.0,0.0,0.0,3611,76552,54165,-22387
18554,0.0,0.0,0.0,3611,76556,54165,-22391
18555,0.0,0.0,0.0,3611,76560,54165,-22395
18556,0.0,0.0,0.0,3611,76564,54165,-22399
18557,0.0,0.0,0.0,3611,76568,54165,-22403
18558,0.0,0.0,0.0,3611,76572,54165,-22407
18559,0.0,0.0,0.0,3611,76576,54165,-22411
18560,0.0,0.0,0.0,3611,76580,54165,-22415
18561,0.0,0.0,0.0,3611,76584,54165,-22419
18562,0.0,0.0,0.0,3611,76588,54165,-22423
18563,0.0,0.0,0.0,3611,76592,54165,-22427
18564,0.0,0.0,0.0,3611,76596,54165,-22431
18566,0.0,0.0,0.0,3611,76600,54165,-22435
18567,0.0,0.0,0.0,3611,76604,54165,-22439
18569,0.0,0.0,0.0,3611,76608,54165,-22443
18570,0.0,0.0,0.0,3611,76612,54165,-22447
18571,0.0,0.0,0.0,3611,76616,54165,-22451
18572,0.0,0.0,0.0,3611,76620,54165,-22455
18573,0.0,0.0,0.0,3611,76624,54165,-22459
18574,0.0,0.0,0.0,3611,76628,54165,-22463
18575,0.0,0.0,0.0,3611,76632,54165,-22467
18576,0.0,0.0,0.0,3611,76636,54165,-22471
18577,0.0,0.0,0.0,3611,76640,54165,-22475
18578,0.0,0.0,0.0,3611,76644,54165,-22479
18579,0.0,0.0,0.0,3611,76648,54165,-22483
18581,0.0,0.0,0.0,3611,76652,54165,-22487
18582,0.0,0.0,0.0,3611,76656,54165,-22491
18583,0.0,0.0,0.0,3611,76660,54165,-22495
18584,0.0,0.0,0.0,3611,76664,54165,-22499
18585,0.0,0.0,0.0,3611,76668,54165,-22503
18586,0.0,0.0,0.0,3611,76672,54165,-22507
18587,0.0,0.0,0.0,3611,76676,54165,-22511
18588,0.0,0.0,0.0,3611,76680,54165,-22515
18589,0.0,0.0,0.0,3611,76684,54165,-22519
18590,0.0,0.0,0.0,3611,76688,54165,-22523
18591,0.0,0.0,0.0,3611,76692,54165,-22527
18592,0.0,0.0,0.0,3611,76696,54165,-22531
18593,0.0,0.0,0.0,3611,76700,54165,-22535
18594,0.0,0.0,0.0,3611,76704,54165,-22539
18595,0.0,0.0,0.0,3611,76708,54165,-22543
18596,0.0,0.0,0.0,3611,76712,54165,-22547
18597,0.0,0.0,0.0,3611,76716,54165,-22551
18600,0.0,0.0,0.0,3611,76720,54165,-22555
18602,0.0,0.0,0.0,3611,76724,54165,-22559
18604,0.0,0.0,0.0,3611,76728,54165,-22563
18605,0.0,0.0,0.0,3611,76732,54165,-22567
18606,0.0,0.0,0.0,3611,76736,54165,-22571
18607,0.0,0.0,0.0,3611,76740,54165,-22575
18610,0.0,0.0,0.0,3611,76744,54165,-22579
18611,0.0,0.0,0.0,3611,76748,54165,-22583
18612,0.0,0.0,0.0,3611,76752,54165,-22587
18613,0.0,0.0,0.0,3611,76756,54165,-22591
18614,0.0,0.0,0.0,3611,76760,54165,-22595
18616,0.0,0.0,0.0,3611,76764,54165,-22599
18617,0.0,0.0,0.0,3611,76768,54165,-22603
18618,0.0,0.0,0.0,3611,76772,54165,-22607
18619,0.0,0.0,0.0,3611,76776,54165,-22611
18620,0.0,0.0,0.0,3611,76780,54165,-22615
18621,0.0,0.0,0.0,3611,76784,54165,-22619
18623,0.0,0.0,0.0,3611,76788,54165,-22623
18625,0.0,0.0,0.0,3611,76792,54165,-22627
18627,0.0,0.0,0.0,3611,76796,54165,-22631
18628,0.0,0.0,0.0,3611,76800,54165,-22635
18629,0.0,0.0,0.0,3611,76804,54165,-22639
18631,0.0,0.0,0.0,3611,76808,54165,-22643
18632,0.0,0.0,0.0,3611,76812,54165,-22647
18633,0.0,0.0,0.0,3611,76816,54165,-22651
18634,0.0,0.0,0.0,3611,76820,54165,-22655
18636,0.0,0.0,0.0,3611,76824,54165,-22659
18637,0.0,0.0,0.0,3611,76828,54165,-22663
18638,0.0,0.0,0.0,3611,76832,54165,-22667
18639,0.0,0.0,0.0,3611,76836,54165,-22671
18640,0.0,0.0,0.0,3611,76840,54165,-22675
18641,0.0,0.0,0.0,3611,76844,54165,-22679
18643,0.0,0.0,0.0,3611,76848,54165,-22683
18644,0.0,0.0,0.0,3611,76852,54165,-22687
18645,0.0,0.0,0.0,3611,76856,54165,-22691
18646,0.0,0.0,0.0,3611,76860,54165,-22695
18647,0.0,0.0,0.0,3611,76864,54165,-22699
18648,0.0,0.0,0.0,3611,76868,54165,-22703
18649,0.0,0.0,0.0,3611,76872,54165,-22707
18650,0.0,0.0,0.0,3611,76876,54165,-22711
18651,0.0,0.0,0.0,3611,76880,54165,-22715
18652,0.0,0.0,0.0,3611,76884,54165,-22719
18653,0.0,0.0,0.0,3611,76888,54165,-22723
18654,0.0,0.0,0.0,3611,76892,54165,-22727
18655,0.0,0.0,0.0,3611,76896,54165,-22731
18656,0.0,0.0,0.0,3611,76900,54165,-22735
18657,0.0,0.0,0.0,3611,76904,54165,-22739
18658,0.0,0.0,0.0,3611,76908,54165,-22743
18659,0.0,0.0,0.0,3611,76912,54165,-22747
18660,0.0,0.0,0.0,3611,76916,54165,-22751
18661,0.0,0.0,0.0,3611,76920,54165,-22755
18662,0.0,0.0,0.0,3611,76924,54165,-22759
18663,0.0,0.0,0.0,3611,76928,54165,-22763
18664,0.0,0.0,0.0,3611,76932,54165,-22767
18665,0.0,0.0,0.0,3611,76936,54165,-22771
18668,0.0,0.0,0.0,3611,76940,54165,-22775
18669,0.0,0.0,0.0,3611,76944,54165,-22779
18670,0.0,0.0,0.0,3611,76948,54165,-22783
18671,0.0,0.0,0.0,3611,76952,54165,-22787
18673,0.0,0.0,0.0,3611,76956,54165,-22791
18674,0.0,0.0,0.0,3611,76960,54165,-22795
18675,0.0,0.0,0.0,3611,76964,54165,-22799
18676,0.0,0.0,0.0,3611,76968,54165,-22803
18677,0.0,0.0,0.0,3611,76972,54165,-22807
18679,0.0,0.0,0.0,3611,76976,54165,-22811
18680,0.0,0.0,0.0,3611,76980,54165,-22815
18682,0.0,0.0,0.0,3611,76984,54165,-22819
18683,0.0,0.0,0.0,3611,76988,54165,-22823
18684,0.0,0.0,0.0,3611,76992,54165,-22827
18685,0.0,0.0,0.0,3611,76996,54165,-22831
18686,0.0,0.0,0.0,3611,77000,54165,-22835
18687,0.0,0.0,0.0,3611,77004,54165,-22839
18688,0.0,0.0,0.0,3611,77008,54165,-22843
18689,0.0,0.0,0.0,3611,77012,54165,-22847
18690,0.0,0.0,0.0,3611,77016,54165,-22851
18691,0.0,0.0,0.0,3611,77020,54165,-22855
18692,0.0,0.0,0.0,3611,77024,54165,-22859
18693,0.0,0.0,0.0,3611,77028,54165,-22863
18694,0.0,0.0,0.0,3611,77032,54165,-22867
18695,0.0,0.0,0.0,3611,77036,54165,-22871
18697,0.0,0.0,0.0,3611,77040,54165,-22875
18698,0.0,0.0,0.0,3611,77044,54165,-22879
18700,0.0,0.0,0.0,3611,77048,54165,-22883
18701,0.0,0.0,0.0,3611,77052,54165,-22887
18703,0.0,0.0,0.0,3611,77056,54165,-22891
18704,0.0,0.0,0.0,3611,77060,54165,-22895
18705,0.0,0.0,0.0,3611,77064,54165,-22899
18706,0.0,0.0,0.0,3611,77068,54165,-22903
18709,0.0,0.0,0.0,3611,77072,54165,-22907
18710,0.0,0.0,0.0,3611,77076,54165,-22911
18711,0.0,0.0,0.0,3611,77080,54165,-22915
18712,0.0,0.0,0.0,3611,77084,54165,-22919
18713,0.0,0.0,0.0,3611,77088,54165,-22923
18714,0.0,0.0,0.0,3611,77092,54165,-22927
18715,0.0,0.0,0.0,3611,77096,54165,-22931
18717,0.0,0.0,0.0,3611,77100,54165,-22935
18718,0.0,0.0,0.0,3611,77104,54165,-22939
18719,0.0,0.0,0.0,3611,77108,54165,-22943
18720,0.0,0.0,0.0,3611,77112,54165,-22947
18724,0.0,0.0,0.0,3611,77116,54165,-22951
18726,0.0,0.0,0.0,3611,77120,54165,-22955
18727,0.0,0.0,0.0,3611,77124,54165,-22959
18728,0.0,0.0,0.0,3611,77128,54165,-22963
18729,0.0,0.0,0.0,3611,77132,54165,-22967
18730,0.0,0.0,0.0,3611,77136,54165,-22971
18731,0.0,0.0,0.0,3611,77140,54165,-22975
18732,0.0,0.0,0.0,3611,77144,54165,-22979
18733,0.0,0.0,0.0,3611,77148,54165,-22983
18735,0.0,0.0,0.0,3611,77152,54165,-22987
18736,0.0,0.0,0.0,3611,77156,54165,-22991
18737,0.0,0.0,0.0,3611,77160,54165,-22995
18740,0.0,0.0,0.0,3611,77164,54165,-22999
18741,0.0,0.0,0.0,3611,77168,54165,-23003
18743,0.0,0.0,0.0,3611,77172,54165,-23007
18744,0.0,0.0,0.0,3611,77176,54165,-23011
18745,0.0,0.0,0.0,3611,77180,54165,-23015
18747,0.0,0.0,0.0,3611,77184,54165,-23019
18748,0.0,0.0,0.0,3611,77188,54165,-23023
18751,0.0,0.0,0.0,3611,77192,54165,-23027
18752,0.0,0.0,0.0,3611,77196,54165,-23031
18753,0.0,0.0,0.0,3611,77200,54165,-23035
18755,0.0,0.0,0.0,3611,77204,54165,-23039
18756,0.0,0.0,0.0,3611,77208,54165,-23043
18757,0.0,0.0,0.0,3611,77212,54165,-23047
18758,0.0,0.0,0.0,3611,77216,54165,-23051
18759,0.0,0.0,0.0,3611,77220,54165,-23055
18760,0.0,0.0,0.0,3611,77224,54165,-23059
18762,0.0,0.0,0.0,3611,77228,54165,-23063
18764,0.0,0.0,0.0,3611,77232,54165,-23067
18765,0.0,0.0,0.0,3611,77236,54165,-23071
18766,0.0,0.0,0.0,3611,77240,54165,-23075
18767,0.0,0.0,0.0,3611,77244,54165,-23079
18768,0.0,0.0,0.0,3611,77248,54165,-23083
18769,0.0,0.0,0.0,3611,77252,54165,-23087
18770,0.0,0.0,0.0,3611,77256,54165,-23091
18771,0.0,0.0,0.0,3611,77260,54165,-23095
18773,0.0,0.0,0.0,3611,77264,54165,-23099
18774,0.0,0.0,0.0,3611,77268,54165,-23103
18775,0.0,0.0,0.0,3611,77272,54165,-23107
18776,0.0,0.0,0.0,3611,77276,54165,-23111
18777,0.0,0.0,0.0,3611,77280,54165,-23115
18779,0.0,0.0,0.0,3611,77284,54165,-23119
18780,0.0,0.0,0.0,3611,77288,54165,-23123
18782,0.0,0.0,0.0,3611,77292,54165,-23127
18783,0.0,0.0,0.0,3611,77296,54165,-23131
18785,0.0,0.0,0.0,3611,77300,54165,-23135
18786,0.0,0.0,0.0,3611,77304,54165,-23139
18787,0.0,0.0,0.0,3611,77308,54165,-23143
18788,0.0,0.0,0.0,3611,77312,54165,-23147
18789,0.0,0.0,0.0,3611,77316,54165,-23151
18790,0.0,0.0,0.0,3611,77320,54165,-23155
18791,0.0,0.0,0.0,3611,77324,54165,-23159
18792,0.0,0.0,0.0,3611,77328,54165,-23163
18793,0.0,0.0,0.0,3611,77332,54165,-23167
18794,0.0,0.0,0.0,3611,77336,54165,-23171
18795,0.0,0.0,0.0,3611,77340,54165,-23175
18796,0.0,0.0,0.0,3611,77344,54165,-23179
18798,0.0,0.0,0.0,3611,77348,54165,-23183
18799,0.0,0.0,0.0,3611,77352,54165,-23187
18800,0.0,0.0,0.0,3611,77356,54165,-23191
18801,0.0,0.0,0.0,3611,77360,54165,-23195
18804,0.0,0.0,0.0,3611,77364,54165,-23199
18805,0.0,0.0,0.0,3611,77368,54165,-23203
18806,0.0,0.0,0.0,3611,77372,54165,-23207
18807,0.0,0.0,0.0,3611,77376,54165,-23211
18808,0.0,0.0,0.0,3611,77380,54165,-23215
18809,0.0,0.0,0.0,3611,77384,54165,-23219
18811,0.0,0.0,0.0,3611,77388,54165,-23223
18812,0.0,0.0,0.0,3611,77392,54165,-23227
18814,0.0,0.0,0.0,3611,77396,54165,-23231
18815,0.0,0.0,0.0,3611,77400,54165,-23235
18816,0.0,0.0,0.0,3611,77404,54165,-23239
18817,0.0,0.0,0.0,3611,77408,54165,-23243
18818,0.0,0.0,0.0,3611,77412,54165,-23247
18820,0.0,0.0,0.0,3611,77416,54165,-23251
18821,0.0,0.0,0.0,3611,77420,54165,-23255
18822,0.0,0.0,0.0,3611,77424,54165,-23259
18823,0.0,0.0,0.0,3611,77428,54165,-23263
18824,0.0,0.0,0.0,3611,77432,54165,-23267
18825,0.0,0.0,0.0,3611,77436,54165,-23271
18826,0.0,0.0,0.0,3611,77440,54165,-23275
18827,0.0,0.0,0.0,3611,77444,54165,-23279
18828,0.0,0.0,0.0,3611,77448,54165,-23283
18829,0.0,0.0,0.0,3611,77452,54165,-23287
18830,0.0,0.0,0.0,3611,77456,54165,-23291
18831,0.0,0.0,0.0,3611,77460,54165,-23295
18832,0.0,0.0,0.0,3611,77464,54165,-23299
18833,0.0,0.0,0.0,3611,77468,54165,-23303
18834,0.0,0.0,0.0,3611,77472,54165,-23307
18835,0.0,0.0,0.0,3611,77476,54165,-23311
18836,0.0,0.0,0.0,3611,77480,54165,-23315
18837,0.0,0.0,0.0,3611,77484,54165,-23319
18838,0.0,0.0,0.0,3611,77488,54165,-23323
18839,0.0,0.0,0.0,3611,77492,54165,-23327
18840,0.0,0.0,0.0,3611,77496,54165,-23331
18841,0.0,0.0,0.0,3611,77500,54165,-23335
18842,0.0,0.0,0.0,3611,77504,54165,-23339
18843,0.0,0.0,0.0,3611,77508,54165,-23343
18845,0.0,0.0,0.0,3611,77512,54165,-23347
18846,0.0,0.0,0.0,3611,77516,54165,-23351
18847,0.0,0.0,0.0,3611,77520,54165,-23355
18848,0.0,0.0,0.0,3611,77524,54165,-23359
18849,0.0,0.0,0.0,3611,77528,54165,-23363
18851,0.0,0.0,0.0,3611,77532,54165,-23367
18852,0.0,0.0,0.0,3611,77536,54165,-23371
18853,0.0,0.0,0.0,3611,77540,54165,-23375
18855,0.0,0.0,0.0,3611,77544,54165,-23379
18856,0.0,0.0,0.0,3611,77548,54165,-23383
18857,0.0,0.0,0.0,3611,77552,54165,-23387
18858,0.0,0.0,0.0,3611,77556,54165,-23391
18859,0.0,0.0,0.0,3611,77560,54165,-23395
18860,0.0,0.0,0.0,3611,77564,54165,-23399
18861,0.0,0.0,0.0,3611,77568,54165,-23403
18862,0.0,0.0,0.0,3611,77572,54165,-23407
18864,0.0,0.0,0.0,3611,77576,54165,-23411
18865,0.0,0.0,0.0,3611,77580,54165,-23415
18868,0.0,0.0,0.0,3611,77584,54165,-23419
18870,0.0,0.0,0.0,3611,77588,54165,-23423
18871,0.0,0.0,0.0,3611,77592,54165,-23427
18872,0.0,0.0,0.0,3611,77596,54165,-23431
18874,0.0,0.0,0.0,3611,77600,54165,-23435
18875,0.0,0.0,0.0,3611,77604,54165,-23439
18876,0.0,0.0,0.0,3611,77608,54165,-23443
18878,0.0,0.0,0.0,3611,77612,54165,-23447
18881,0.0,0.0,0.0,3611,77616,54165,-23451
18882,0.0,0.0,0.0,3611,77620,54165,-23455
18883,0.0,0.0,0.0,3611,77624,54165,-23459
18884,0.0,0.0,0.0,3611,77628,54165,-23463
18886,0.0,0.0,0.0,3611,77632,54165,-23467
18887,0.0,0.0,0.0,3611,77636,54165,-23471
18888,0.0,0.0,0.0,3611,77640,54165,-23475
18889,0.0,0.0,0.0,3611,77644,54165,-23479
18890,0.0,0.0,0.0,3611,77648,54165,-23483
18891,0.0,0.0,0.0,3611,77652,54165,-23487
18892,0.0,0.0,0.0,3611,77656,54165,-23491
18893,0.0,0.0,0.0,3611,77660,54165,-23495
18894,0.0,0.0,0.0,3611,77664,54165,-23499
18896,0.0,0.0,0.0,3611,77668,54165,-23503
18898,0.0,0.0,0.0,3611,77672,54165,-23507
18900,0.0,0.0,0.0,3611,77676,54165,-23511
18901,0.0,0.0,0.0,3611,77680,54165,-23515
18902,0.0,0.0,0.0,3611,77684,54165,-23519
18903,0.0,0.0,0.0,3611,77688,54165,-23523
18904,0.0,0.0,0.0,3611,77692,54165,-23527
18905,0.0,0.0,0.0,3611,77696,54165,-23531
18906,0.0,0.0,0.0,3611,77700,54165,-23535
18907,0.0,0.0,0.0,3611,77704,54165,-23539
18908,0.0,0.0,0.0,3611,77708,54165,-23543
18909,0.0,0.0,0.0,3611,77712,54165,-23547
18910,0.0,0.0,0.0,3611,77716,54165,-23551
18911,0.0,0.0,0.0,3611,77720,54165,-23555
18912,0.0,0.0,0.0,3611,77724,54165,-23559
18913,0.0,0.0,0.0,3611,77728,54165,-23563
18914,0.0,0.0,0.0,3611,77732,54165,-23567
18915,0.0,0.0,0.0,3611,77736,54165,-23571
18916,0.0,0.0,0.0,3611,77740,54165,-23575
18917,0.0,0.0,0.0,3611,77744,54165,-23579
18918,0.0,0.0,0.0,3611,77748,54165,-23583
18919,0.0,0.0,0.0,3611,77752,54165,-23587
18920,0.0,0.0,0.0,3611,77756,54165,-23591
18921,0.0,0.0,0.0,3611,77760,54165,-23595
18923,0.0,0.0,0.0,3611,77764,54165,-23599
18925,0.0,0.0,0.0,3611,77768,54165,-23603
18926,0.0,0.0,0.0,3611,77772,54165,-23607
18927,0.0,0.0,0.0,3611,77776,54165,-23611
18928,0.0,0.0,0.0,3611,77780,54165,-23615
18929,0.0,0.0,0.0,3611,77784,54165,-23619
18931,0.0,0.0,0.0,3611,77788,54165,-23623
18932,0.0,0.0,0.0,3611,77792,54165,-23627
18934,0.0,0.0,0.0,3611,77796,54165,-23631
18935,0.0,0.0,0.0,3611,77800,54165,-23635
18936,0.0,0.0,0.0,3611,77804,54165,-23639
18937,0.0,0.0,0.0,3611,77808,54165,-23643
18938,0.0,0.0,0.0,3611,77812,54165,-23647
18939,0.0,0.0,0.0,3611,77816,54165,-23651
18940,0.0,0.0,0.0,3611,77820,54165,-23655
18941,0.0,0.0,0.0,3611,77824,54165,-23659
18942,0.0,0.0,0.0,3611,77828,54165,-23663
18943,0.0,0.0,0.0,3611,77832,54165,-23667
18944,0.0,0.0,0.0,3611,77836,54165,-23671
18945,0.0,0.0,0.0,3611,77840,54165,-23675
18946,0.0,0.0,0.0,3611,77844,54165,-23679
18947,0.0,0.0,0.0,3611,77848,54165,-23683
18948,0.0,0.0,0.0,3611,77852,54165,-23687
18949,0.0,0.0,0.0,3611,77856,54165,-23691
18951,0.0,0.0,0.0,3611,77860,54165,-23695
18952,0.0,0.0,0.0,3611,77864,54165,-23699
18953,0.0,0.0,0.0,3611,77868,54165,-23703
18954,0.0,0.0,0.0,3611,77872,54165,-23707
18955,0.0,0.0,0.0,3611,77876,54165,-23711
18957,0.0,0.0,0.0,3611,77880,54165,-23715
18958,0.0,0.0,0.0,3611,77884,54165,-23719
18960,0.0,0.0,0.0,3611,77888,54165,-23723
18964,0.0,0.0,0.0,3611,77892,54165,-23727
18965,0.0,0.0,0.0,3611,77896,54165,-23731
18966,0.0,0.0,0.0,3611,77900,54165,-23735
18967,0.0,0.0,0.0,3611,77904,54165,-23739
18968,0.0,0.0,0.0,3611,77908,54165,-23743
18969,0.0,0.0,0.0,3611,77912,54165,-23747
18970,0.0,0.0,0.0,3611,77916,54165,-23751
18975,0.0,0.0,0.0,3611,77920,54165,-23755
18977,0.0,0.0,0.0,3611,77924,54165,-23759
18978,0.0,0.0,0.0,3611,77928,54165,-23763
18981,0.0,0.0,0.0,3611,77932,54165,-23767
18983,0.0,0.0,0.0,3611,77936,54165,-23771
18984,0.0,0.0,0.0,3611,77940,54165,-23775
18985,0.0,0.0,0.0,3611,77944,54165,-23779
18986,0.0,0.0,0.0,3611,77948,54165,-23783
18987,0.0,0.0,0.0,3611,77952,54165,-23787
18988,0.0,0.0,0.0,3611,77956,54165,-23791
18991,0.0,0.0,0.0,3611,77960,54165,-23795
18992,0.0,0.0,0.0,3611,77964,54165,-23799
18993,0.0,0.0,0.0,3611,77968,54165,-23803
18994,0.0,0.0,0.0,3611,77972,54165,-23807
18995,0.0,0.0,0.0,3611,77976,54165,-23811
18996,0.0,0.0,0.0,3611,77980,54165,-23815
18998,0.0,0.0,0.0,3611,77984,54165,-23819
19000,0.0,0.0,0.0,3611,77988,54165,-23823
19001,0.0,0.0,0.0,3611,77992,54165,-23827
19003,0.0,0.0,0.0,3611,77996,54165,-23831
19004,0.0,0.0,0.0,3611,78000,54165,-23835
19005,0.0,0.0,0.0,3611,78004,54165,-23839
19006,0.0,0.0,0.0,3611,78008,54165,-23843
19007,0.0,0.0,0.0,3611,78012,54165,-23847
19008,0.0,0.0,0.0,3611,78016,54165,-23851
19009,0.0,0.0,0.0,3611,78020,54165,-23855
19011,0.0,0.0,0.0,3611,78024,54165,-23859
19012,0.0,0.0,0.0,3611,78028,54165,-23863
19013,0.0,0.0,0.0,3611,78032,54165,-23867
19015,0.0,0.0,0.0,3611,78036,54165,-23871
19016,0.0,0.0,0.0,3611,78040,54165,-23875
19018,0.0,0.0,0.0,3611,78044,54165,-23879
19019,0.0,0.0,0.0,3611,78048,54165,-23883
19021,0.0,0.0,0.0,3611,78052,54165,-23887
19022,0.0,0.0,0.0,3611,78056,54165,-23891
19023,0.0,0.0,0.0,3611,78060,54165,-23895
19024,0.0,0.0,0.0,3611,78064,54165,-23899
19025,0.0,0.0,0.0,3611,78068,54165,-23903
19026,0.0,0.0,0.0,3611,78072,54165,-23907
19029,0.0,0.0,0.0,3611,78076,54165,-23911
19030,0.0,0.0,0.0,3611,78080,54165,-23915
19031,0.0,0.0,0.0,3611,78084,54165,-23919
19032,0.0,0.0,0.0,3611,78088,54165,-23923
19033,0.0,0.0,0.0,3611,78092,54165,-23927
19034,0.0,0.0,0.0,3611,78096,54165,-23931
19035,0.0,0.0,0.0,3611,78100,54165,-23935
19036,0.0,0.0,0.0,3611,78104,54165,-23939
19037,0.0,0.0,0.0,3611,78108,54165,-23943
19038,0.0,0.0,0.0,3611,78112,54165,-23947
19040,0.0,0.0,0.0,3611,78116,54165,-23951
19041,0.0,0.0,0.0,3611,78120,54165,-23955
19042,0.0,0.0,0.0,3611,78124,54165,-23959
19043,0.0,0.0,0.0,3611,78128,54165,-23963
19044,0.0,0.0,0.0,3611,78132,54165,-23967
19045,0.0,0.0,0.0,3611,78136,54165,-23971
19046,0.0,0.0,0.0,3611,78140,54165,-23975
19047,0.0,0.0,0.0,3611,78144,54165,-23979
19048,0.0,0.0,0.0,3611,78148,54165,-23983
19049,0.0,0.0,0.0,3611,78152,54165,-23987
19050,0.0,0.0,0.0,3611,78156,54165,-23991
19051,0.0,0.0,0.0,3611,78160,54165,-23995
19052,0.0,0.0,0.0,3611,78164,54165,-23999
19053,0.0,0.0,0.0,3611,78168,54165,-24003
19054,0.0,0.0,0.0,3611,78172,54165,-24007
19057,0.0,0.0,0.0,3611,78176,54165,-24011
19058,0.0,0.0,0.0,3611,78180,54165,-24015
19060,0.0,0.0,0.0,3611,78184,54165,-24019
19061,0.0,0.0,0.0,3611,78188,54165,-24023
19062,0.0,0.0,0.0,3611,78192,54165,-24027
19063,0.0,0.0,0.0,3611,78196,54165,-24031
19064,0.0,0.0,0.0,3611,78200,54165,-24035
19065,0.0,0.0,0.0,3611,78204,54165,-24039
19066,0.0,0.0,0.0,3611,78208,54165,-24043
19067,0.0,0.0,0.0,3611,78212,54165,-24047
19068,0.0,0.0,0.0,3611,78216,54165,-24051
19069,0.0,0.0,0.0,3611,78220,54165,-24055
19070,0.0,0.0,0.0,3611,78224,54165,-24059
19071,0.0,0.0,0.0,3611,78228,54165,-24063
19072,0.0,0.0,0.0,3611,78232,54165,-24067
19073,0.0,0.0,0.0,3611,78236,54165,-24071
19075,0.0,0.0,0.0,3611,78240,54165,-24075
19076,0.0,0.0,0.0,3611,78244,54165,-24079
19077,0.0,0.0,0.0,3611,78248,54165,-24083
19078,0.0,0.0,0.0,3611,78252,54165,-24087
19079,0.0,0.0,0.0,3611,78256,54165,-24091
19080,0.0,0.0,0.0,3611,78260,54165,-24095
19081,0.0,0.0,0.0,3611,78264,54165,-24099
19082,0.0,0.0,0.0,3611,78268,54165,-24103
19084,0.0,0.0,0.0,3611,78272,54165,-24107
19085,0.0,0.0,0.0,3611,78276,54165,-24111
19086,0.0,0.0,0.0,3611,78280,54165,-24115
19087,0.0,0.0,0.0,3611,78284,54165,-24119
19089,0.0,0.0,0.0,3611,78288,54165,-24123
19090,0.0,0.0,0.0,3611,78292,54165,-24127
19091,0.0,0.0,0.0,3611,78296,54165,-24131
19092,0.0,0.0,0.0,3611,78300,54165,-24135
19095,0.0,0.0,0.0,3611,78304,54165,-24139
19096,0.0,0.0,0.0,3611,78308,54165,-24143
19097,0.0,0.0,0.0,3611,78312,54165,-24147
19098,0.0,0.0,0.0,3611,78316,54165,-24151
19099,0.0,0.0,0.0,3611,78320,54165,-24155
19100,0.0,0.0,0.0,3611,78324,54165,-24159
19101,0.0,0.0,0.0,3611,78328,54165,-24163
19103,0.0,0.0,0.0,3611,78332,54165,-24167
19104,0.0,0.0,0.0,3611,78336,54165,-24171
19105,0.0,0.0,0.0,3611,78340,54165,-24175
19107,0.0,0.0,0.0,3611,78344,54165,-24179
19108,0.0,0.0,0.0,3611,78348,54165,-24183
19109,0.0,0.0,0.0,3611,78352,54165,-24187
19110,0.0,0.0,0.0,3611,78356,54165,-24191
19111,0.0,0.0,0.0,3611,78360,54165,-24195
19112,0.0,0.0,0.0,3611,78364,54165,-24199
19114,0.0,0.0,0.0,3611,78368,54165,-24203
19115,0.0,0.0,0.0,3611,78372,54165,-24207
19116,0.0,0.0,0.0,3611,78376,54165,-24211
19117,0.0,0.0,0.0,3611,78380,54165,-24215
19118,0.0,0.0,0.0,3611,78384,54165,-24219
19119,0.0,0.0,0.0,3611,78388,54165,-24223
19120,0.0,0.0,0.0,3611,78392,54165,-24227
19121,0.0,0.0,0.0,3611,78396,54165,-24231
19122,0.0,0.0,0.0,3611,78400,54165,-24235
19123,0.0,0.0,0.0,3611,78404,54165,-24239
19124,0.0,0.0,0.0,3611,78408,54165,-24243
19125,0.0,0.0,0.0,3611,78412,54165,-24247
19126,0.0,0.0,0.0,3611,78416,54165,-24251
19127,0.0,0.0,0.0,3611,78420,54165,-24255
19128,0.0,0.0,0.0,3611,78424,54165,-24259
19129,0.0,0.0,0.0,3611,78428,54165,-24263
19130,0.0,0.0,0.0,3611,78432,54165,-24267
19131,0.0,0.0,0.0,3611,78436,54165,-24271
19132,0.0,0.0,0.0,3611,78440,54165,-24275
19133,0.0,0.0,0.0,3611,78444,54165,-24279
19134,0.0,0.0,0.0,3611,78448,54165,-24283
19135,0.0,0.0,0.0,3611,78452,54165,-24287
19136,0.0,0.0,0.0,3611,78456,54165,-24291
19138,0.0,0.0,0.0,3611,78460,54165,-24295
19139,0.0,0.0,0.0,3611,78464,54165,-24299
19140,0.0,0.0,0.0,3611,78468,54165,-24303
19141,0.0,0.0,0.0,3611,78472,54165,-24307
19142,0.0,0.0,0.0,3611,78476,54165,-24311
19143,0.0,0.0,0.0,3611,78480,54165,-24315
19144,0.0,0.0,0.0,3611,78484,54165,-24319
19145,0.0,0.0,0.0,3611,78488,54165,-24323
19146,0.0,0.0,0.0,3611,78492,54165,-24327
19147,0.0,0.0,0.0,3611,78496,54165,-24331
19148,0.0,0.0,0.0,3611,78500,54165,-24335
19150,0.0,0.0,0.0,3611,78504,54165,-24339
19151,0.0,0.0,0.0,3611,78508,54165,-24343
19152,0.0,0.0,0.0,3611,78512,54165,-24347
19153,0.0,0.0,0.0,3611,78516,54165,-24351
19154,0.0,0.0,0.0,3611,78520,54165,-24355
19156,0.0,0.0,0.0,3611,78524,54165,-24359
19157,0.0,0.0,0.0,3611,78528,54165,-24363
19158,0.0,0.0,0.0,3611,78532,54165,-24367
19159,0.0,0.0,0.0,3611,78536,54165,-24371
19160,0.0,0.0,0.0,3611,78540,54165,-24375
19164,0.0,0.0,0.0,3611,78544,54165,-24379
19165,0.0,0.0,0.0,3611,78548,54165,-24383
19166,0.0,0.0,0.0,3611,78552,54165,-24387
19167,0.0,0.0,0.0,3611,78556,54165,-24391
19168,0.0,0.0,0.0,3611,78560,54165,-24395
19169,0.0,0.0,0.0,3611,78564,54165,-24399
19170,0.0,0.0,0.0,3611,78568,54165,-24403
19172,0.0,0.0,0.0,3611,78572,54165,-24407
19173,0.0,0.0,0.0,3611,78576,54165,-24411
19174,0.0,0.0,0.0,3611,78580,54165,-24415
19175,0.0,0.0,0.0,3611,78584,54165,-24419
19176,0.0,0.0,0.0,3611,78588,54165,-24423
19177,0.0,0.0,0.0,3611,78592,54165,-24427
19178,0.0,0.0,0.0,3611,78596,54165,-24431
19179,0.0,0.0,0.0,3611,78600,54165,-24435
19182,0.0,0.0,0.0,3611,78604,54165,-24439
19183,0.0,0.0,0.0,3611,78608,54165,-24443
19184,0.0,0.0,0.0,3611,78612,54165,-24447
19185,0.0,0.0,0.0,3611,78616,54165,-24451
19188,0.0,0.0,0.0,3611,78620,54165,-24455
19189,0.0,0.0,0.0,3611,78624,54165,-24459
19190,0.0,0.0,0.0,3611,78628,54165,-24463
19191,0.0,0.0,0.0,3611,78632,54165,-24467
19192,0.0,0.0,0.0,3611,78636,54165,-24471
19193,0.0,0.0,0.0,3611,78640,54165,-24475
19194,0.0,0.0,0.0,3611,78644,54165,-24479
19195,0.0,0.0,0.0,3611,78648,54165,-24483
19196,0.0,0.0,0.0,3611,78652,54165,-24487
19197,0.0,0.0,0.0,3611,78656,54165,-24491
19198,0.0,0.0,0.0,3611,78660,54165,-24495
19199,0.0,0.0,0.0,3611,78664,54165,-24499
19200,0.0,0.0,0.0,3611,78668,54165,-24503
19201,0.0,0.0,0.0,3611,78672,54165,-24507
19202,0.0,0.0,0.0,3611,78676,54165,-24511
19203,0.0,0.0,0.0,3611,78680,54165,-24515
19204,0.0,0.0,0.0,3611,78684,54165,-24519
19205,0.0,0.0,0.0,3611,78688,54165,-24523
19207,0.0,0.0,0.0,3611,78692,54165,-24527
19208,0.0,0.0,0.0,3611,78696,54165,-24531
19209,0.0,0.0,0.0,3611,78700,54165,-24535
19210,0.0,0.0,0.0,3611,78704,54165,-24539
19211,0.0,0.0,0.0,3611,78708,54165,-24543
19212,0.0,0.0,0.0,3611,78712,54165,-24547
19213,0.0,0.0,0.0,3611,78716,54165,-24551
19214,0.0,0.0,0.0,3611,78720,54165,-24555
19215,0.0,0.0,0.0,3611,78724,54165,-24559
19216,0.0,0.0,0.0,3611,78728,54165,-24563
19217,0.0,0.0,0.0,3611,78732,54165,-24567
19218,0.0,0.0,0.0,3611,78736,54165,-24571
19219,0.0,0.0,0.0,3611,78740,54165,-24575
19220,0.0,0.0,0.0,3611,78744,54165,-24579
19221,0.0,0.0,0.0,3611,78748,54165,-24583
19223,0.0,0.0,0.0,3611,78752,54165,-24587
19224,0.0,0.0,0.0,3611,78756,54165,-24591
19225,0.0,0.0,0.0,3611,78760,54165,-24595
19226,0.0,0.0,0.0,3611,78764,54165,-24599
19227,0.0,0.0,0.0,3611,78768,54165,-24603
19228,0.0,0.0,0.0,3611,78772,54165,-24607
19229,0.0,0.0,0.0,3611,78776,54165,-24611
19230,0.0,0.0,0.0,3611,78780,54165,-24615
19231,0.0,0.0,0.0,3611,78784,54165,-24619
19232,0.0,0.0,0.0,3611,78788,54165,-24623
19234,0.0,0.0,0.0,3611,78792,54165,-24627
19235,0.0,0.0,0.0,3611,78796,54165,-24631
19237,0.0,0.0,0.0,3611,78800,54165,-24635
19238,0.0,0.0,0.0,3611,78804,54165,-24639
19239,0.0,0.0,0.0,3611,78808,54165,-24643
19241,0.0,0.0,0.0,3611,78812,54165,-24647
19243,0.0,0.0,0.0,3611,78816,54165,-24651
19244,0.0,0.0,0.0,3611,78820,54165,-24655
19245,0.0,0.0,0.0,3611,78824,54165,-24659
19246,0.0,0.0,0.0,3611,78828,54165,-24663
19247,0.0,0.0,0.0,3611,78832,54165,-24667
19248,0.0,0.0,0.0,3611,78836,54165,-24671
19249,0.0,0.0,0.0,3611,78840,54165,-24675
19252,0.0,0.0,0.0,3611,78844,54165,-24679
19254,0.0,0.0,0.0,3611,78848,54165,-24683
19255,0.0,0.0,0.0,3611,78852,54165,-24687
19257,0.0,0.0,0.0,3611,78856,54165,-24691
19258,0.0,0.0,0.0,3611,78860,54165,-24695
19259,0.0,0.0,0.0,3611,78864,54165,-24699
19262,0.0,0.0,0.0,3611,78868,54165,-24703
19263,0.0,0.0,0.0,3611,78872,54165,-24707
19264,0.0,0.0,0.0,3611,78876,54165,-24711
19266,0.0,0.0,0.0,3611,78880,54165,-24715
19267,0.0,0.0,0.0,3611,78884,54165,-24719
19269,0.0,0.0,0.0,3611,78888,54165,-24723
19270,0.0,0.0,0.0,3611,78892,54165,-24727
19271,0.0,0.0,0.0,3611,78896,54165,-24731
19273,0.0,0.0,0.0,3611,78900,54165,-24735
19274,0.0,0.0,0.0,3611,78904,54165,-24739
19275,0.0,0.0,0.0,3611,78908,54165,-24743
19276,0.0,0.0,0.0,3611,78912,54165,-24747
19277,0.0,0.0,0.0,3611,78916,54165,-24751
19278,0.0,0.0,0.0,3611,78920,54165,-24755
19279,0.0,0.0,0.0,3611,78924,54165,-24759
19280,0.0,0.0,0.0,3611,78928,54165,-24763
19281,0.0,0.0,0.0,3611,78932,54165,-24767
19282,0.0,0.0,0.0,3611,78936,54165,-24771
19283,0.0,0.0,0.0,3611,78940,54165,-24775
19284,0.0,0.0,0.0,3611,78944,54165,-24779
19287,0.0,0.0,0.0,3611,78948,54165,-24783
19288,0.0,0.0,0.0,3611,78952,54165,-24787
19289,0.0,0.0,0.0,3611,78956,54165,-24791
19290,0.0,0.0,0.0,3611,78960,54165,-24795
19291,0.0,0.0,0.0,3611,78964,54165,-24799
19293,0.0,0.0,0.0,3611,78968,54165,-24803
19294,0.0,0.0,0.0,3611,78972,54165,-24807
19295,0.0,0.0,0.0,3611,78976,54165,-24811
19296,0.0,0.0,0.0,3611,78980,54165,-24815
19297,0.0,0.0,0.0,3611,78984,54165,-24819
19298,0.0,0.0,0.0,3611,78988,54165,-24823
19299,0.0,0.0,0.0,3611,78992,54165,-24827
19300,0.0,0.0,0.0,3611,78996,54165,-24831
19301,0.0,0.0,0.0,3611,79000,54165,-24835
19302,0.0,0.0,0.0,3611,79004,54165,-24839
19303,0.0,0.0,0.0,3611,79008,54165,-24843
19304,0.0,0.0,0.0,3611,79012,54165,-24847
19305,0.0,0.0,0.0,3611,79016,54165,-24851
19306,0.0,0.0,0.0,3611,79020,54165,-24855
19307,0.0,0.0,0.0,3611,79024,54165,-24859
19308,0.0,0.0,0.0,3611,79028,54165,-24863
19309,0.0,0.0,0.0,3611,79032,54165,-24867
19310,0.0,0.0,0.0,3611,79036,54165,-24871
19311,0.0,0.0,0.0,3611,79040,54165,-24875
19313,0.0,0.0,0.0,3611,79044,54165,-24879
19315,0.0,0.0,0.0,3611,79048,54165,-24883
19316,0.0,0.0,0.0,3611,79052,54165,-24887
19317,0.0,0.0,0.0,3611,79056,54165,-24891
19318,0.0,0.0,0.0,3611,79060,54165,-24895
19320,0.0,0.0,0.0,3611,79064,54165,-24899
19321,0.0,0.0,0.0,3611,79068,54165,-24903
19322,0.0,0.0,0.0,3611,79072,54165,-24907
19323,0.0,0.0,0.0,3611,79076,54165,-24911
19324,0.0,0.0,0.0,3611,79080,54165,-24915
19326,0.0,0.0,0.0,3611,79084,54165,-24919
19327,0.0,0.0,0.0,3611,79088,54165,-24923
19328,0.0,0.0,0.0,3611,79092,54165,-24927
19329,0.0,0.0,0.0,3611,79096,54165,-24931
19330,0.0,0.0,0.0,3611,79100,54165,-24935
19331,0.0,0.0,0.0,3611,79104,54165,-24939
19332,0.0,0.0,0.0,3611,79108,54165,-24943
19334,0.0,0.0,0.0,3611,79112,54165,-24947
19335,0.0,0.0,0.0,3611,79116,54165,-24951
19336,0.0,0.0,0.0,3611,79120,54165,-24955
19337,0.0,0.0,0.0,3611,79124,54165,-24959
19338,0.0,0.0,0.0,3611,79128,54165,-24963
19340,0.0,0.0,0.0,3611,79132,54165,-24967
19341,0.0,0.0,0.0,3611,79136,54165,-24971
19342,0.0,0.0,0.0,3611,79140,54165,-24975
19343,0.0,0.0,0.0,3611,79144,54165,-24979
19344,0.0,0.0,0.0,3611,79148,54165,-24983
19345,0.0,0.0,0.0,3611,79152,54165,-24987
19346,0.0,0.0,0.0,3611,79156,54165,-24991
19348,0.0,0.0,0.0,3611,79160,54165,-24995
19349,0.0,0.0,0.0,3611,79164,54165,-24999
19350,0.0,0.0,0.0,3611,79168,54165,-25003
19351,0.0,0.0,0.0,3611,79172,54165,-25007
19352,0.0,0.0,0.0,3611,79176,54165,-25011
19353,0.0,0.0,0.0,3611,79180,54165,-25015
19354,0.0,0.0,0.0,3611,79184,54165,-25019
19355,0.0,0.0,0.0,3611,79188,54165,-25023
19356,0.0,0.0,0.0,3611,79192,54165,-25027
19358,0.0,0.0,0.0,3611,79196,54165,-25031
19359,0.0,0.0,0.0,3611,79200,54165,-25035
19360,0.0,0.0,0.0,3611,79204,54165,-25039
19361,0.0,0.0,0.0,3611,79208,54165,-25043
19362,0.0,0.0,0.0,3611,79212,54165,-25047
19363,0.0,0.0,0.0,3611,79216,54165,-25051
19364,0.0,0.0,0.0,3611,79220,54165,-25055
19365,0.0,0.0,0.0,3611,79224,54165,-25059
19366,0.0,0.0,0.0,3611,79228,54165,-25063
19367,0.0,0.0,0.0,3611,79232,54165,-25067
19368,0.0,0.0,0.0,3611,79236,54165,-25071
19369,0.0,0.0,0.0,3611,79240,54165,-25075
19370,0.0,0.0,0.0,3611,79244,54165,-25079
19371,0.0,0.0,0.0,3611,79248,54165,-25083
19372,0.0,0.0,0.0,3611,79252,54165,-25087
19374,0.0,0.0,0.0,3611,79256,54165,-25091
19375,0.0,0.0,0.0,3611,79260,54165,-25095
19376,0.0,0.0,0.0,3611,79264,54165,-25099
19377,0.0,0.0,0.0,3611,79268,54165,-25103
19379,0.0,0.0,0.0,3611,79272,54165,-25107
19380,0.0,0.0,0.0,3611,79276,54165,-25111
19381,0.0,0.0,0.0,3611,79280,54165,-25115
19382,0.0,0.0,0.0,3611,79284,54165,-25119
19384,0.0,0.0,0.0,3611,79288,54165,-25123
19385,0.0,0.0,0.0,3611,79292,54165,-25127
19386,0.0,0.0,0.0,3611,79296,54165,-25131
19387,0.0,0.0,0.0,3611,79300,54165,-25135
19389,0.0,0.0,0.0,3611,79304,54165,-25139
19390,0.0,0.0,0.0,3611,79308,54165,-25143
19391,0.0,0.0,0.0,3611,79312,54165,-25147
19393,0.0,0.0,0.0,3611,79316,54165,-25151
19394,0.0,0.0,0.0,3611,79320,54165,-25155
19395,0.0,0.0,0.0,3611,79324,54165,-25159
19396,0.0,0.0,0.0,3611,79328,54165,-25163
19397,0.0,0.0,0.0,3611,79332,54165,-25167
19399,0.0,0.0,0.0,3611,79336,54165,-25171
19400,0.0,0.0,0.0,3611,79340,54165,-25175
19401,0.0,0.0,0.0,3611,79344,54165,-25179
19402,0.0,0.0,0.0,3611,79348,54165,-25183
19403,0.0,0.0,0.0,3611,79352,54165,-25187
19404,0.0,0.0,0.0,3611,79356,54165,-25191
19405,0.0,0.0,0.0,3611,79360,54165,-25195
19406,0.0,0.0,0.0,3611,79364,54165,-25199
19407,0.0,0.0,0.0,3611,79368,54165,-25203
19408,0.0,0.0,0.0,3611,79372,54165,-25207
19410,0.0,0.0,0.0,3611,79376,54165,-25211
19411,0.0,0.0,0.0,3611,79380,54165,-25215
19412,0.0,0.0,0.0,3611,79384,54165,-25219
19413,0.0,0.0,0.0,3611,79388,54165,-25223
19414,0.0,0.0,0.0,3611,79392,54165,-25227
19415,0.0,0.0,0.0,3611,79396,54165,-25231
19417,0.0,0.0,0.0,3611,79400,54165,-25235
19418,0.0,0.0,0.0,3611,79404,54165,-25239
19419,0.0,0.0,0.0,3611,79408,54165,-25243
19420,0.0,0.0,0.0,3611,79412,54165,-25247
19422,0.0,0.0,0.0,3611,79416,54165,-25251
19424,0.0,0.0,0.0,3611,79420,54165,-25255
19426,0.0,0.0,0.0,3611,79424,54165,-25259
19427,0.0,0.0,0.0,3611,79428,54165,-25263
19428,0.0,0.0,0.0,3611,79432,54165,-25267
19430,0.0,0.0,0.0,3611,79436,54165,-25271
19431,0.0,0.0,0.0,3611,79440,54165,-25275
19432,0.0,0.0,0.0,3611,79444,54165,-25279
19434,0.0,0.0,0.0,3611,79448,54165,-25283
19435,0.0,0.0,0.0,3611,79452,54165,-25287
19436,0.0,0.0,0.0,3611,79456,54165,-25291
19437,0.0,0.0,0.0,3611,79460,54165,-25295
19439,0.0,0.0,0.0,3611,79464,54165,-25299
19440,0.0,0.0,0.0,3611,79468,54165,-25303
19441,0.0,0.0,0.0,3611,79472,54165,-25307
19442,0.0,0.0,0.0,3611,79476,54165,-25311
19444,0.0,0.0,0.0,3611,79480,54165,-25315
19445,0.0,0.0,0.0,3611,79484,54165,-25319
19446,0.0,0.0,0.0,3611,79488,54165,-25323
19447,0.0,0.0,0.0,3611,79492,54165,-25327
19448,0.0,0.0,0.0,3611,79496,54165,-25331
19449,0.0,0.0,0.0,3611,79500,54165,-25335
19450,0.0,0.0,0.0,3611,79504,54165,-25339
19451,0.0,0.0,0.0,3611,79508,54165,-25343
19453,0.0,0.0,0.0,3611,79512,54165,-25347
19454,0.0,0.0,0.0,3611,79516,54165,-25351
19455,0.0,0.0,0.0,3611,79520,54165,-25355
19456,0.0,0.0,0.0,3611,79524,54165,-25359
19457,0.0,0.0,0.0,3611,79528,54165,-25363
19458,0.0,0.0,0.0,3611,79532,54165,-25367
19459,0.0,0.0,0.0,3611,79536,54165,-25371
19460,0.0,0.0,0.0,3611,79540,54165,-25375
19461,0.0,0.0,0.0,3611,79544,54165,-25379
19462,0.0,0.0,0.0,3611,79548,54165,-25383
19463,0.0,0.0,0.0,3611,79552,54165,-25387
19464,0.0,0.0,0.0,3611,79556,54165,-25391
19465,0.0,0.0,0.0,3611,79560,54165,-25395
19466,0.0,0.0,0.0,3611,79564,54165,-25399
19467,0.0,0.0,0.0,3611,79568,54165,-25403
19468,0.0,0.0,0.0,3611,79572,54165,-25407
19469,0.0,0.0,0.0,3611,79576,54165,-25411
19470,0.0,0.0,0.0,3611,79580,54165,-25415
19471,0.0,0.0,0.0,3611,79584,54165,-25419
19472,0.0,0.0,0.0,3611,79588,54165,-25423
19473,0.0,0.0,0.0,3611,79592,54165,-25427
19475,0.0,0.0,0.0,3611,79596,54165,-25431
19477,0.0,0.0,0.0,3611,79600,54165,-25435
19478,0.0,0.0,0.0,3611,79604,54165,-25439
19480,0.0,0.0,0.0,3611,79608,54165,-25443
19482,0.0,0.0,0.0,3611,79612,54165,-25447
19484,0.0,0.0,0.0,3611,79616,54165,-25451
19485,0.0,0.0,0.0,3611,79620,54165,-25455
19486,0.0,0.0,0.0,3611,79624,54165,-25459
19487,0.0,0.0,0.0,3611,79628,54165,-25463
19488,0.0,0.0,0.0,3611,79632,54165,-25467
19489,0.0,0.0,0.0,3611,79636,54165,-25471
19490,0.0,0.0,0.0,3611,79640,54165,-25475
19491,0.0,0.0,0.0,3611,79644,54165,-25479
19492,0.0,0.0,0.0,3611,79648,54165,-25483
19493,0.0,0.0,0.0,3611,79652,54165,-25487
19494,0.0,0.0,0.0,3611,79656,54165,-25491
19495,0.0,0.0,0.0,3611,79660,54165,-25495
19497,0.0,0.0,0.0,3611,79664,54165,-25499
19498,0.0,0.0,0.0,3611,79668,54165,-25503
19499,0.0,0.0,0.0,3611,79672,54165,-25507
19500,0.0,0.0,0.0,3611,79676,54165,-25511
19501,0.0,0.0,0.0,3611,79680,54165,-25515
19502,0.0,0.0,0.0,3611,79684,54165,-25519
19503,0.0,0.0,0.0,3611,79688,54165,-25523
19504,0.0,0.0,0.0,3611,79692,54165,-25527
19505,0.0,0.0,0.0,3611,79696,54165,-25531
19506,0.0,0.0,0.0,3611,79700,54165,-25535
19507,0.0,0.0,0.0,3611,79704,54165,-25539
19508,0.0,0.0,0.0,3611,79708,54165,-25543
19509,0.0,0.0,0.0,3611,79712,54165,-25547
19510,0.0,0.0,0.0,3611,79716,54165,-25551
19511,0.0,0.0,0.0,3611,79720,54165,-25555
19512,0.0,0.0,0.0,3611,79724,54165,-25559
19513,0.0,0.0,0.0,3611,79728,54165,-25563
19514,0.0,0.0,0.0,3611,79732,54165,-25567
19515,0.0,0.0,0.0,3611,79736,54165,-25571
19516,0.0,0.0,0.0,3611,79740,54165,-25575
19517,0.0,0.0,0.0,3611,79744,54165,-25579
19518,0.0,0.0,0.0,3611,79748,54165,-25583
19519,0.0,0.0,0.0,3611,79752,54165,-25587
19520,0.0,0.0,0.0,3611,79756,54165,-25591
19521,0.0,0.0,0.0,3611,79760,54165,-25595
19522,0.0,0.0,0.0,3611,79764,54165,-25599
19523,0.0,0.0,0.0,3611,79768,54165,-25603
19524,0.0,0.0,0.0,3611,79772,54165,-25607
19525,0.0,0.0,0.0,3611,79776,54165,-25611
19527,0.0,0.0,0.0,3611,79780,54165,-25615
19528,0.0,0.0,0.0,3611,79784,54165,-25619
19529,0.0,0.0,0.0,3611,79788,54165,-25623
19530,0.0,0.0,0.0,3611,79792,54165,-25627
19531,0.0,0.0,0.0,3611,79796,54165,-25631
19532,0.0,0.0,0.0,3611,79800,54165,-25635
19533,0.0,0.0,0.0,3611,79804,54165,-25639
19534,0.0,0.0,0.0,3611,79808,54165,-25643
19536,0.0,0.0,0.0,3611,79812,54165,-25647
19537,0.0,0.0,0.0,3611,79816,54165,-25651
19538,0.0,0.0,0.0,3611,79820,54165,-25655
19539,0.0,0.0,0.0,3611,79824,54165,-25659
19540,0.0,0.0,0.0,3611,79828,54165,-25663
19541,0.0,0.0,0.0,3611,79832,54165,-25667
19542,0.0,0.0,0.0,3611,79836,54165,-25671
19543,0.0,0.0,0.0,3611,79840,54165,-25675
19544,0.0,0.0,0.0,3611,79844,54165,-25679
19545,0.0,0.0,0.0,3611,79848,54165,-25683
19546,0.0,0.0,0.0,3611,79852,54165,-25687
19547,0.0,0.0,0.0,3611,79856,54165,-25691
19549,0.0,0.0,0.0,3611,79860,54165,-25695
19550,0.0,0.0,0.0,3611,79864,54165,-25699
19551,0.0,0.0,0.0,3611,79868,54165,-25703
19552,0.0,0.0,0.0,3611,79872,54165,-25707
19553,0.0,0.0,0.0,3611,79876,54165,-25711
19554,0.0,0.0,0.0,3611,79880,54165,-25715
19555,0.0,0.0,0.0,3611,79884,54165,-25719
19556,0.0,0.0,0.0,3611,79888,54165,-25723
19558,0.0,0.0,0.0,3611,79892,54165,-25727
19559,0.0,0.0,0.0,3611,79896,54165,-25731
19560,0.0,0.0,0.0,3611,79900,54165,-25735
19562,0.0,0.0,0.0,3611,79904,54165,-25739
19563,0.0,0.0,0.0,3611,79908,54165,-25743
19565,0.0,0.0,0.0,3611,79912,54165,-25747
19566,0.0,0.0,0.0,3611,79916,54165,-25751
19567,0.0,0.0,0.0,3611,79920,54165,-25755
19568,0.0,0.0,0.0,3611,79924,54165,-25759
19569,0.0,0.0,0.0,3611,79928,54165,-25763
19571,0.0,0.0,0.0,3611,79932,54165,-25767
19572,0.0,0.0,0.0,3611,79936,54165,-25771
19574,0.0,0.0,0.0,3611,79940,54165,-25775
19575,0.0,0.0,0.0,3611,79944,54165,-25779
19576,0.0,0.0,0.0,3611,79948,54165,-25783
19577,0.0,0.0,0.0,3611,79952,54165,-25787
19578,0.0,0.0,0.0,3611,79956,54165,-25791
19579,0.0,0.0,0.0,3611,79960,54165,-25795
19580,0.0,0.0,0.0,3611,79964,54165,-25799
19582,0.0,0.0,0.0,3611,79968,54165,-25803
19583,0.0,0.0,0.0,3611,79972,54165,-25807
19584,0.0,0.0,0.0,3611,79976,54165,-25811
19585,0.0,0.0,0.0,3611,79980,54165,-25815
19586,0.0,0.0,0.0,3611,79984,54165,-25819
19587,0.0,0.0,0.0,3611,79988,54165,-25823
19589,0.0,0.0,0.0,3611,79992,54165,-25827
19590,0.0,0.0,0.0,3611,79996,54165,-25831
19591,0.0,0.0,0.0,3611,80000,54165,-25835
19592,0.0,0.0,0.0,3611,80004,54165,-25839
19593,0.0,0.0,0.0,3611,80008,54165,-25843
19594,0.0,0.0,0.0,3611,80012,54165,-25847
19596,0.0,0.0,0.0,3611,80016,54165,-25851
19597,0.0,0.0,0.0,3611,80020,54165,-25855
19598,0.0,0.0,0.0,3611,80024,54165,-25859
19599,0.0,0.0,0.0,3611,80028,54165,-25863
19600,0.0,0.0,0.0,3611,80032,54165,-25867
19601,0.0,0.0,0.0,3611,80036,54165,-25871
19602,0.0,0.0,0.0,3611,80040,54165,-25875
19603,0.0,0.0,0.0,3611,80044,54165,-25879
19604,0.0,0.0,0.0,3611,80048,54165,-25883
19605,0.0,0.0,0.0,3611,80052,54165,-25887
19608,0.0,0.0,0.0,3611,80056,54165,-25891
19609,0.0,0.0,0.0,3611,80060,54165,-25895
19611,0.0,0.0,0.0,3611,80064,54165,-25899
19612,0.0,0.0,0.0,3611,80068,54165,-25903
19613,0.0,0.0,0.0,3611,80072,54165,-25907
19614,0.0,0.0,0.0,3611,80076,54165,-25911
19615,0.0,0.0,0.0,3611,80080,54165,-25915
19616,0.0,0.0,0.0,3611,80084,54165,-25919
19618,0.0,0.0,0.0,3611,80088,54165,-25923
19619,0.0,0.0,0.0,3611,80092,54165,-25927
19620,0.0,0.0,0.0,3611,80096,54165,-25931
19622,0.0,0.0,0.0,3611,80100,54165,-25935
19623,0.0,0.0,0.0,3611,80104,54165,-25939
19624,0.0,0.0,0.0,3611,80108,54165,-25943
19626,0.0,0.0,0.0,3611,80112,54165,-25947
19627,0.0,0.0,0.0,3611,80116,54165,-25951
19628,0.0,0.0,0.0,3611,80120,54165,-25955
19629,0.0,0.0,0.0,3611,80124,54165,-25959
19630,0.0,0.0,0.0,3611,80128,54165,-25963
19631,0.0,0.0,0.0,3611,80132,54165,-25967
19632,0.0,0.0,0.0,3611,80136,54165,-25971
19634,0.0,0.0,0.0,3611,80140,54165,-25975
19635,0.0,0.0,0.0,3611,80144,54165,-25979
19636,0.0,0.0,0.0,3611,80148,54165,-25983
19637,0.0,0.0,0.0,3611,80152,54165,-25987
19639,0.0,0.0,0.0,3611,80156,54165,-25991
19640,0.0,0.0,0.0,3611,80160,54165,-25995
19641,0.0,0.0,0.0,3611,80164,54165,-25999
19642,0.0,0.0,0.0,3611,80168,54165,-26003
19643,0.0,0.0,0.0,3611,80172,54165,-26007
19644,0.0,0.0,0.0,3611,80176,54165,-26011
19646,0.0,0.0,0.0,3611,80180,54165,-26015
19647,0.0,0.0,0.0,3611,80184,54165,-26019
19648,0.0,0.0,0.0,3611,80188,54165,-26023
19649,0.0,0.0,0.0,3611,80192,54165,-26027
19650,0.0,0.0,0.0,3611,80196,54165,-26031
19651,0.0,0.0,0.0,3611,80200,54165,-26035
19652,0.0,0.0,0.0,3611,80204,54165,-26039
19654,0.0,0.0,0.0,3611,80208,54165,-26043
19655,0.0,0.0,0.0,3611,80212,54165,-26047
19656,0.0,0.0,0.0,3611,80216,54165,-26051
19657,0.0,0.0,0.0,3611,80220,54165,-26055
19658,0.0,0.0,0.0,3611,80224,54165,-26059
19659,0.0,0.0,0.0,3611,80228,54165,-26063
19660,0.0,0.0,0.0,3611,80232,54165,-26067
19661,0.0,0.0,0.0,3611,80236,54165,-26071
19662,0.0,0.0,0.0,3611,80240,54165,-26075
19663,0.0,0.0,0.0,3611,80244,54165,-26079
19664,0.0,0.0,0.0,3611,80248,54165,-26083
19665,0.0,0.0,0.0,3611,80252,54165,-26087
19666,0.0,0.0,0.0,3611,80256,54165,-26091
19667,0.0,0.0,0.0,3611,80260,54165,-26095
19668,0.0,0.0,0.0,3611,80264,54165,-26099
19669,0.0,0.0,0.0,3611,80268,54165,-26103
19670,0.0,0.0,0.0,3611,80272,54165,-26107
19671,0.0,0.0,0.0,3611,80276,54165,-26111
19672,0.0,0.0,0.0,3611,80280,54165,-26115
19673,0.0,0.0,0.0,3611,80284,54165,-26119
19674,0.0,0.0,0.0,3611,80288,54165,-26123
19675,0.0,0.0,0.0,3611,80292,54165,-26127
19676,0.0,0.0,0.0,3611,80296,54165,-26131
19677,0.0,0.0,0.0,3611,80300,54165,-26135
19678,0.0,0.0,0.0,3611,80304,54165,-26139
19679,0.0,0.0,0.0,3611,80308,54165,-26143
19680,0.0,0.0,0.0,3611,80312,54165,-26147
19681,0.0,0.0,0.0,3611,80316,54165,-26151
19682,0.0,0.0,0.0,3611,80320,54165,-26155
19683,0.0,0.0,0.0,3611,80324,54165,-26159
19684,0.0,0.0,0.0,3611,80328,54165,-26163
19685,0.0,0.0,0.0,3611,80332,54165,-26167
19686,0.0,0.0,0.0,3611,80336,54165,-26171
19688,0.0,0.0,0.0,3611,80340,54165,-26175
19689,0.0,0.0,0.0,3611,80344,54165,-26179
19690,0.0,0.0,0.0,3611,80348,54165,-26183
19691,0.0,0.0,0.0,3611,80352,54165,-26187
19693,0.0,0.0,0.0,3611,80356,54165,-26191
19694,0.0,0.0,0.0,3611,80360,54165,-26195
19695,0.0,0.0,0.0,3611,80364,54165,-26199
19698,0.0,0.0,0.0,3611,80368,54165,-26203
19699,0.0,0.0,0.0,3611,80372,54165,-26207
19700,0.0,0.0,0.0,3611,80376,54165,-26211
19701,0.0,0.0,0.0,3611,80380,54165,-26215
19702,0.0,0.0,0.0,3611,80384,54165,-26219
19703,0.0,0.0,0.0,3611,80388,54165,-26223
19704,0.0,0.0,0.0,3611,80392,54165,-26227
19705,0.0,0.0,0.0,3611,80396,54165,-26231
19706,0.0,0.0,0.0,3611,80400,54165,-26235
19708,0.0,0.0,0.0,3611,80404,54165,-26239
19709,0.0,0.0,0.0,3611,80408,54165,-26243
19710,0.0,0.0,0.0,3611,80412,54165,-26247
19711,0.0,0.0,0.0,3611,80416,54165,-26251
19712,0.0,0.0,0.0,3611,80420,54165,-26255
19713,0.0,0.0,0.0,3611,80424,54165,-26259
19714,0.0,0.0,0.0,3611,80428,54165,-26263
19715,0.0,0.0,0.0,3611,80432,54165,-26267
19717,0.0,0.0,0.0,3611,80436,54165,-26271
19718,0.0,0.0,0.0,3611,80440,54165,-26275
19719,0.0,0.0,0.0,3611,80444,54165,-26279
19721,0.0,0.0,0.0,3611,80448,54165,-26283
19722,0.0,0.0,0.0,3611,80452,54165,-26287
19723,0.0,0.0,0.0,3611,80456,54165,-26291
19724,0.0,0.0,0.0,3611,80460,54165,-26295
19725,0.0,0.0,0.0,3611,80464,54165,-26299
19726,0.0,0.0,0.0,3611,80468,54165,-26303
19727,0.0,0.0,0.0,3611,80472,54165,-26307
19728,0.0,0.0,0.0,3611,80476,54165,-26311
19729,0.0,0.0,0.0,3611,80480,54165,-26315
19730,0.0,0.0,0.0,3611,80484,54165,-26319
19731,0.0,0.0,0.0,3611,80488,54165,-26323
19732,0.0,0.0,0.0,3611,80492,54165,-26327
19733,0.0,0.0,0.0,3611,80496,54165,-26331
19734,0.0,0.0,0.0,3611,80500,54165,-26335
19735,0.0,0.0,0.0,3611,80504,54165,-26339
19736,0.0,0.0,0.0,3611,80508,54165,-26343
19737,0.0,0.0,0.0,3611,80512,54165,-26347
19738,0.0,0.0,0.0,3611,80516,54165,-26351
19739,0.0,0.0,0.0,3611,80520,54165,-26355
19740,0.0,0.0,0.0,3611,80524,54165,-26359
19742,0.0,0.0,0.0,3611,80528,54165,-26363
19743,0.0,0.0,0.0,3611,80532,54165,-26367
19744,0.0,0.0,0.0,3611,80536,54165,-26371
19745,0.0,0.0,0.0,3611,80540,54165,-26375
19746,0.0,0.0,0.0,3611,80544,54165,-26379
19747,0.0,0.0,0.0,3611,80548,54165,-26383
19748,0.0,0.0,0.0,3611,80552,54165,-26387
19749,0.0,0.0,0.0,3611,80556,54165,-26391
19750,0.0,0.0,0.0,3611,80560,54165,-26395
19751,0.0,0.0,0.0,3611,80564,54165,-26399
19752,0.0,0.0,0.0,3611,80568,54165,-26403
19753,0.0,0.0,0.0,3611,80572,54165,-26407
19755,0.0,0.0,0.0,3611,80576,54165,-26411
19756,0.0,0.0,0.0,3611,80580,54165,-26415
19757,0.0,0.0,0.0,3611,80584,54165,-26419
19758,0.0,0.0,0.0,3611,80588,54165,-26423
19760,0.0,0.0,0.0,3611,80592,54165,-26427
19761,0.0,0.0,0.0,3611,80596,54165,-26431
19762,0.0,0.0,0.0,3611,80600,54165,-26435
19763,0.0,0.0,0.0,3611,80604,54165,-26439
19764,0.0,0.0,0.0,3611,80608,54165,-26443
19765,0.0,0.0,0.0,3611,80612,54165,-26447
19766,0.0,0.0,0.0,3611,80616,54165,-26451
19767,0.0,0.0,0.0,3611,80620,54165,-26455
19769,0.0,0.0,0.0,3611,80624,54165,-26459
19770,0.0,0.0,0.0,3611,80628,54165,-26463
19771,0.0,0.0,0.0,3611,80632,54165,-26467
19772,0.0,0.0,0.0,3611,80636,54165,-26471
19773,0.0,0.0,0.0,3611,80640,54165,-26475
19774,0.0,0.0,0.0,3611,80644,54165,-26479
19775,0.0,0.0,0.0,3611,80648,54165,-26483
19776,0.0,0.0,0.0,3611,80652,54165,-26487
19777,0.0,0.0,0.0,3611,80656,54165,-26491
19778,0.0,0.0,0.0,3611,80660,54165,-26495
19779,0.0,0.0,0.0,3611,80664,54165,-26499
19780,0.0,0.0,0.0,3611,80668,54165,-26503
19781,0.0,0.0,0.0,3611,80672,54165,-26507
19782,0.0,0.0,0.0,3611,80676,54165,-26511
19784,0.0,0.0,0.0,3611,80680,54165,-26515
19785,0.0,0.0,0.0,3611,80684,54165,-26519
19786,0.0,0.0,0.0,3611,80688,54165,-26523
19787,0.0,0.0,0.0,3611,80692,54165,-26527
19788,0.0,0.0,0.0,3611,80696,54165,-26531
19789,0.0,0.0,0.0,3611,80700,54165,-26535
19790,0.0,0.0,0.0,3611,80704,54165,-26539
19791,0.0,0.0,0.0,3611,80708,54165,-26543
19793,0.0,0.0,0.0,3611,80712,54165,-26547
19795,0.0,0.0,0.0,3611,80716,54165,-26551
19796,0.0,0.0,0.0,3611,80720,54165,-26555
19797,0.0,0.0,0.0,3611,80724,54165,-26559
19798,0.0,0.0,0.0,3611,80728,54165,-26563
19799,0.0,0.0,0.0,3611,80732,54165,-26567
19800,0.0,0.0,0.0,3611,80736,54165,-26571
19801,0.0,0.0,0.0,3611,80740,54165,-26575
19802,0.0,0.0,0.0,3611,80744,54165,-26579
19803,0.0,0.0,0.0,3611,80748,54165,-26583
19804,0.0,0.0,0.0,3611,80752,54165,-26587
19805,0.0,0.0,0.0,3611,80756,54165,-26591
19807,0.0,0.0,0.0,3611,80760,54165,-26595
19808,0.0,0.0,0.0,3611,80764,54165,-26599
19809,0.0,0.0,0.0,3611,80768,54165,-26603
19810,0.0,0.0,0.0,3611,80772,54165,-26607
19811,0.0,0.0,0.0,3611,80776,54165,-26611
19813,0.0,0.0,0.0,3611,80780,54165,-26615
19814,0.0,0.0,0.0,3611,80784,54165,-26619
19816,0.0,0.0,0.0,3611,80788,54165,-26623
19817,0.0,0.0,0.0,3611,80792,54165,-26627
19818,0.0,0.0,0.0,3611,80796,54165,-26631
19819,0.0,0.0,0.0,3611,80800,54165,-26635
19820,0.0,0.0,0.0,3611,80804,54165,-26639
19821,0.0,0.0,0.0,3611,80808,54165,-26643
19823,0.0,0.0,0.0,3611,80812,54165,-26647
19824,0.0,0.0,0.0,3611,80816,54165,-26651
19827,0.0,0.0,0.0,3611,80820,54165,-26655
19828,0.0,0.0,0.0,3611,80824,54165,-26659
19829,0.0,0.0,0.0,3611,80828,54165,-26663
19830,0.0,0.0,0.0,3611,80832,54165,-26667
19831,0.0,0.0,0.0,3611,80836,54165,-26671
19832,0.0,0.0,0.0,3611,80840,54165,-26675
19834,0.0,0.0,0.0,3611,80844,54165,-26679
19835,0.0,0.0,0.0,3611,80848,54165,-26683
19836,0.0,0.0,0.0,3611,80852,54165,-26687
19837,0.0,0.0,0.0,3611,80856,54165,-26691
19838,0.0,0.0,0.0,3611,80860,54165,-26695
19839,0.0,0.0,0.0,3611,80864,54165,-26699
19841,0.0,0.0,0.0,3611,80868,54165,-26703
19843,0.0,0.0,0.0,3611,80872,54165,-26707
19844,0.0,0.0,0.0,3611,80876,54165,-26711
19846,0.0,0.0,0.0,3611,80880,54165,-26715
19847,0.0,0.0,0.0,3611,80884,54165,-26719
19848,0.0,0.0,0.0,3611,80888,54165,-26723
19849,0.0,0.0,0.0,3611,80892,54165,-26727
19850,0.0,0.0,0.0,3611,80896,54165,-26731
19851,0.0,0.0,0.0,3611,80900,54165,-26735
19852,0.0,0.0,0.0,3611,80904,54165,-26739
19853,0.0,0.0,0.0,3611,80908,54165,-26743
19854,0.0,0.0,0.0,3611,80912,54165,-26747
19855,0.0,0.0,0.0,3611,80916,54165,-26751
19856,0.0,0.0,0.0,3611,80920,54165,-26755
19858,0.0,0.0,0.0,3611,80924,54165,-26759
19859,0.0,0.0,0.0,3611,80928,54165,-26763
19860,0.0,0.0,0.0,3611,80932,54165,-26767
19861,0.0,0.0,0.0,3611,80936,54165,-26771
19862,0.0,0.0,0.0,3611,80940,54165,-26775
19863,0.0,0.0,0.0,3611,80944,54165,-26779
19864,0.0,0.0,0.0,3611,80948,54165,-26783
19866,0.0,0.0,0.0,3611,80952,54165,-26787
19867,0.0,0.0,0.0,3611,80956,54165,-26791
19868,0.0,0.0,0.0,3611,80960,54165,-26795
19869,0.0,0.0,0.0,3611,80964,54165,-26799
19872,0.0,0.0,0.0,3611,80968,54165,-26803
19873,0.0,0.0,0.0,3611,80972,54165,-26807
19874,0.0,0.0,0.0,3611,80976,54165,-26811
19875,0.0,0.0,0.0,3611,80980,54165,-26815
19876,0.0,0.0,0.0,3611,80984,54165,-26819
19877,0.0,0.0,0.0,3611,80988,54165,-26823
19878,0.0,0.0,0.0,3611,80992,54165,-26827
19879,0.0,0.0,0.0,3611,80996,54165,-26831
19880,0.0,0.0,0.0,3611,81000,54165,-26835
19882,0.0,0.0,0.0,3611,81004,54165,-26839
19883,0.0,0.0,0.0,3611,81008,54165,-26843
19884,0.0,0.0,0.0,3611,81012,54165,-26847
19885,0.0,0.0,0.0,3611,81016,54165,-26851
19887,0.0,0.0,0.0,3611,81020,54165,-26855
19888,0.0,0.0,0.0,3611,81024,54165,-26859
19889,0.0,0.0,0.0,3611,81028,54165,-26863
19890,0.0,0.0,0.0,3611,81032,54165,-26867
19891,0.0,0.0,0.0,3611,81036,54165,-26871
19892,0.0,0.0,0.0,3611,81040,54165,-26875
19893,0.0,0.0,0.0,3611,81044,54165,-26879
19894,0.0,0.0,0.0,3611,81048,54165,-26883
19895,0.0,0.0,0.0,3611,81052,54165,-26887
19896,0.0,0.0,0.0,3611,81056,54165,-26891
19897,0.0,0.0,0.0,3611,81060,54165,-26895
19898,0.0,0.0,0.0,3611,81064,54165,-26899
19900,0.0,0.0,0.0,3611,81068,54165,-26903
19901,0.0,0.0,0.0,3611,81072,54165,-26907
19903,0.0,0.0,0.0,3611,81076,54165,-26911
19905,0.0,0.0,0.0,3611,81080,54165,-26915
19907,0.0,0.0,0.0,3611,81084,54165,-26919
19909,0.0,0.0,0.0,3611,81088,54165,-26923
19910,0.0,0.0,0.0,3611,81092,54165,-26927
19911,0.0,0.0,0.0,3611,81096,54165,-26931
19912,0.0,0.0,0.0,3611,81100,54165,-26935
19914,0.0,0.0,0.0,3611,81104,54165,-26939
19915,0.0,0.0,0.0,3611,81108,54165,-26943
19916,0.0,0.0,0.0,3611,81112,54165,-26947
19917,0.0,0.0,0.0,3611,81116,54165,-26951
19918,0.0,0.0,0.0,3611,81120,54165,-26955
19919,0.0,0.0,0.0,3611,81124,54165,-26959
19920,0.0,0.0,0.0,3611,81128,54165,-26963
19924,0.0,0.0,0.0,3611,81132,54165,-26967
19925,0.0,0.0,0.0,3611,81136,54165,-26971
19928,0.0,0.0,0.0,3611,81140,54165,-26975
19930,0.0,0.0,0.0,3611,81144,54165,-26979
19931,0.0,0.0,0.0,3611,81148,54165,-26983
19932,0.0,0.0,0.0,3611,81152,54165,-26987
19933,0.0,0.0,0.0,3611,81156,54165,-26991
19934,0.0,0.0,0.0,3611,81160,54165,-26995
19935,0.0,0.0,0.0,3611,81164,54165,-26999
19936,0.0,0.0,0.0,3611,81168,54165,-27003
19937,0.0,0.0,0.0,3611,81172,54165,-27007
19939,0.0,0.0,0.0,3611,81176,54165,-27011
19940,0.0,0.0,0.0,3611,81180,54165,-27015
19941,0.0,0.0,0.0,3611,81184,54165,-27019
19943,0.0,0.0,0.0,3611,81188,54165,-27023
19944,0.0,0.0,0.0,3611,81192,54165,-27027
19945,0.0,0.0,0.0,3611,81196,54165,-27031
19947,0.0,0.0,0.0,3611,81200,54165,-27035
19948,0.0,0.0,0.0,3611,81204,54165,-27039
19949,0.0,0.0,0.0,3611,81208,54165,-27043
19950,0.0,0.0,0.0,3611,81212,54165,-27047
19951,0.0,0.0,0.0,3611,81216,54165,-27051
19954,0.0,0.0,0.0,3611,81220,54165,-27055
19955,0.0,0.0,0.0,3611,81224,54165,-27059
19956,0.0,0.0,0.0,3611,81228,54165,-27063
19958,0.0,0.0,0.0,3611,81232,54165,-27067
19960,0.0,0.0,0.0,3611,81236,54165,-27071
19962,0.0,0.0,0.0,3611,81240,54165,-27075
19963,0.0,0.0,0.0,3611,81244,54165,-27079
19964,0.0,0.0,0.0,3611,81248,54165,-27083
19965,0.0,0.0,0.0,3611,81252,54165,-27087
19966,0.0,0.0,0.0,3611,81256,54165,-27091
19970,0.0,0.0,0.0,3611,81260,54165,-27095
19971,0.0,0.0,0.0,3611,81264,54165,-27099
19972,0.0,0.0,0.0,3611,81268,54165,-27103
19974,0.0,0.0,0.0,3611,81272,54165,-27107
19975,0.0,0.0,0.0,3611,81276,54165,-27111
19976,0.0,0.0,0.0,3611,81280,54165,-27115
19977,0.0,0.0,0.0,3611,81284,54165,-27119
19978,0.0,0.0,0.0,3611,81288,54165,-27123
19979,0.0,0.0,0.0,3611,81292,54165,-27127
19980,0.0,0.0,0.0,3611,81296,54165,-27131
19981,0.0,0.0,0.0,3611,81300,54165,-27135
19982,0.0,0.0,0.0,3611,81304,54165,-27139
19983,0.0,0.0,0.0,3611,81308,54165,-27143
19984,0.0,0.0,0.0,3611,81312,54165,-27147
19985,0.0,0.0,0.0,3611,81316,54165,-27151
19986,0.0,0.0,0.0,3611,81320,54165,-27155
19987,0.0,0.0,0.0,3611,81324,54165,-27159
19988,0.0,0.0,0.0,3611,81328,54165,-27163
19989,0.0,0.0,0.0,3611,81332,54165,-27167
19991,0.0,0.0,0.0,3611,81336,54165,-27171
19993,0.0,0.0,0.0,3611,81340,54165,-27175
19994,0.0,0.0,0.0,3611,81344,54165,-27179
19995,0.0,0.0,0.0,3611,81348,54165,-27183
19996,0.0,0.0,0.0,3611,81352,54165,-27187
19997,0.0,0.0,0.0,3611,81356,54165,-27191
19998,0.0,0.0,0.0,3611,81360,54165,-27195
19999,0.0,0.0,0.0,3611,81364,54165,-27199
20001,0.0,0.0,0.0,3611,81368,54165,-27203
20002,0.0,0.0,0.0,3611,81372,54165,-27207
20003,0.0,0.0,0.0,3611,81376,54165,-27211
20004,0.0,0.0,0.0,3611,81380,54165,-27215
20005,0.0,0.0,0.0,3611,81384,54165,-27219
20006,0.0,0.0,0.0,3611,81388,54165,-27223
20007,0.0,0.0,0.0,3611,81392,54165,-27227
20008,0.0,0.0,0.0,3611,81396,54165,-27231
20009,0.0,0.0,0.0,3611,81400,54165,-27235
20010,0.0,0.0,0.0,3611,81404,54165,-27239
20011,0.0,0.0,0.0,3611,81408,54165,-27243
20012,0.0,0.0,0.0,3611,81412,54165,-27247
20013,0.0,0.0,0.0,3611,81416,54165,-27251
20014,0.0,0.0,0.0,3611,81420,54165,-27255
20015,0.0,0.0,0.0,3611,81424,54165,-27259
20016,0.0,0.0,0.0,3611,81428,54165,-27263
20017,0.0,0.0,0.0,3611,81432,54165,-27267
20018,0.0,0.0,0.0,3611,81436,54165,-27271
20019,0.0,0.0,0.0,3611,81440,54165,-27275
20021,0.0,0.0,0.0,3611,81444,54165,-27279
20022,0.0,0.0,0.0,3611,81448,54165,-27283
20023,0.0,0.0,0.0,3611,81452,54165,-27287
20025,0.0,0.0,0.0,3611,81456,54165,-27291
20027,0.0,0.0,0.0,3611,81460,54165,-27295
20028,0.0,0.0,0.0,3611,81464,54165,-27299
20029,0.0,0.0,0.0,3611,81468,54165,-27303
20030,0.0,0.0,0.0,3611,81472,54165,-27307
20033,0.0,0.0,0.0,3611,81476,54165,-27311
20034,0.0,0.0,0.0,3611,81480,54165,-27315
20037,0.0,0.0,0.0,3611,81484,54165,-27319
20038,0.0,0.0,0.0,3611,81488,54165,-27323
20039,0.0,0.0,0.0,3611,81492,54165,-27327
20040,0.0,0.0,0.0,3611,81496,54165,-27331
20041,0.0,0.0,0.0,3611,81500,54165,-27335
20042,0.0,0.0,0.0,3611,81504,54165,-27339
20043,0.0,0.0,0.0,3611,81508,54165,-27343
20045,0.0,0.0,0.0,3611,81512,54165,-27347
20047,0.0,0.0,0.0,3611,81516,54165,-27351
20048,0.0,0.0,0.0,3611,81520,54165,-27355
20049,0.0,0.0,0.0,3611,81524,54165,-27359
20050,0.0,0.0,0.0,3611,81528,54165,-27363
20051,0.0,0.0,0.0,3611,81532,54165,-27367
20053,0.0,0.0,0.0,3611,81536,54165,-27371
20054,0.0,0.0,0.0,3611,81540,54165,-27375
20055,0.0,0.0,0.0,3611,81544,54165,-27379
20056,0.0,0.0,0.0,3611,81548,54165,-27383
20058,0.0,0.0,0.0,3611,81552,54165,-27387
20059,0.0,0.0,0.0,3611,81556,54165,-27391
20060,0.0,0.0,0.0,3611,81560,54165,-27395
20061,0.0,0.0,0.0,3611,81564,54165,-27399
20064,0.0,0.0,0.0,3611,81568,54165,-27403
20065,0.0,0.0,0.0,3611,81572,54165,-27407
20066,0.0,0.0,0.0,3611,81576,54165,-27411
20067,0.0,0.0,0.0,3611,81580,54165,-27415
20069,0.0,0.0,0.0,3611,81584,54165,-27419
20070,0.0,0.0,0.0,3611,81588,54165,-27423
20071,0.0,0.0,0.0,3611,81592,54165,-27427
20072,0.0,0.0,0.0,3611,81596,54165,-27431
20073,0.0,0.0,0.0,3611,81600,54165,-27435
20074,0.0,0.0,0.0,3611,81604,54165,-27439
20075,0.0,0.0,0.0,3611,81608,54165,-27443
20076,0.0,0.0,0.0,3611,81612,54165,-27447
20077,0.0,0.0,0.0,3611,81616,54165,-27451
20078,0.0,0.0,0.0,3611,81620,54165,-27455
20079,0.0,0.0,0.0,3611,81624,54165,-27459
20080,0.0,0.0,0.0,3611,81628,54165,-27463
20081,0.0,0.0,0.0,3611,81632,54165,-27467
20082,0.0,0.0,0.0,3611,81636,54165,-27471
20083,0.0,0.0,0.0,3611,81640,54165,-27475
20084,0.0,0.0,0.0,3611,81644,54165,-27479
20085,0.0,0.0,0.0,3611,81648,54165,-27483
20087,0.0,0.0,0.0,3611,81652,54165,-27487
20088,0.0,0.0,0.0,3611,81656,54165,-27491
20091,0.0,0.0,0.0,3611,81660,54165,-27495
20092,0.0,0.0,0.0,3611,81664,54165,-27499
20093,0.0,0.0,0.0,3611,81668,54165,-27503
20094,0.0,0.0,0.0,3611,81672,54165,-27507
20095,0.0,0.0,0.0,3611,81676,54165,-27511
20097,0.0,0.0,0.0,3611,81680,54165,-27515
20098,0.0,0.0,0.0,3611,81684,54165,-27519
20099,0.0,0.0,0.0,3611,81688,54165,-27523
20100,0.0,0.0,0.0,3611,81692,54165,-27527
20101,0.0,0.0,0.0,3611,81696,54165,-27531
20102,0.0,0.0,0.0,3611,81700,54165,-27535
20103,0.0,0.0,0.0,3611,81704,54165,-27539
20104,0.0,0.0,0.0,3611,81708,54165,-27543
20105,0.0,0.0,0.0,3611,81712,54165,-27547
20106,0.0,0.0,0.0,3611,81716,54165,-27551
20107,0.0,0.0,0.0,3611,81720,54165,-27555
20108,0.0,0.0,0.0,3611,81724,54165,-27559
20109,0.0,0.0,0.0,3611,81728,54165,-27563
20110,0.0,0.0,0.0,3611,81732,54165,-27567
20112,0.0,0.0,0.0,3611,81736,54165,-27571
20113,0.0,0.0,0.0,3611,81740,54165,-27575
20115,0.0,0.0,0.0,3611,81744,54165,-27579
20116,0.0,0.0,0.0,3611,81748,54165,-27583
20118,0.0,0.0,0.0,3611,81752,54165,-27587
20119,0.0,0.0,0.0,3611,81756,54165,-27591
20121,0.0,0.0,0.0,3611,81760,54165,-27595
20122,0.0,0.0,0.0,3611,81764,54165,-27599
20123,0.0,0.0,0.0,3611,81768,54165,-27603
20124,0.0,0.0,0.0,3611,81772,54165,-27607
20125,0.0,0.0,0.0,3611,81776,54165,-27611
20126,0.0,0.0,0.0,3611,81780,54165,-27615
20128,0.0,0.0,0.0,3611,81784,54165,-27619
20129,0.0,0.0,0.0,3611,81788,54165,-27623
20130,0.0,0.0,0.0,3611,81792,54165,-27627
20131,0.0,0.0,0.0,3611,81796,54165,-27631
20132,0.0,0.0,0.0,3611,81800,54165,-27635
20133,0.0,0.0,0.0,3611,81804,54165,-27639
20134,0.0,0.0,0.0,3611,81808,54165,-27643
20135,0.0,0.0,0.0,3611,81812,54165,-27647
20136,0.0,0.0,0.0,3611,81816,54165,-27651
20137,0.0,0.0,0.0,3611,81820,54165,-27655
20139,0.0,0.0,0.0,3611,81824,54165,-27659
20140,0.0,0.0,0.0,3611,81828,54165,-27663
20141,0.0,0.0,0.0,3611,81832,54165,-27667
20142,0.0,0.0,0.0,3611,81836,54165,-27671
20143,0.0,0.0,0.0,3611,81840,54165,-27675
20144,0.0,0.0,0.0,3611,81844,54165,-27679
20145,0.0,0.0,0.0,3611,81848,54165,-27683
20146,0.0,0.0,0.0,3611,81852,54165,-27687
20148,0.0,0.0,0.0,3611,81856,54165,-27691
20149,0.0,0.0,0.0,3611,81860,54165,-27695
20150,0.0,0.0,0.0,3611,81864,54165,-27699
20152,0.0,0.0,0.0,3611,81868,54165,-27703
20153,0.0,0.0,0.0,3611,81872,54165,-27707
20155,0.0,0.0,0.0,3611,81876,54165,-27711
20156,0.0,0.0,0.0,3611,81880,54165,-27715
20157,0.0,0.0,0.0,3611,81884,54165,-27719
20158,0.0,0.0,0.0,3611,81888,54165,-27723
20159,0.0,0.0,0.0,3611,81892,54165,-27727
20160,0.0,0.0,0.0,3611,81896,54165,-27731
20161,0.0,0.0,0.0,3611,81900,54165,-27735
20162,0.0,0.0,0.0,3611,81904,54165,-27739
20163,0.0,0.0,0.0,3611,81908,54165,-27743
20164,0.0,0.0,0.0,3611,81912,54165,-27747
20165,0.0,0.0,0.0,3611,81916,54165,-27751
20166,0.0,0.0,0.0,3611,81920,54165,-27755
20168,0.0,0.0,0.0,3611,81924,54165,-27759
20169,0.0,0.0,0.0,3611,81928,54165,-27763
20171,0.0,0.0,0.0,3611,81932,54165,-27767
20173,0.0,0.0,0.0,3611,81936,54165,-27771
20174,0.0,0.0,0.0,3611,81940,54165,-27775
20175,0.0,0.0,0.0,3611,81944,54165,-27779
20176,0.0,0.0,0.0,3611,81948,54165,-27783
20178,0.0,0.0,0.0,3611,81952,54165,-27787
20180,0.0,0.0,0.0,3611,81956,54165,-27791
20181,0.0,0.0,0.0,3611,81960,54165,-27795
20183,0.0,0.0,0.0,3611,81964,54165,-27799
20184,0.0,0.0,0.0,3611,81968,54165,-27803
20185,0.0,0.0,0.0,3611,81972,54165,-27807
20186,0.0,0.0,0.0,3611,81976,54165,-27811
20187,0.0,0.0,0.0,3611,81980,54165,-27815
20188,0.0,0.0,0.0,3611,81984,54165,-27819
20189,0.0,0.0,0.0,3611,81988,54165,-27823
20190,0.0,0.0,0.0,3611,81992,54165,-27827
20191,0.0,0.0,0.0,3611,81996,54165,-27831
20192,0.0,0.0,0.0,3611,82000,54165,-27835
20193,0.0,0.0,0.0,3611,82004,54165,-27839
20195,0.0,0.0,0.0,3611,82008,54165,-27843
20197,0.0,0.0,0.0,3611,82012,54165,-27847
20198,0.0,0.0,0.0,3611,82016,54165,-27851
20199,0.0,0.0,0.0,3611,82020,54165,-27855
20200,0.0,0.0,0.0,3611,82024,54165,-27859
20202,0.0,0.0,0.0,3611,82028,54165,-27863
20203,0.0,0.0,0.0,3611,82032,54165,-27867
20204,0.0,0.0,0.0,3611,82036,54165,-27871
20206,0.0,0.0,0.0,3611,82040,54165,-27875
20208,0.0,0.0,0.0,3611,82044,54165,-27879
20209,0.0,0.0,0.0,3611,82048,54165,-27883
20210,0.0,0.0,0.0,3611,82052,54165,-27887
20211,0.0,0.0,0.0,3611,82056,54165,-27891
20212,0.0,0.0,0.0,3611,82060,54165,-27895
20213,0.0,0.0,0.0,3611,82064,54165,-27899
20214,0.0,0.0,0.0,3611,82068,54165,-27903
20215,0.0,0.0,0.0,3611,82072,54165,-27907
20216,0.0,0.0,0.0,3611,82076,54165,-27911
20217,0.0,0.0,0.0,3611,82080,54165,-27915
20219,0.0,0.0,0.0,3611,82084,54165,-27919
20220,0.0,0.0,0.0,3611,82088,54165,-27923
20222,0.0,0.0,0.0,3611,82092,54165,-27927
20223,0.0,0.0,0.0,3611,82096,54165,-27931
20224,0.0,0.0,0.0,3611,82100,54165,-27935
20225,0.0,0.0,0.0,3611,82104,54165,-27939
20226,0.0,0.0,0.0,3611,82108,54165,-27943
20227,0.0,0.0,0.0,3611,82112,54165,-27947
20228,0.0,0.0,0.0,3611,82116,54165,-27951
20229,0.0,0.0,0.0,3611,82120,54165,-27955
20232,0.0,0.0,0.0,3611,82124,54165,-27959
20233,0.0,0.0,0.0,3611,82128,54165,-27963
20234,0.0,0.0,0.0,3611,82132,54165,-27967
20235,0.0,0.0,0.0,3611,82136,54165,-27971
20236,0.0,0.0,0.0,3611,82140,54165,-27975
20238,0.0,0.0,0.0,3611,82144,54165,-27979
20239,0.0,0.0,0.0,3611,82148,54165,-27983
20240,0.0,0.0,0.0,3611,82152,54165,-27987
20242,0.0,0.0,0.0,3611,82156,54165,-27991
20243,0.0,0.0,0.0,3611,82160,54165,-27995
20244,0.0,0.0,0.0,3611,82164,54165,-27999
20245,0.0,0.0,0.0,3611,82168,54165,-28003
20246,0.0,0.0,0.0,3611,82172,54165,-28007
20247,0.0,0.0,0.0,3611,82176,54165,-28011
20248,0.0,0.0,0.0,3611,82180,54165,-28015
20249,0.0,0.0,0.0,3611,82184,54165,-28019
20250,0.0,0.0,0.0,3611,82188,54165,-28023
20252,0.0,0.0,0.0,3611,82192,54165,-28027
20253,0.0,0.0,0.0,3611,82196,54165,-28031
20254,0.0,0.0,0.0,3611,82200,54165,-28035
20255,0.0,0.0,0.0,3611,82204,54165,-28039
20257,0.0,0.0,0.0,3611,82208,54165,-28043
20258,0.0,0.0,0.0,3611,82212,54165,-28047
20260,0.0,0.0,0.0,3611,82216,54165,-28051
20261,0.0,0.0,0.0,3611,82220,54165,-28055
20262,0.0,0.0,0.0,3611,82224,54165,-28059
20263,0.0,0.0,0.0,3611,82228,54165,-28063
20264,0.0,0.0,0.0,3611,82232,54165,-28067
20265,0.0,0.0,0.0,3611,82236,54165,-28071
20268,0.0,0.0,0.0,3611,82240,54165,-28075
20269,0.0,0.0,0.0,3611,82244,54165,-28079
20272,0.0,0.0,0.0,3611,82248,54165,-28083
20273,0.0,0.0,0.0,3611,82252,54165,-28087
20275,0.0,0.0,0.0,3611,82256,54165,-28091
20276,0.0,0.0,0.0,3611,82260,54165,-28095
20278,0.0,0.0,0.0,3611,82264,54165,-28099
20280,0.0,0.0,0.0,3611,82268,54165,-28103
20281,0.0,0.0,0.0,3611,82272,54165,-28107
20282,0.0,0.0,0.0,3611,82276,54165,-28111
20283,0.0,0.0,0.0,3611,82280,54165,-28115
20284,0.0,0.0,0.0,3611,82284,54165,-28119
20286,0.0,0.0,0.0,3611,82288,54165,-28123
20287,0.0,0.0,0.0,3611,82292,54165,-28127
20288,0.0,0.0,0.0,3611,82296,54165,-28131
20289,0.0,0.0,0.0,3611,82300,54165,-28135
20290,0.0,0.0,0.0,3611,82304,54165,-28139
20291,0.0,0.0,0.0,3611,82308,54165,-28143
20292,0.0,0.0,0.0,3611,82312,54165,-28147
20293,0.0,0.0,0.0,3611,82316,54165,-28151
20295,0.0,0.0,0.0,3611,82320,54165,-28155
20296,0.0,0.0,0.0,3611,82324,54165,-28159
20297,0.0,0.0,0.0,3611,82328,54165,-28163
20298,0.0,0.0,0.0,3611,82332,54165,-28167
20300,0.0,0.0,0.0,3611,82336,54165,-28171
20302,0.0,0.0,0.0,3611,82340,54165,-28175
20303,0.0,0.0,0.0,3611,82344,54165,-28179
20305,0.0,0.0,0.0,3611,82348,54165,-28183
20306,0.0,0.0,0.0,3611,82352,54165,-28187
20307,0.0,0.0,0.0,3611,82356,54165,-28191
20308,0.0,0.0,0.0,3611,82360,54165,-28195
20309,0.0,0.0,0.0,3611,82364,54165,-28199
20310,0.0,0.0,0.0,3611,82368,54165,-28203
20311,0.0,0.0,0.0,3611,82372,54165,-28207
20312,0.0,0.0,0.0,3611,82376,54165,-28211
20313,0.0,0.0,0.0,3611,82380,54165,-28215
20314,0.0,0.0,0.0,3611,82384,54165,-28219
20315,0.0,0.0,0.0,3611,82388,54165,-28223
20316,0.0,0.0,0.0,3611,82392,54165,-28227
20317,0.0,0.0,0.0,3611,82396,54165,-28231
20318,0.0,0.0,0.0,3611,82400,54165,-28235
20319,0.0,0.0,0.0,3611,82404,54165,-28239
20320,0.0,0.0,0.0,3611,82408,54165,-28243
20321,0.0,0.0,0.0,3611,82412,54165,-28247
20322,0.0,0.0,0.0,3611,82416,54165,-28251
20323,0.0,0.0,0.0,3611,82420,54165,-28255
20324,0.0,0.0,0.0,3611,82424,54165,-28259
20325,0.0,0.0,0.0,3611,82428,54165,-28263
20326,0.0,0.0,0.0,3611,82432,54165,-28267
20327,0.0,0.0,0.0,3611,82436,54165,-28271
20328,0.0,0.0,0.0,3611,82440,54165,-28275
20330,0.0,0.0,0.0,3611,82444,54165,-28279
20334,0.0,0.0,0.0,3611,82448,54165,-28283
20335,0.0,0.0,0.0,3611,82452,54165,-28287
20336,0.0,0.0,0.0,3611,82456,54165,-28291
20337,0.0,0.0,0.0,3611,82460,54165,-28295
20338,0.0,0.0,0.0,3611,82464,54165,-28299
20340,0.0,0.0,0.0,3611,82468,54165,-28303
20342,0.0,0.0,0.0,3611,82472,54165,-28307
20343,0.0,0.0,0.0,3611,82476,54165,-28311
20345,0.0,0.0,0.0,3611,82480,54165,-28315
20346,0.0,0.0,0.0,3611,82484,54165,-28319
20348,0.0,0.0,0.0,3611,82488,54165,-28323
20349,0.0,0.0,0.0,3611,82492,54165,-28327
20351,0.0,0.0,0.0,3611,82496,54165,-28331
20352,0.0,0.0,0.0,3611,82500,54165,-28335
20353,0.0,0.0,0.0,3611,82504,54165,-28339
20354,0.0,0.0,0.0,3611,82508,54165,-28343
20356,0.0,0.0,0.0,3611,82512,54165,-28347
20357,0.0,0.0,0.0,3611,82516,54165,-28351
20358,0.0,0.0,0.0,3611,82520,54165,-28355
20359,0.0,0.0,0.0,3611,82524,54165,-28359
20360,0.0,0.0,0.0,3611,82528,54165,-28363
20361,0.0,0.0,0.0,3611,82532,54165,-28367
20362,0.0,0.0,0.0,3611,82536,54165,-28371
20363,0.0,0.0,0.0,3611,82540,54165,-28375
20365,0.0,0.0,0.0,3611,82544,54165,-28379
20367,0.0,0.0,0.0,3611,82548,54165,-28383
20368,0.0,0.0,0.0,3611,82552,54165,-28387
20369,0.0,0.0,0.0,3611,82556,54165,-28391
20371,0.0,0.0,0.0,3611,82560,54165,-28395
20373,0.0,0.0,0.0,3611,82564,54165,-28399
20374,0.0,0.0,0.0,3611,82568,54165,-28403
20375,0.0,0.0,0.0,3611,82572,54165,-28407
20376,0.0,0.0,0.0,3611,82576,54165,-28411
20377,0.0,0.0,0.0,3611,82580,54165,-28415
20379,0.0,0.0,0.0,3611,82584,54165,-28419
20380,0.0,0.0,0.0,3611,82588,54165,-28423
20381,0.0,0.0,0.0,3611,82592,54165,-28427
20382,0.0,0.0,0.0,3611,82596,54165,-28431
20384,0.0,0.0,0.0,3611,82600,54165,-28435
20385,0.0,0.0,0.0,3611,82604,54165,-28439
20386,0.0,0.0,0.0,3611,82608,54165,-28443
20387,0.0,0.0,0.0,3611,82612,54165,-28447
20388,0.0,0.0,0.0,3611,82616,54165,-28451
20389,0.0,0.0,0.0,3611,82620,54165,-28455
20390,0.0,0.0,0.0,3611,82624,54165,-28459
20391,0.0,0.0,0.0,3611,82628,54165,-28463
20392,0.0,0.0,0.0,3611,82632,54165,-28467
20393,0.0,0.0,0.0,3611,82636,54165,-28471
20394,0.0,0.0,0.0,3611,82640,54165,-28475
20395,0.0,0.0,0.0,3611,82644,54165,-28479
20396,0.0,0.0,0.0,3611,82648,54165,-28483
20399,0.0,0.0,0.0,3611,82652,54165,-28487
20400,0.0,0.0,0.0,3611,82656,54165,-28491
20402,0.0,0.0,0.0,3611,82660,54165,-28495
20403,0.0,0.0,0.0,3611,82664,54165,-28499
20404,0.0,0.0,0.0,3611,82668,54165,-28503
20405,0.0,0.0,0.0,3611,82672,54165,-28507
20406,0.0,0.0,0.0,3611,82676,54165,-28511
20407,0.0,0.0,0.0,3611,82680,54165,-28515
20408,0.0,0.0,0.0,3611,82684,54165,-28519
20409,0.0,0.0,0.0,3611,82688,54165,-28523
20411,0.0,0.0,0.0,3611,82692,54165,-28527
20412,0.0,0.0,0.0,3611,82696,54165,-28531
20413,0.0,0.0,0.0,3611,82700,54165,-28535
20416,0.0,0.0,0.0,3611,82704,54165,-28539
20417,0.0,0.0,0.0,3611,82708,54165,-28543
20418,0.0,0.0,0.0,3611,82712,54165,-28547
20420,0.0,0.0,0.0,3611,82716,54165,-28551
20422,0.0,0.0,0.0,3611,82720,54165,-28555
20423,0.0,0.0,0.0,3611,82724,54165,-28559
20424,0.0,0.0,0.0,3611,82728,54165,-28563
20426,0.0,0.0,0.0,3611,82732,54165,-28567
20427,0.0,0.0,0.0,3611,82736,54165,-28571
20428,0.0,0.0,0.0,3611,82740,54165,-28575
20429,0.0,0.0,0.0,3611,82744,54165,-28579
20432,0.0,0.0,0.0,3611,82748,54165,-28583
20434,0.0,0.0,0.0,3611,82752,54165,-28587
20435,0.0,0.0,0.0,3611,82756,54165,-28591
20436,0.0,0.0,0.0,3611,82760,54165,-28595
20437,0.0,0.0,0.0,3611,82764,54165,-28599
20439,0.0,0.0,0.0,3611,82768,54165,-28603
20440,0.0,0.0,0.0,3611,82772,54165,-28607
20442,0.0,0.0,0.0,3611,82776,54165,-28611
20443,0.0,0.0,0.0,3611,82780,54165,-28615
20444,0.0,0.0,0.0,3611,82784,54165,-28619
20445,0.0,0.0,0.0,3611,82788,54165,-28623
20446,0.0,0.0,0.0,3611,82792,54165,-28627
20447,0.0,0.0,0.0,3611,82796,54165,-28631
20448,0.0,0.0,0.0,3611,82800,54165,-28635
20449,0.0,0.0,0.0,3611,82804,54165,-28639
20450,0.0,0.0,0.0,3611,82808,54165,-28643
20453,0.0,0.0,0.0,3611,82812,54165,-28647
20454,0.0,0.0,0.0,3611,82816,54165,-28651
20455,0.0,0.0,0.0,3611,82820,54165,-28655
20456,0.0,0.0,0.0,3611,82824,54165,-28659
20458,0.0,0.0,0.0,3611,82828,54165,-28663
20459,0.0,0.0,0.0,3611,82832,54165,-28667
20460,0.0,0.0,0.0,3611,82836,54165,-28671
20464,0.0,0.0,0.0,3611,82840,54165,-28675
20465,0.0,0.0,0.0,3611,82844,54165,-28679
20466,0.0,0.0,0.0,3611,82848,54165,-28683
20469,0.0,0.0,0.0,3611,82852,54165,-28687
20470,0.0,0.0,0.0,3611,82856,54165,-28691
20471,0.0,0.0,0.0,3611,82860,54165,-28695
20472,0.0,0.0,0.0,3611,82864,54165,-28699
20473,0.0,0.0,0.0,3611,82868,54165,-28703
20474,0.0,0.0,0.0,3611,82872,54165,-28707
20476,0.0,0.0,0.0,3611,82876,54165,-28711
20477,0.0,0.0,0.0,3611,82880,54165,-28715
20479,0.0,0.0,0.0,3611,82884,54165,-28719
20481,0.0,0.0,0.0,3611,82888,54165,-28723
20483,0.0,0.0,0.0,3611,82892,54165,-28727
20484,0.0,0.0,0.0,3611,82896,54165,-28731
20486,0.0,0.0,0.0,3611,82900,54165,-28735
20487,0.0,0.0,0.0,3611,82904,54165,-28739
20488,0.0,0.0,0.0,3611,82908,54165,-28743
20489,0.0,0.0,0.0,3611,82912,54165,-28747
20490,0.0,0.0,0.0,3611,82916,54165,-28751
20492,0.0,0.0,0.0,3611,82920,54165,-28755
20494,0.0,0.0,0.0,3611,82924,54165,-28759
20495,0.0,0.0,0.0,3611,82928,54165,-28763
20496,0.0,0.0,0.0,3611,82932,54165,-28767
20498,0.0,0.0,0.0,3611,82936,54165,-28771
20501,0.0,0.0,0.0,3611,82940,54165,-28775
20503,0.0,0.0,0.0,3611,82944,54165,-28779
20504,0.0,0.0,0.0,3611,82948,54165,-28783
20505,0.0,0.0,0.0,3611,82952,54165,-28787
20506,0.0,0.0,0.0,3611,82956,54165,-28791
20507,0.0,0.0,0.0,3611,82960,54165,-28795
20508,0.0,0.0,0.0,3611,82964,54165,-28799
20509,0.0,0.0,0.0,3611,82968,54165,-28803
20510,0.0,0.0,0.0,3611,82972,54165,-28807
20511,0.0,0.0,0.0,3611,82976,54165,-28811
20512,0.0,0.0,0.0,3611,82980,54165,-28815
20515,0.0,0.0,0.0,3611,82984,54165,-28819
20516,0.0,0.0,0.0,3611,82988,54165,-28823
20518,0.0,0.0,0.0,3611,82992,54165,-28827
20519,0.0,0.0,0.0,3611,82996,54165,-28831
20521,0.0,0.0,0.0,3611,83000,54165,-28835
20522,0.0,0.0,0.0,3611,83004,54165,-28839
20523,0.0,0.0,0.0,3611,83008,54165,-28843
20524,0.0,0.0,0.0,3611,83012,54165,-28847
20525,0.0,0.0,0.0,3611,83016,54165,-28851
20526,0.0,0.0,0.0,3611,83020,54165,-28855
20527,0.0,0.0,0.0,3611,83024,54165,-28859
20528,0.0,0.0,0.0,3611,83028,54165,-28863
20529,0.0,0.0,0.0,3611,83032,54165,-28867
20530,0.0,0.0,0.0,3611,83036,54165,-28871
20531,0.0,0.0,0.0,3611,83040,54165,-28875
20532,0.0,0.0,0.0,3611,83044,54165,-28879
20533,0.0,0.0,0.0,3611,83048,54165,-28883
20534,0.0,0.0,0.0,3611,83052,54165,-28887
20535,0.0,0.0,0.0,3611,83056,54165,-28891
20536,0.0,0.0,0.0,3611,83060,54165,-28895
20537,0.0,0.0,0.0,3611,83064,54165,-28899
20538,0.0,0.0,0.0,3611,83068,54165,-28903
20539,0.0,0.0,0.0,3611,83072,54165,-28907
20540,0.0,0.0,0.0,3611,83076,54165,-28911
20542,0.0,0.0,0.0,3611,83080,54165,-28915
20543,0.0,0.0,0.0,3611,83084,54165,-28919
20544,0.0,0.0,0.0,3611,83088,54165,-28923
20545,0.0,0.0,0.0,3611,83092,54165,-28927
20547,0.0,0.0,0.0,3611,83096,54165,-28931
20549,0.0,0.0,0.0,3611,83100,54165,-28935
20550,0.0,0.0,0.0,3611,83104,54165,-28939
20551,0.0,0.0,0.0,3611,83108,54165,-28943
20552,0.0,0.0,0.0,3611,83112,54165,-28947
20553,0.0,0.0,0.0,3611,83116,54165,-28951
20554,0.0,0.0,0.0,3611,83120,54165,-28955
20555,0.0,0.0,0.0,3611,83124,54165,-28959
20556,0.0,0.0,0.0,3611,83128,54165,-28963
20557,0.0,0.0,0.0,3611,83132,54165,-28967
20559,0.0,0.0,0.0,3611,83136,54165,-28971
20560,0.0,0.0,0.0,3611,83140,54165,-28975
20561,0.0,0.0,0.0,3611,83144,54165,-28979
20562,0.0,0.0,0.0,3611,83148,54165,-28983
20563,0.0,0.0,0.0,3611,83152,54165,-28987
20564,0.0,0.0,0.0,3611,83156,54165,-28991
20565,0.0,0.0,0.0,3611,83160,54165,-28995
20566,0.0,0.0,0.0,3611,83164,54165,-28999
20567,0.0,0.0,0.0,3611,83168,54165,-29003
20568,0.0,0.0,0.0,3611,83172,54165,-29007
20569,0.0,0.0,0.0,3611,83176,54165,-29011
20570,0.0,0.0,0.0,3611,83180,54165,-29015
20571,0.0,0.0,0.0,3611,83184,54165,-29019
20574,0.0,0.0,0.0,3611,83188,54165,-29023
20575,0.0,0.0,0.0,3611,83192,54165,-29027
20576,0.0,0.0,0.0,3611,83196,54165,-29031
20577,0.0,0.0,0.0,3611,83200,54165,-29035
20579,0.0,0.0,0.0,3611,83204,54165,-29039
20581,0.0,0.0,0.0,3611,83208,54165,-29043
20582,0.0,0.0,0.0,3611,83212,54165,-29047
20583,0.0,0.0,0.0,3611,83216,54165,-29051
20584,0.0,0.0,0.0,3611,83220,54165,-29055
20585,0.0,0.0,0.0,3611,83224,54165,-29059
20586,0.0,0.0,0.0,3611,83228,54165,-29063
20588,0.0,0.0,0.0,3611,83232,54165,-29067
20589,0.0,0.0,0.0,3611,83236,54165,-29071
20590,0.0,0.0,0.0,3611,83240,54165,-29075
20591,0.0,0.0,0.0,3611,83244,54165,-29079
20592,0.0,0.0,0.0,3611,83248,54165,-29083
20593,0.0,0.0,0.0,3611,83252,54165,-29087
20594,0.0,0.0,0.0,3611,83256,54165,-29091
20595,0.0,0.0,0.0,3611,83260,54165,-29095
20597,0.0,0.0,0.0,3611,83264,54165,-29099
20599,0.0,0.0,0.0,3611,83268,54165,-29103
20600,0.0,0.0,0.0,3611,83272,54165,-29107
20601,0.0,0.0,0.0,3611,83276,54165,-29111
20602,0.0,0.0,0.0,3611,83280,54165,-29115
20604,0.0,0.0,0.0,3611,83284,54165,-29119
20606,0.0,0.0,0.0,3611,83288,54165,-29123
20607,0.0,0.0,0.0,3611,83292,54165,-29127
20608,0.0,0.0,0.0,3611,83296,54165,-29131
20609,0.0,0.0,0.0,3611,83300,54165,-29135
20610,0.0,0.0,0.0,3611,83304,54165,-29139
20612,0.0,0.0,0.0,3611,83308,54165,-29143
20613,0.0,0.0,0.0,3611,83312,54165,-29147
20614,0.0,0.0,0.0,3611,83316,54165,-29151
20616,0.0,0.0,0.0,3611,83320,54165,-29155
20618,0.0,0.0,0.0,3611,83324,54165,-29159
20619,0.0,0.0,0.0,3611,83328,54165,-29163
20622,0.0,0.0,0.0,3611,83332,54165,-29167
20623,0.0,0.0,0.0,3611,83336,54165,-29171
20624,0.0,0.0,0.0,3611,83340,54165,-29175
20625,0.0,0.0,0.0,3611,83344,54165,-29179
20626,0.0,0.0,0.0,3611,83348,54165,-29183
20627,0.0,0.0,0.0,3611,83352,54165,-29187
20628,0.0,0.0,0.0,3611,83356,54165,-29191
20629,0.0,0.0,0.0,3611,83360,54165,-29195
20631,0.0,0.0,0.0,3611,83364,54165,-29199
20632,0.0,0.0,0.0,3611,83368,54165,-29203
20633,0.0,0.0,0.0,3611,83372,54165,-29207
20634,0.0,0.0,0.0,3611,83376,54165,-29211
20635,0.0,0.0,0.0,3611,83380,54165,-29215
20637,0.0,0.0,0.0,3611,83384,54165,-29219
20639,0.0,0.0,0.0,3611,83388,54165,-29223
20640,0.0,0.0,0.0,3611,83392,54165,-29227
20642,0.0,0.0,0.0,3611,83396,54165,-29231
20644,0.0,0.0,0.0,3611,83400,54165,-29235
20646,0.0,0.0,0.0,3611,83404,54165,-29239
20647,0.0,0.0,0.0,3611,83408,54165,-29243
20648,0.0,0.0,0.0,3611,83412,54165,-29247
20649,0.0,0.0,0.0,3611,83416,54165,-29251
20652,0.0,0.0,0.0,3611,83420,54165,-29255
20653,0.0,0.0,0.0,3611,83424,54165,-29259
20654,0.0,0.0,0.0,3611,83428,54165,-29263
20655,0.0,0.0,0.0,3611,83432,54165,-29267
20657,0.0,0.0,0.0,3611,83436,54165,-29271
20658,0.0,0.0,0.0,3611,83440,54165,-29275
20659,0.0,0.0,0.0,3611,83444,54165,-29279
20660,0.0,0.0,0.0,3611,83448,54165,-29283
20661,0.0,0.0,0.0,3611,83452,54165,-29287
20662,0.0,0.0,0.0,3611,83456,54165,-29291
20663,0.0,0.0,0.0,3611,83460,54165,-29295
20664,0.0,0.0,0.0,3611,83464,54165,-29299
20665,0.0,0.0,0.0,3611,83468,54165,-29303
20666,0.0,0.0,0.0,3611,83472,54165,-29307
20667,0.0,0.0,0.0,3611,83476,54165,-29311
20668,0.0,0.0,0.0,3611,83480,54165,-29315
20669,0.0,0.0,0.0,3611,83484,54165,-29319
20670,0.0,0.0,0.0,3611,83488,54165,-29323
20672,0.0,0.0,0.0,3611,83492,54165,-29327
20674,0.0,0.0,0.0,3611,83496,54165,-29331
20675,0.0,0.0,0.0,3611,83500,54165,-29335
20676,0.0,0.0,0.0,3611,83504,54165,-29339
20677,0.0,0.0,0.0,3611,83508,54165,-29343
20678,0.0,0.0,0.0,3611,83512,54165,-29347
20679,0.0,0.0,0.0,3611,83516,54165,-29351
20681,0.0,0.0,0.0,3611,83520,54165,-29355
20682,0.0,0.0,0.0,3611,83524,54165,-29359
20683,0.0,0.0,0.0,3611,83528,54165,-29363
20684,0.0,0.0,0.0,3611,83532,54165,-29367
20685,0.0,0.0,0.0,3611,83536,54165,-29371
20686,0.0,0.0,0.0,3611,83540,54165,-29375
20687,0.0,0.0,0.0,3611,83544,54165,-29379
20689,0.0,0.0,0.0,3611,83548,54165,-29383
20690,0.0,0.0,0.0,3611,83552,54165,-29387
20691,0.0,0.0,0.0,3611,83556,54165,-29391
20693,0.0,0.0,0.0,3611,83560,54165,-29395
20695,0.0,0.0,0.0,3611,83564,54165,-29399
20696,0.0,0.0,0.0,3611,83568,54165,-29403
20697,0.0,0.0,0.0,3611,83572,54165,-29407
20698,0.0,0.0,0.0,3611,83576,54165,-29411
20700,0.0,0.0,0.0,3611,83580,54165,-29415
20702,0.0,0.0,0.0,3611,83584,54165,-29419
20705,0.0,0.0,0.0,3611,83588,54165,-29423
20706,0.0,0.0,0.0,3611,83592,54165,-29427
20708,0.0,0.0,0.0,3611,83596,54165,-29431
20709,0.0,0.0,0.0,3611,83600,54165,-29435
20710,0.0,0.0,0.0,3611,83604,54165,-29439
20717,0.0,0.0,0.0,3611,83608,54165,-29443
20718,0.0,0.0,0.0,3611,83612,54165,-29447
20719,0.0,0.0,0.0,3611,83616,54165,-29451
20720,0.0,0.0,0.0,3611,83620,54165,-29455
20722,0.0,0.0,0.0,3611,83624,54165,-29459
20723,0.0,0.0,0.0,3611,83628,54165,-29463
20725,0.0,0.0,0.0,3611,83632,54165,-29467
20726,0.0,0.0,0.0,3611,83636,54165,-29471
20727,0.0,0.0,0.0,3611,83640,54165,-29475
20728,0.0,0.0,0.0,3611,83644,54165,-29479
20730,0.0,0.0,0.0,3611,83648,54165,-29483
20731,0.0,0.0,0.0,3611,83652,54165,-29487
20732,0.0,0.0,0.0,3611,83656,54165,-29491
20733,0.0,0.0,0.0,3611,83660,54165,-29495
20734,0.0,0.0,0.0,3611,83664,54165,-29499
20735,0.0,0.0,0.0,3611,83668,54165,-29503
20736,0.0,0.0,0.0,3611,83672,54165,-29507
20737,0.0,0.0,0.0,3611,83676,54165,-29511
20740,0.0,0.0,0.0,3611,83680,54165,-29515
20741,0.0,0.0,0.0,3611,83684,54165,-29519
20742,0.0,0.0,0.0,3611,83688,54165,-29523
20743,0.0,0.0,0.0,3611,83692,54165,-29527
20744,0.0,0.0,0.0,3611,83696,54165,-29531
20745,0.0,0.0,0.0,3611,83700,54165,-29535
20746,0.0,0.0,0.0,3611,83704,54165,-29539
20747,0.0,0.0,0.0,3611,83708,54165,-29543
20748,0.0,0.0,0.0,3611,83712,54165,-29547
20750,0.0,0.0,0.0,3611,83716,54165,-29551
20751,0.0,0.0,0.0,3611,83720,54165,-29555
20752,0.0,0.0,0.0,3611,83724,54165,-29559
20753,0.0,0.0,0.0,3611,83728,54165,-29563
20754,0.0,0.0,0.0,3611,83732,54165,-29567
20755,0.0,0.0,0.0,3611,83736,54165,-29571
20757,0.0,0.0,0.0,3611,83740,54165,-29575
20758,0.0,0.0,0.0,3611,83744,54165,-29579
20759,0.0,0.0,0.0,3611,83748,54165,-29583
20760,0.0,0.0,0.0,3611,83752,54165,-29587
20761,0.0,0.0,0.0,3611,83756,54165,-29591
20762,0.0,0.0,0.0,3611,83760,54165,-29595
20763,0.0,0.0,0.0,3611,83764,54165,-29599
20764,0.0,0.0,0.0,3611,83768,54165,-29603
20766,0.0,0.0,0.0,3611,83772,54165,-29607
20767,0.0,0.0,0.0,3611,83776,54165,-29611
20771,0.0,0.0,0.0,3611,83780,54165,-29615
20773,0.0,0.0,0.0,3611,83784,54165,-29619
20774,0.0,0.0,0.0,3611,83788,54165,-29623
20776,0.0,0.0,0.0,3611,83792,54165,-29627
20777,0.0,0.0,0.0,3611,83796,54165,-29631
20778,0.0,0.0,0.0,3611,83800,54165,-29635
20779,0.0,0.0,0.0,3611,83804,54165,-29639
20780,0.0,0.0,0.0,3611,83808,54165,-29643
20783,0.0,0.0,0.0,3611,83812,54165,-29647
20784,0.0,0.0,0.0,3611,83816,54165,-29651
20786,0.0,0.0,0.0,3611,83820,54165,-29655
20787,0.0,0.0,0.0,3611,83824,54165,-29659
20788,0.0,0.0,0.0,3611,83828,54165,-29663
20789,0.0,0.0,0.0,3611,83832,54165,-29667
20790,0.0,0.0,0.0,3611,83836,54165,-29671
20792,0.0,0.0,0.0,3611,83840,54165,-29675
20793,0.0,0.0,0.0,3611,83844,54165,-29679
20794,0.0,0.0,0.0,3611,83848,54165,-29683
20795,0.0,0.0,0.0,3611,83852,54165,-29687
20796,0.0,0.0,0.0,3611,83856,54165,-29691
20797,0.0,0.0,0.0,3611,83860,54165,-29695
20799,0.0,0.0,0.0,3611,83864,54165,-29699
20800,0.0,0.0,0.0,3611,83868,54165,-29703
20801,0.0,0.0,0.0,3611,83872,54165,-29707
20802,0.0,0.0,0.0,3611,83876,54165,-29711
20803,0.0,0.0,0.0,3611,83880,54165,-29715
20805,0.0,0.0,0.0,3611,83884,54165,-29719
20806,0.0,0.0,0.0,3611,83888,54165,-29723
20807,0.0,0.0,0.0,3611,83892,54165,-29727
20808,0.0,0.0,0.0,3611,83896,54165,-29731
20809,0.0,0.0,0.0,3611,83900,54165,-29735
20811,0.0,0.0,0.0,3611,83904,54165,-29739
20812,0.0,0.0,0.0,3611,83908,54165,-29743
20813,0.0,0.0,0.0,3611,83912,54165,-29747
20814,0.0,0.0,0.0,3611,83916,54165,-29751
20815,0.0,0.0,0.0,3611,83920,54165,-29755
20817,0.0,0.0,0.0,3611,83924,54165,-29759
20819,0.0,0.0,0.0,3611,83928,54165,-29763
20820,0.0,0.0,0.0,3611,83932,54165,-29767
20821,0.0,0.0,0.0,3611,83936,54165,-29771
20822,0.0,0.0,0.0,3611,83940,54165,-29775
20824,0.0,0.0,0.0,3611,83944,54165,-29779
20826,0.0,0.0,0.0,3611,83948,54165,-29783
20827,0.0,0.0,0.0,3611,83952,54165,-29787
20829,0.0,0.0,0.0,3611,83956,54165,-29791
20830,0.0,0.0,0.0,3611,83960,54165,-29795
20831,0.0,0.0,0.0,3611,83964,54165,-29799
20832,0.0,0.0,0.0,3611,83968,54165,-29803
20833,0.0,0.0,0.0,3611,83972,54165,-29807
20834,0.0,0.0,0.0,3611,83976,54165,-29811
20835,0.0,0.0,0.0,3611,83980,54165,-29815
20836,0.0,0.0,0.0,3611,83984,54165,-29819
20837,0.0,0.0,0.0,3611,83988,54165,-29823
20838,0.0,0.0,0.0,3611,83992,54165,-29827
20839,0.0,0.0,0.0,3611,83996,54165,-29831
20840,0.0,0.0,0.0,3611,84000,54165,-29835
20842,0.0,0.0,0.0,3611,84004,54165,-29839
20843,0.0,0.0,0.0,3611,84008,54165,-29843
20844,0.0,0.0,0.0,3611,84012,54165,-29847
20846,0.0,0.0,0.0,3611,84016,54165,-29851
20847,0.0,0.0,0.0,3611,84020,54165,-29855
20848,0.0,0.0,0.0,3611,84024,54165,-29859
20849,0.0,0.0,0.0,3611,84028,54165,-29863
20850,0.0,0.0,0.0,3611,84032,54165,-29867
20851,0.0,0.0,0.0,3611,84036,54165,-29871
20852,0.0,0.0,0.0,3611,84040,54165,-29875
20853,0.0,0.0,0.0,3611,84044,54165,-29879
20854,0.0,0.0,0.0,3611,84048,54165,-29883
20855,0.0,0.0,0.0,3611,84052,54165,-29887
20856,0.0,0.0,0.0,3611,84056,54165,-29891
20857,0.0,0.0,0.0,3611,84060,54165,-29895
20858,0.0,0.0,0.0,3611,84064,54165,-29899
20859,0.0,0.0,0.0,3611,84068,54165,-29903
20860,0.0,0.0,0.0,3611,84072,54165,-29907
20861,0.0,0.0,0.0,3611,84076,54165,-29911
20863,0.0,0.0,0.0,3611,84080,54165,-29915
20864,0.0,0.0,0.0,3611,84084,54165,-29919
20865,0.0,0.0,0.0,3611,84088,54165,-29923
20866,0.0,0.0,0.0,3611,84092,54165,-29927
20867,0.0,0.0,0.0,3611,84096,54165,-29931
20870,0.0,0.0,0.0,3611,84100,54165,-29935
20871,0.0,0.0,0.0,3611,84104,54165,-29939
20872,0.0,0.0,0.0,3611,84108,54165,-29943
20874,0.0,0.0,0.0,3611,84112,54165,-29947
20875,0.0,0.0,0.0,3611,84116,54165,-29951
20876,0.0,0.0,0.0,3611,84120,54165,-29955
20877,0.0,0.0,0.0,3611,84124,54165,-29959
20878,0.0,0.0,0.0,3611,84128,54165,-29963
20879,0.0,0.0,0.0,3611,84132,54165,-29967
20880,0.0,0.0,0.0,3611,84136,54165,-29971
20881,0.0,0.0,0.0,3611,84140,54165,-29975
20883,0.0,0.0,0.0,3611,84144,54165,-29979
20884,0.0,0.0,0.0,3611,84148,54165,-29983
20885,0.0,0.0,0.0,3611,84152,54165,-29987
20886,0.0,0.0,0.0,3611,84156,54165,-29991
20887,0.0,0.0,0.0,3611,84160,54165,-29995
20888,0.0,0.0,0.0,3611,84164,54165,-29999
20889,0.0,0.0,0.0,3611,84168,54165,-30003
20890,0.0,0.0,0.0,3611,84172,54165,-30007
20891,0.0,0.0,0.0,3611,84176,54165,-30011
20892,0.0,0.0,0.0,3611,84180,54165,-30015
20893,0.0,0.0,0.0,3611,84184,54165,-30019
20894,0.0,0.0,0.0,3611,84188,54165,-30023
20896,0.0,0.0,0.0,3611,84192,54165,-30027
20897,0.0,0.0,0.0,3611,84196,54165,-30031
20898,0.0,0.0,0.0,3611,84200,54165,-30035
20899,0.0,0.0,0.0,3611,84204,54165,-30039
20900,0.0,0.0,0.0,3611,84208,54165,-30043
20901,0.0,0.0,0.0,3611,84212,54165,-30047
20902,0.0,0.0,0.0,3611,84216,54165,-30051
20903,0.0,0.0,0.0,3611,84220,54165,-30055
20904,0.0,0.0,0.0,3611,84224,54165,-30059
20905,0.0,0.0,0.0,3611,84228,54165,-30063
20906,0.0,0.0,0.0,3611,84232,54165,-30067
20907,0.0,0.0,0.0,3611,84236,54165,-30071
20908,0.0,0.0,0.0,3611,84240,54165,-30075
20909,0.0,0.0,0.0,3611,84244,54165,-30079
20910,0.0,0.0,0.0,3611,84248,54165,-30083
20911,0.0,0.0,0.0,3611,84252,54165,-30087
20912,0.0,0.0,0.0,3611,84256,54165,-30091
20913,0.0,0.0,0.0,3611,84260,54165,-30095
20914,0.0,0.0,0.0,3611,84264,54165,-30099
20915,0.0,0.0,0.0,3611,84268,54165,-30103
20916,0.0,0.0,0.0,3611,84272,54165,-30107
20917,0.0,0.0,0.0,3611,84276,54165,-30111
20918,0.0,0.0,0.0,3611,84280,54165,-30115
20920,0.0,0.0,0.0,3611,84284,54165,-30119
20922,0.0,0.0,0.0,3611,84288,54165,-30123
20923,0.0,0.0,0.0,3611,84292,54165,-30127
20925,0.0,0.0,0.0,3611,84296,54165,-30131
20927,0.0,0.0,0.0,3611,84300,54165,-30135
20928,0.0,0.0,0.0,3611,84304,54165,-30139
20929,0.0,0.0,0.0,3611,84308,54165,-30143
20930,0.0,0.0,0.0,3611,84312,54165,-30147
20931,0.0,0.0,0.0,3611,84316,54165,-30151
20932,0.0,0.0,0.0,3611,84320,54165,-30155
20933,0.0,0.0,0.0,3611,84324,54165,-30159
20934,0.0,0.0,0.0,3611,84328,54165,-30163
20936,0.0,0.0,0.0,3611,84332,54165,-30167
20937,0.0,0.0,0.0,3611,84336,54165,-30171
20938,0.0,0.0,0.0,3611,84340,54165,-30175
20939,0.0,0.0,0.0,3611,84344,54165,-30179
20940,0.0,0.0,0.0,3611,84348,54165,-30183
20941,0.0,0.0,0.0,3611,84352,54165,-30187
20942,0.0,0.0,0.0,3611,84356,54165,-30191
20943,0.0,0.0,0.0,3611,84360,54165,-30195
20944,0.0,0.0,0.0,3611,84364,54165,-30199
20946,0.0,0.0,0.0,3611,84368,54165,-30203
20948,0.0,0.0,0.0,3611,84372,54165,-30207
20949,0.0,0.0,0.0,3611,84376,54165,-30211
20950,0.0,0.0,0.0,3611,84380,54165,-30215
20951,0.0,0.0,0.0,3611,84384,54165,-30219
20952,0.0,0.0,0.0,3611,84388,54165,-30223
20953,0.0,0.0,0.0,3611,84392,54165,-30227
20954,0.0,0.0,0.0,3611,84396,54165,-30231
20955,0.0,0.0,0.0,3611,84400,54165,-30235
20956,0.0,0.0,0.0,3611,84404,54165,-30239
20957,0.0,0.0,0.0,3611,84408,54165,-30243
20958,0.0,0.0,0.0,3611,84412,54165,-30247
20959,0.0,0.0,0.0,3611,84416,54165,-30251
20960,0.0,0.0,0.0,3611,84420,54165,-30255
20961,0.0,0.0,0.0,3611,84424,54165,-30259
20962,0.0,0.0,0.0,3611,84428,54165,-30263
20963,0.0,0.0,0.0,3611,84432,54165,-30267
20964,0.0,0.0,0.0,3611,84436,54165,-30271
20965,0.0,0.0,0.0,3611,84440,54165,-30275
20966,0.0,0.0,0.0,3611,84444,54165,-30279
20968,0.0,0.0,0.0,3611,84448,54165,-30283
20969,0.0,0.0,0.0,3611,84452,54165,-30287
20970,0.0,0.0,0.0,3611,84456,54165,-30291
20971,0.0,0.0,0.0,3611,84460,54165,-30295
20972,0.0,0.0,0.0,3611,84464,54165,-30299
20973,0.0,0.0,0.0,3611,84468,54165,-30303
20974,0.0,0.0,0.0,3611,84472,54165,-30307
20975,0.0,0.0,0.0,3611,84476,54165,-30311
20976,0.0,0.0,0.0,3611,84480,54165,-30315
20977,0.0,0.0,0.0,3611,84484,54165,-30319
20978,0.0,0.0,0.0,3611,84488,54165,-30323
20981,0.0,0.0,0.0,3611,84492,54165,-30327
20984,0.0,0.0,0.0,3611,84496,54165,-30331
20985,0.0,0.0,0.0,3611,84500,54165,-30335
20986,0.0,0.0,0.0,3611,84504,54165,-30339
20987,0.0,0.0,0.0,3611,84508,54165,-30343
20988,0.0,0.0,0.0,3611,84512,54165,-30347
20989,0.0,0.0,0.0,3611,84516,54165,-30351
20990,0.0,0.0,0.0,3611,84520,54165,-30355
20991,0.0,0.0,0.0,3611,84524,54165,-30359
20992,0.0,0.0,0.0,3611,84528,54165,-30363
20993,0.0,0.0,0.0,3611,84532,54165,-30367
20994,0.0,0.0,0.0,3611,84536,54165,-30371
20995,0.0,0.0,0.0,3611,84540,54165,-30375
20996,0.0,0.0,0.0,3611,84544,54165,-30379
20997,0.0,0.0,0.0,3611,84548,54165,-30383
20998,0.0,0.0,0.0,3611,84552,54165,-30387
20999,0.0,0.0,0.0,3611,84556,54165,-30391
21000,0.0,0.0,0.0,3611,84560,54165,-30395
21001,0.0,0.0,0.0,3611,84564,54165,-30399
21002,0.0,0.0,0.0,3611,84568,54165,-30403
21003,0.0,0.0,0.0,3611,84572,54165,-30407
21004,0.0,0.0,0.0,3611,84576,54165,-30411
21005,0.0,0.0,0.0,3611,84580,54165,-30415
21006,0.0,0.0,0.0,3611,84584,54165,-30419
21007,0.0,0.0,0.0,3611,84588,54165,-30423
21008,0.0,0.0,0.0,3611,84592,54165,-30427
21009,0.0,0.0,0.0,3611,84596,54165,-30431
21010,0.0,0.0,0.0,3611,84600,54165,-30435
21011,0.0,0.0,0.0,3611,84604,54165,-30439
21012,0.0,0.0,0.0,3611,84608,54165,-30443
21013,0.0,0.0,0.0,3611,84612,54165,-30447
21015,0.0,0.0,0.0,3611,84616,54165,-30451
21016,0.0,0.0,0.0,3611,84620,54165,-30455
21017,0.0,0.0,0.0,3611,84624,54165,-30459
21018,0.0,0.0,0.0,3611,84628,54165,-30463
21020,0.0,0.0,0.0,3611,84632,54165,-30467
21021,0.0,0.0,0.0,3611,84636,54165,-30471
21022,0.0,0.0,0.0,3611,84640,54165,-30475
21023,0.0,0.0,0.0,3611,84644,54165,-30479
21024,0.0,0.0,0.0,3611,84648,54165,-30483
21025,0.0,0.0,0.0,3611,84652,54165,-30487
21027,0.0,0.0,0.0,3611,84656,54165,-30491
21028,0.0,0.0,0.0,3611,84660,54165,-30495
21029,0.0,0.0,0.0,3611,84664,54165,-30499
21030,0.0,0.0,0.0,3611,84668,54165,-30503
21031,0.0,0.0,0.0,3611,84672,54165,-30507
21032,0.0,0.0,0.0,3611,84676,54165,-30511
21034,0.0,0.0,0.0,3611,84680,54165,-30515
21035,0.0,0.0,0.0,3611,84684,54165,-30519
21036,0.0,0.0,0.0,3611,84688,54165,-30523
21037,0.0,0.0,0.0,3611,84692,54165,-30527
21038,0.0,0.0,0.0,3611,84696,54165,-30531
21039,0.0,0.0,0.0,3611,84700,54165,-30535
21040,0.0,0.0,0.0,3611,84704,54165,-30539
21042,0.0,0.0,0.0,3611,84708,54165,-30543
21045,0.0,0.0,0.0,3611,84712,54165,-30547
21046,0.0,0.0,0.0,3611,84716,54165,-30551
21048,0.0,0.0,0.0,3611,84720,54165,-30555
21049,0.0,0.0,0.0,3611,84724,54165,-30559
21050,0.0,0.0,0.0,3611,84728,54165,-30563
21051,0.0,0.0,0.0,3611,84732,54165,-30567
21052,0.0,0.0,0.0,3611,84736,54165,-30571
21053,0.0,0.0,0.0,3611,84740,54165,-30575
21054,0.0,0.0,0.0,3611,84744,54165,-30579
21055,0.0,0.0,0.0,3611,84748,54165,-30583
21056,0.0,0.0,0.0,3611,84752,54165,-30587
21057,0.0,0.0,0.0,3611,84756,54165,-30591
21058,0.0,0.0,0.0,3611,84760,54165,-30595
21059,0.0,0.0,0.0,3611,84764,54165,-30599
21060,0.0,0.0,0.0,3611,84768,54165,-30603
21061,0.0,0.0,0.0,3611,84772,54165,-30607
21062,0.0,0.0,0.0,3611,84776,54165,-30611
21063,0.0,0.0,0.0,3611,84780,54165,-30615
21064,0.0,0.0,0.0,3611,84784,54165,-30619
21066,0.0,0.0,0.0,3611,84788,54165,-30623
21067,0.0,0.0,0.0,3611,84792,54165,-30627
21068,0.0,0.0,0.0,3611,84796,54165,-30631
21070,0.0,0.0,0.0,3611,84800,54165,-30635
21072,0.0,0.0,0.0,3611,84804,54165,-30639
21073,0.0,0.0,0.0,3611,84808,54165,-30643
21074,0.0,0.0,0.0,3611,84812,54165,-30647
21076,0.0,0.0,0.0,3611,84816,54165,-30651
21077,0.0,0.0,0.0,3611,84820,54165,-30655
21078,0.0,0.0,0.0,3611,84824,54165,-30659
21079,0.0,0.0,0.0,3611,84828,54165,-30663
21080,0.0,0.0,0.0,3611,84832,54165,-30667
21081,0.0,0.0,0.0,3611,84836,54165,-30671
21082,0.0,0.0,0.0,3611,84840,54165,-30675
21084,0.0,0.0,0.0,3611,84844,54165,-30679
21086,0.0,0.0,0.0,3611,84848,54165,-30683
21089,0.0,0.0,0.0,3611,84852,54165,-30687
21091,0.0,0.0,0.0,3611,84856,54165,-30691
21093,0.0,0.0,0.0,3611,84860,54165,-30695
21094,0.0,0.0,0.0,3611,84864,54165,-30699
21095,0.0,0.0,0.0,3611,84868,54165,-30703
21097,0.0,0.0,0.0,3611,84872,54165,-30707
21098,0.0,0.0,0.0,3611,84876,54165,-30711
21099,0.0,0.0,0.0,3611,84880,54165,-30715
21100,0.0,0.0,0.0,3611,84884,54165,-30719
21101,0.0,0.0,0.0,3611,84888,54165,-30723
21102,0.0,0.0,0.0,3611,84892,54165,-30727
21103,0.0,0.0,0.0,3611,84896,54165,-30731
21104,0.0,0.0,0.0,3611,84900,54165,-30735
21105,0.0,0.0,0.0,3611,84904,54165,-30739
21106,0.0,0.0,0.0,3611,84908,54165,-30743
21108,0.0,0.0,0.0,3611,84912,54165,-30747
21109,0.0,0.0,0.0,3611,84916,54165,-30751
21111,0.0,0.0,0.0,3611,84920,54165,-30755
21112,0.0,0.0,0.0,3611,84924,54165,-30759
21113,0.0,0.0,0.0,3611,84928,54165,-30763
21114,0.0,0.0,0.0,3611,84932,54165,-30767
21115,0.0,0.0,0.0,3611,84936,54165,-30771
21116,0.0,0.0,0.0,3611,84940,54165,-30775
21117,0.0,0.0,0.0,3611,84944,54165,-30779
21119,0.0,0.0,0.0,3611,84948,54165,-30783
21120,0.0,0.0,0.0,3611,84952,54165,-30787
21121,0.0,0.0,0.0,3611,84956,54165,-30791
21122,0.0,0.0,0.0,3611,84960,54165,-30795
21124,0.0,0.0,0.0,3611,84964,54165,-30799
21125,0.0,0.0,0.0,3611,84968,54165,-30803
21126,0.0,0.0,0.0,3611,84972,54165,-30807
21127,0.0,0.0,0.0,3611,84976,54165,-30811
21128,0.0,0.0,0.0,3611,84980,54165,-30815
21129,0.0,0.0,0.0,3611,84984,54165,-30819
21130,0.0,0.0,0.0,3611,84988,54165,-30823
21131,0.0,0.0,0.0,3611,84992,54165,-30827
21132,0.0,0.0,0.0,3611,84996,54165,-30831
21133,0.0,0.0,0.0,3611,85000,54165,-30835
21134,0.0,0.0,0.0,3611,85004,54165,-30839
21135,0.0,0.0,0.0,3611,85008,54165,-30843
21136,0.0,0.0,0.0,3611,85012,54165,-30847
21137,0.0,0.0,0.0,3611,85016,54165,-30851
21138,0.0,0.0,0.0,3611,85020,54165,-30855
21139,0.0,0.0,0.0,3611,85024,54165,-30859
21142,0.0,0.0,0.0,3611,85028,54165,-30863
21144,0.0,0.0,0.0,3611,85032,54165,-30867
21145,0.0,0.0,0.0,3611,85036,54165,-30871
21146,0.0,0.0,0.0,3611,85040,54165,-30875
21147,0.0,0.0,0.0,3611,85044,54165,-30879
21148,0.0,0.0,0.0,3611,85048,54165,-30883
21149,0.0,0.0,0.0,3611,85052,54165,-30887
21150,0.0,0.0,0.0,3611,85056,54165,-30891
21151,0.0,0.0,0.0,3611,85060,54165,-30895
21153,0.0,0.0,0.0,3611,85064,54165,-30899
21154,0.0,0.0,0.0,3611,85068,54165,-30903
21157,0.0,0.0,0.0,3611,85072,54165,-30907
21158,0.0,0.0,0.0,3611,85076,54165,-30911
21160,0.0,0.0,0.0,3611,85080,54165,-30915
21161,0.0,0.0,0.0,3611,85084,54165,-30919
21162,0.0,0.0,0.0,3611,85088,54165,-30923
21163,0.0,0.0,0.0,3611,85092,54165,-30927
21164,0.0,0.0,0.0,3611,85096,54165,-30931
21165,0.0,0.0,0.0,3611,85100,54165,-30935
21166,0.0,0.0,0.0,3611,85104,54165,-30939
21168,0.0,0.0,0.0,3611,85108,54165,-30943
21169,0.0,0.0,0.0,3611,85112,54165,-30947
21170,0.0,0.0,0.0,3611,85116,54165,-30951
21171,0.0,0.0,0.0,3611,85120,54165,-30955
21172,0.0,0.0,0.0,3611,85124,54165,-30959
21173,0.0,0.0,0.0,3611,85128,54165,-30963
21175,0.0,0.0,0.0,3611,85132,54165,-30967
21176,0.0,0.0,0.0,3611,85136,54165,-30971
21177,0.0,0.0,0.0,3611,85140,54165,-30975
21178,0.0,0.0,0.0,3611,85144,54165,-30979
21179,0.0,0.0,0.0,3611,85148,54165,-30983
21180,0.0,0.0,0.0,3611,85152,54165,-30987
21182,0.0,0.0,0.0,3611,85156,54165,-30991
21183,0.0,0.0,0.0,3611,85160,54165,-30995
21184,0.0,0.0,0.0,3611,85164,54165,-30999
21185,0.0,0.0,0.0,3611,85168,54165,-31003
21186,0.0,0.0,0.0,3611,85172,54165,-31007
21187,0.0,0.0,0.0,3611,85176,54165,-31011
21189,0.0,0.0,0.0,3611,85180,54165,-31015
21190,0.0,0.0,0.0,3611,85184,54165,-31019
21191,0.0,0.0,0.0,3611,85188,54165,-31023
21192,0.0,0.0,0.0,3611,85192,54165,-31027
21193,0.0,0.0,0.0,3611,85196,54165,-31031
21194,0.0,0.0,0.0,3611,85200,54165,-31035
21195,0.0,0.0,0.0,3611,85204,54165,-31039
21197,0.0,0.0,0.0,3611,85208,54165,-31043
21198,0.0,0.0,0.0,3611,85212,54165,-31047
21199,0.0,0.0,0.0,3611,85216,54165,-31051
21200,0.0,0.0,0.0,3611,85220,54165,-31055
21201,0.0,0.0,0.0,3611,85224,54165,-31059
21202,0.0,0.0,0.0,3611,85228,54165,-31063
21204,0.0,0.0,0.0,3611,85232,54165,-31067
21206,0.0,0.0,0.0,3611,85236,54165,-31071
21207,0.0,0.0,0.0,3611,85240,54165,-31075
21208,0.0,0.0,0.0,3611,85244,54165,-31079
21209,0.0,0.0,0.0,3611,85248,54165,-31083
21210,0.0,0.0,0.0,3611,85252,54165,-31087
21211,0.0,0.0,0.0,3611,85256,54165,-31091
21212,0.0,0.0,0.0,3611,85260,54165,-31095
21213,0.0,0.0,0.0,3611,85264,54165,-31099
21215,0.0,0.0,0.0,3611,85268,54165,-31103
21216,0.0,0.0,0.0,3611,85272,54165,-31107
21217,0.0,0.0,0.0,3611,85276,54165,-31111
21218,0.0,0.0,0.0,3611,85280,54165,-31115
21219,0.0,0.0,0.0,3611,85284,54165,-31119
21220,0.0,0.0,0.0,3611,85288,54165,-31123
21221,0.0,0.0,0.0,3611,85292,54165,-31127
21222,0.0,0.0,0.0,3611,85296,54165,-31131
21223,0.0,0.0,0.0,3611,85300,54165,-31135
21226,0.0,0.0,0.0,3611,85304,54165,-31139
21227,0.0,0.0,0.0,3611,85308,54165,-31143
21228,0.0,0.0,0.0,3611,85312,54165,-31147
21230,0.0,0.0,0.0,3611,85316,54165,-31151
21232,0.0,0.0,0.0,3611,85320,54165,-31155
21233,0.0,0.0,0.0,3611,85324,54165,-31159
21234,0.0,0.0,0.0,3611,85328,54165,-31163
21235,0.0,0.0,0.0,3611,85332,54165,-31167
21236,0.0,0.0,0.0,3611,85336,54165,-31171
21237,0.0,0.0,0.0,3611,85340,54165,-31175
21238,0.0,0.0,0.0,3611,85344,54165,-31179
21239,0.0,0.0,0.0,3611,85348,54165,-31183
21243,0.0,0.0,0.0,3611,85352,54165,-31187
21244,0.0,0.0,0.0,3611,85356,54165,-31191
21245,0.0,0.0,0.0,3611,85360,54165,-31195
21246,0.0,0.0,0.0,3611,85364,54165,-31199
21247,0.0,0.0,0.0,3611,85368,54165,-31203
21248,0.0,0.0,0.0,3611,85372,54165,-31207
21249,0.0,0.0,0.0,3611,85376,54165,-31211
21252,0.0,0.0,0.0,3611,85380,54165,-31215
21253,0.0,0.0,0.0,3611,85384,54165,-31219
21254,0.0,0.0,0.0,3611,85388,54165,-31223
21255,0.0,0.0,0.0,3611,85392,54165,-31227
21256,0.0,0.0,0.0,3611,85396,54165,-31231
21258,0.0,0.0,0.0,3611,85400,54165,-31235
21259,0.0,0.0,0.0,3611,85404,54165,-31239
21260,0.0,0.0,0.0,3611,85408,54165,-31243
21261,0.0,0.0,0.0,3611,85412,54165,-31247
21262,0.0,0.0,0.0,3611,85416,54165,-31251
21263,0.0,0.0,0.0,3611,85420,54165,-31255
21265,0.0,0.0,0.0,3611,85424,54165,-31259
21266,0.0,0.0,0.0,3611,85428,54165,-31263
21267,0.0,0.0,0.0,3611,85432,54165,-31267
21268,0.0,0.0,0.0,3611,85436,54165,-31271
21269,0.0,0.0,0.0,3611,85440,54165,-31275
21270,0.0,0.0,0.0,3611,85444,54165,-31279
21271,0.0,0.0,0.0,3611,85448,54165,-31283
21272,0.0,0.0,0.0,3611,85452,54165,-31287
21273,0.0,0.0,0.0,3611,85456,54165,-31291
21274,0.0,0.0,0.0,3611,85460,54165,-31295
21275,0.0,0.0,0.0,3611,85464,54165,-31299
21276,0.0,0.0,0.0,3611,85468,54165,-31303
21277,0.0,0.0,0.0,3611,85472,54165,-31307
21278,0.0,0.0,0.0,3611,85476,54165,-31311
21279,0.0,0.0,0.0,3611,85480,54165,-31315
21280,0.0,0.0,0.0,3611,85484,54165,-31319
21281,0.0,0.0,0.0,3611,85488,54165,-31323
21282,0.0,0.0,0.0,3611,85492,54165,-31327
21283,0.0,0.0,0.0,3611,85496,54165,-31331
21284,0.0,0.0,0.0,3611,85500,54165,-31335
21285,0.0,0.0,0.0,3611,85504,54165,-31339
21286,0.0,0.0,0.0,3611,85508,54165,-31343
21287,0.0,0.0,0.0,3611,85512,54165,-31347
21288,0.0,0.0,0.0,3611,85516,54165,-31351
21289,0.0,0.0,0.0,3611,85520,54165,-31355
21290,0.0,0.0,0.0,3611,85524,54165,-31359
21291,0.0,0.0,0.0,3611,85528,54165,-31363
21292,0.0,0.0,0.0,3611,85532,54165,-31367
21293,0.0,0.0,0.0,3611,85536,54165,-31371
21294,0.0,0.0,0.0,3611,85540,54165,-31375
21295,0.0,0.0,0.0,3611,85544,54165,-31379
21296,0.0,0.0,0.0,3611,85548,54165,-31383
21298,0.0,0.0,0.0,3611,85552,54165,-31387
21299,0.0,0.0,0.0,3611,85556,54165,-31391
21300,0.0,0.0,0.0,3611,85560,54165,-31395
21302,0.0,0.0,0.0,3611,85564,54165,-31399
21303,0.0,0.0,0.0,3611,85568,54165,-31403
21304,0.0,0.0,0.0,3611,85572,54165,-31407
21305,0.0,0.0,0.0,3611,85576,54165,-31411
21306,0.0,0.0,0.0,3611,85580,54165,-31415
21307,0.0,0.0,0.0,3611,85584,54165,-31419
21309,0.0,0.0,0.0,3611,85588,54165,-31423
21310,0.0,0.0,0.0,3611,85592,54165,-31427
21311,0.0,0.0,0.0,3611,85596,54165,-31431
21312,0.0,0.0,0.0,3611,85600,54165,-31435
21313,0.0,0.0,0.0,3611,85604,54165,-31439
21314,0.0,0.0,0.0,3611,85608,54165,-31443
21315,0.0,0.0,0.0,3611,85612,54165,-31447
21316,0.0,0.0,0.0,3611,85616,54165,-31451
21317,0.0,0.0,0.0,3611,85620,54165,-31455
21319,0.0,0.0,0.0,3611,85624,54165,-31459
21320,0.0,0.0,0.0,3611,85628,54165,-31463
21321,0.0,0.0,0.0,3611,85632,54165,-31467
21322,0.0,0.0,0.0,3611,85636,54165,-31471
21324,0.0,0.0,0.0,3611,85640,54165,-31475
21325,0.0,0.0,0.0,3611,85644,54165,-31479
21327,0.0,0.0,0.0,3611,85648,54165,-31483
21328,0.0,0.0,0.0,3611,85652,54165,-31487
21329,0.0,0.0,0.0,3611,85656,54165,-31491
21330,0.0,0.0,0.0,3611,85660,54165,-31495
21331,0.0,0.0,0.0,3611,85664,54165,-31499
21333,0.0,0.0,0.0,3611,85668,54165,-31503
21334,0.0,0.0,0.0,3611,85672,54165,-31507
21338,0.0,0.0,0.0,3611,85676,54165,-31511
21340,0.0,0.0,0.0,3611,85680,54165,-31515
21341,0.0,0.0,0.0,3611,85684,54165,-31519
21342,0.0,0.0,0.0,3611,85688,54165,-31523
21343,0.0,0.0,0.0,3611,85692,54165,-31527
21344,0.0,0.0,0.0,3611,85696,54165,-31531
21345,0.0,0.0,0.0,3611,85700,54165,-31535
21346,0.0,0.0,0.0,3611,85704,54165,-31539
21347,0.0,0.0,0.0,3611,85708,54165,-31543
21348,0.0,0.0,0.0,3611,85712,54165,-31547
21349,0.0,0.0,0.0,3611,85716,54165,-31551
21350,0.0,0.0,0.0,3611,85720,54165,-31555
21351,0.0,0.0,0.0,3611,85724,54165,-31559
21352,0.0,0.0,0.0,3611,85728,54165,-31563
21353,0.0,0.0,0.0,3611,85732,54165,-31567
21355,0.0,0.0,0.0,3611,85736,54165,-31571
21356,0.0,0.0,0.0,3611,85740,54165,-31575
21357,0.0,0.0,0.0,3611,85744,54165,-31579
21358,0.0,0.0,0.0,3611,85748,54165,-31583
21359,0.0,0.0,0.0,3611,85752,54165,-31587
21360,0.0,0.0,0.0,3611,85756,54165,-31591
21361,0.0,0.0,0.0,3611,85760,54165,-31595
21362,0.0,0.0,0.0,3611,85764,54165,-31599
21363,0.0,0.0,0.0,3611,85768,54165,-31603
21364,0.0,0.0,0.0,3611,85772,54165,-31607
21366,0.0,0.0,0.0,3611,85776,54165,-31611
21367,0.0,0.0,0.0,3611,85780,54165,-31615
21368,0.0,0.0,0.0,3611,85784,54165,-31619
21370,0.0,0.0,0.0,3611,85788,54165,-31623
21371,0.0,0.0,0.0,3611,85792,54165,-31627
21372,0.0,0.0,0.0,3611,85796,54165,-31631
21373,0.0,0.0,0.0,3611,85800,54165,-31635
21374,0.0,0.0,0.0,3611,85804,54165,-31639
21376,0.0,0.0,0.0,3611,85808,54165,-31643
21377,0.0,0.0,0.0,3611,85812,54165,-31647
21378,0.0,0.0,0.0,3611,85816,54165,-31651
21379,0.0,0.0,0.0,3611,85820,54165,-31655
21380,0.0,0.0,0.0,3611,85824,54165,-31659
21381,0.0,0.0,0.0,3611,85828,54165,-31663
21382,0.0,0.0,0.0,3611,85832,54165,-31667
21383,0.0,0.0,0.0,3611,85836,54165,-31671
21384,0.0,0.0,0.0,3611,85840,54165,-31675
21385,0.0,0.0,0.0,3611,85844,54165,-31679
21386,0.0,0.0,0.0,3611,85848,54165,-31683
21387,0.0,0.0,0.0,3611,85852,54165,-31687
21388,0.0,0.0,0.0,3611,85856,54165,-31691
21389,0.0,0.0,0.0,3611,85860,54165,-31695
21390,0.0,0.0,0.0,3611,85864,54165,-31699
21391,0.0,0.0,0.0,3611,85868,54165,-31703
21392,0.0,0.0,0.0,3611,85872,54165,-31707
21394,0.0,0.0,0.0,3611,85876,54165,-31711
21395,0.0,0.0,0.0,3611,85880,54165,-31715
21396,0.0,0.0,0.0,3611,85884,54165,-31719
21398,0.0,0.0,0.0,3611,85888,54165,-31723
21401,0.0,0.0,0.0,3611,85892,54165,-31727
21402,0.0,0.0,0.0,3611,85896,54165,-31731
21403,0.0,0.0,0.0,3611,85900,54165,-31735
21404,0.0,0.0,0.0,3611,85904,54165,-31739
21405,0.0,0.0,0.0,3611,85908,54165,-31743
21406,0.0,0.0,0.0,3611,85912,54165,-31747
21407,0.0,0.0,0.0,3611,85916,54165,-31751
21408,0.0,0.0,0.0,3611,85920,54165,-31755
21409,0.0,0.0,0.0,3611,85924,54165,-31759
21410,0.0,0.0,0.0,3611,85928,54165,-31763
21411,0.0,0.0,0.0,3611,85932,54165,-31767
21412,0.0,0.0,0.0,3611,85936,54165,-31771
21413,0.0,0.0,0.0,3611,85940,54165,-31775
21414,0.0,0.0,0.0,3611,85944,54165,-31779
21415,0.0,0.0,0.0,3611,85948,54165,-31783
21416,0.0,0.0,0.0,3611,85952,54165,-31787
21417,0.0,0.0,0.0,3611,85956,54165,-31791
21418,0.0,0.0,0.0,3611,85960,54165,-31795
21419,0.0,0.0,0.0,3611,85964,54165,-31799
21421,0.0,0.0,0.0,3611,85968,54165,-31803
21422,0.0,0.0,0.0,3611,85972,54165,-31807
21423,0.0,0.0,0.0,3611,85976,54165,-31811
21424,0.0,0.0,0.0,3611,85980,54165,-31815
21425,0.0,0.0,0.0,3611,85984,54165,-31819
21427,0.0,0.0,0.0,3611,85988,54165,-31823
21428,0.0,0.0,0.0,3611,85992,54165,-31827
21429,0.0,0.0,0.0,3611,85996,54165,-31831
21430,0.0,0.0,0.0,3611,86000,54165,-31835
21431,0.0,0.0,0.0,3611,86004,54165,-31839
21432,0.0,0.0,0.0,3611,86008,54165,-31843
21433,0.0,0.0,0.0,3611,86012,54165,-31847
21434,0.0,0.0,0.0,3611,86016,54165,-31851
21435,0.0,0.0,0.0,3611,86020,54165,-31855
21436,0.0,0.0,0.0,3611,86024,54165,-31859
21438,0.0,0.0,0.0,3611,86028,54165,-31863
21439,0.0,0.0,0.0,3611,86032,54165,-31867
21440,0.0,0.0,0.0,3611,86036,54165,-31871
21441,0.0,0.0,0.0,3611,86040,54165,-31875
21442,0.0,0.0,0.0,3611,86044,54165,-31879
21443,0.0,0.0,0.0,3611,86048,54165,-31883
21445,0.0,0.0,0.0,3611,86052,54165,-31887
21446,0.0,0.0,0.0,3611,86056,54165,-31891
21447,0.0,0.0,0.0,3611,86060,54165,-31895
21448,0.0,0.0,0.0,3611,86064,54165,-31899
21450,0.0,0.0,0.0,3611,86068,54165,-31903
21451,0.0,0.0,0.0,3611,86072,54165,-31907
21452,0.0,0.0,0.0,3611,86076,54165,-31911
21453,0.0,0.0,0.0,3611,86080,54165,-31915
21454,0.0,0.0,0.0,3611,86084,54165,-31919
21455,0.0,0.0,0.0,3611,86088,54165,-31923
21456,0.0,0.0,0.0,3611,86092,54165,-31927
21457,0.0,0.0,0.0,3611,86096,54165,-31931
21458,0.0,0.0,0.0,3611,86100,54165,-31935
21459,0.0,0.0,0.0,3611,86104,54165,-31939
21461,0.0,0.0,0.0,3611,86108,54165,-31943
21462,0.0,0.0,0.0,3611,86112,54165,-31947
21463,0.0,0.0,0.0,3611,86116,54165,-31951
21464,0.0,0.0,0.0,3611,86120,54165,-31955
21465,0.0,0.0,0.0,3611,86124,54165,-31959
21466,0.0,0.0,0.0,3611,86128,54165,-31963
21468,0.0,0.0,0.0,3611,86132,54165,-31967
21469,0.0,0.0,0.0,3611,86136,54165,-31971
21470,0.0,0.0,0.0,3611,86140,54165,-31975
21471,0.0,0.0,0.0,3611,86144,54165,-31979
21472,0.0,0.0,0.0,3611,86148,54165,-31983
21473,0.0,0.0,0.0,3611,86152,54165,-31987
21474,0.0,0.0,0.0,3611,86156,54165,-31991
21475,0.0,0.0,0.0,3611,86160,54165,-31995
21476,0.0,0.0,0.0,3611,86164,54165,-31999
21477,0.0,0.0,0.0,3611,86168,54165,-32003
21478,0.0,0.0,0.0,3611,86172,54165,-32007
21479,0.0,0.0,0.0,3611,86176,54165,-32011
21480,0.0,0.0,0.0,3611,86180,54165,-32015
21482,0.0,0.0,0.0,3611,86184,54165,-32019
21483,0.0,0.0,0.0,3611,86188,54165,-32023
21484,0.0,0.0,0.0,3611,86192,54165,-32027
21485,0.0,0.0,0.0,3611,86196,54165,-32031
21486,0.0,0.0,0.0,3611,86200,54165,-32035
21487,0.0,0.0,0.0,3611,86204,54165,-32039
21488,0.0,0.0,0.0,3611,86208,54165,-32043
21489,0.0,0.0,0.0,3611,86212,54165,-32047
21490,0.0,0.0,0.0,3611,86216,54165,-32051
21491,0.0,0.0,0.0,3611,86220,54165,-32055
21492,0.0,0.0,0.0,3611,86224,54165,-32059
21494,0.0,0.0,0.0,3611,86228,54165,-32063
21495,0.0,0.0,0.0,3611,86232,54165,-32067
21497,0.0,0.0,0.0,3611,86236,54165,-32071
21498,0.0,0.0,0.0,3611,86240,54165,-32075
21499,0.0,0.0,0.0,3611,86244,54165,-32079
21500,0.0,0.0,0.0,3611,86248,54165,-32083
21501,0.0,0.0,0.0,3611,86252,54165,-32087
21502,0.0,0.0,0.0,3611,86256,54165,-32091
21503,0.0,0.0,0.0,3611,86260,54165,-32095
21504,0.0,0.0,0.0,3611,86264,54165,-32099
21505,0.0,0.0,0.0,3611,86268,54165,-32103
21506,0.0,0.0,0.0,3611,86272,54165,-32107
21507,0.0,0.0,0.0,3611,86276,54165,-32111
21509,0.0,0.0,0.0,3611,86280,54165,-32115
21510,0.0,0.0,0.0,3611,86284,54165,-32119
21511,0.0,0.0,0.0,3611,86288,54165,-32123
21512,0.0,0.0,0.0,3611,86292,54165,-32127
21513,0.0,0.0,0.0,3611,86296,54165,-32131
21515,0.0,0.0,0.0,3611,86300,54165,-32135
21517,0.0,0.0,0.0,3611,86304,54165,-32139
21519,0.0,0.0,0.0,3611,86308,54165,-32143
21520,0.0,0.0,0.0,3611,86312,54165,-32147
21521,0.0,0.0,0.0,3611,86316,54165,-32151
21522,0.0,0.0,0.0,3611,86320,54165,-32155
21523,0.0,0.0,0.0,3611,86324,54165,-32159
21524,0.0,0.0,0.0,3611,86328,54165,-32163
21526,0.0,0.0,0.0,3611,86332,54165,-32167
21527,0.0,0.0,0.0,3611,86336,54165,-32171
21528,0.0,0.0,0.0,3611,86340,54165,-32175
21529,0.0,0.0,0.0,3611,86344,54165,-32179
21530,0.0,0.0,0.0,3611,86348,54165,-32183
21531,0.0,0.0,0.0,3611,86352,54165,-32187
21532,0.0,0.0,0.0,3611,86356,54165,-32191
21533,0.0,0.0,0.0,3611,86360,54165,-32195
21534,0.0,0.0,0.0,3611,86364,54165,-32199
21535,0.0,0.0,0.0,3611,86368,54165,-32203
21539,0.0,0.0,0.0,3611,86372,54165,-32207
21540,0.0,0.0,0.0,3611,86376,54165,-32211
21541,0.0,0.0,0.0,3611,86380,54165,-32215
21542,0.0,0.0,0.0,3611,86384,54165,-32219
21543,0.0,0.0,0.0,3611,86388,54165,-32223
21544,0.0,0.0,0.0,3611,86392,54165,-32227
21545,0.0,0.0,0.0,3611,86396,54165,-32231
21546,0.0,0.0,0.0,3611,86400,54165,-32235
21548,0.0,0.0,0.0,3611,86404,54165,-32239
21549,0.0,0.0,0.0,3611,86408,54165,-32243
21551,0.0,0.0,0.0,3611,86412,54165,-32247
21552,0.0,0.0,0.0,3611,86416,54165,-32251
21553,0.0,0.0,0.0,3611,86420,54165,-32255
21554,0.0,0.0,0.0,3611,86424,54165,-32259
21555,0.0,0.0,0.0,3611,86428,54165,-32263
21556,0.0,0.0,0.0,3611,86432,54165,-32267
21557,0.0,0.0,0.0,3611,86436,54165,-32271
21558,0.0,0.0,0.0,3611,86440,54165,-32275
21559,0.0,0.0,0.0,3611,86444,54165,-32279
21560,0.0,0.0,0.0,3611,86448,54165,-32283
21562,0.0,0.0,0.0,3611,86452,54165,-32287
21564,0.0,0.0,0.0,3611,86456,54165,-32291
21566,0.0,0.0,0.0,3611,86460,54165,-32295
21567,0.0,0.0,0.0,3611,86464,54165,-32299
21568,0.0,0.0,0.0,3611,86468,54165,-32303
21569,0.0,0.0,0.0,3611,86472,54165,-32307
21572,0.0,0.0,0.0,3611,86476,54165,-32311
21573,0.0,0.0,0.0,3611,86480,54165,-32315
21576,0.0,0.0,0.0,3611,86484,54165,-32319
21577,0.0,0.0,0.0,3611,86488,54165,-32323
21578,0.0,0.0,0.0,3611,86492,54165,-32327
21580,0.0,0.0,0.0,3611,86496,54165,-32331
21581,0.0,0.0,0.0,3611,86500,54165,-32335
21582,0.0,0.0,0.0,3611,86504,54165,-32339
21583,0.0,0.0,0.0,3611,86508,54165,-32343
21584,0.0,0.0,0.0,3611,86512,54165,-32347
21585,0.0,0.0,0.0,3611,86516,54165,-32351
21586,0.0,0.0,0.0,3611,86520,54165,-32355
21587,0.0,0.0,0.0,3611,86524,54165,-32359
21588,0.0,0.0,0.0,3611,86528,54165,-32363
21589,0.0,0.0,0.0,3611,86532,54165,-32367
21590,0.0,0.0,0.0,3611,86536,54165,-32371
21591,0.0,0.0,0.0,3611,86540,54165,-32375
21594,0.0,0.0,0.0,3611,86544,54165,-32379
21595,0.0,0.0,0.0,3611,86548,54165,-32383
21597,0.0,0.0,0.0,3611,86552,54165,-32387
21598,0.0,0.0,0.0,3611,86556,54165,-32391
21599,0.0,0.0,0.0,3611,86560,54165,-32395
21600,0.0,0.0,0.0,3611,86564,54165,-32399
21601,0.0,0.0,0.0,3611,86568,54165,-32403
21602,0.0,0.0,0.0,3611,86572,54165,-32407
21603,0.0,0.0,0.0,3611,86576,54165,-32411
21604,0.0,0.0,0.0,3611,86580,54165,-32415
21605,0.0,0.0,0.0,3611,86584,54165,-32419
21607,0.0,0.0,0.0,3611,86588,54165,-32423
21608,0.0,0.0,0.0,3611,86592,54165,-32427
21609,0.0,0.0,0.0,3611,86596,54165,-32431
21610,0.0,0.0,0.0,3611,86600,54165,-32435
21611,0.0,0.0,0.0,3611,86604,54165,-32439
21612,0.0,0.0,0.0,3611,86608,54165,-32443
21616,0.0,0.0,0.0,3611,86612,54165,-32447
21617,0.0,0.0,0.0,3611,86616,54165,-32451
21618,0.0,0.0,0.0,3611,86620,54165,-32455
21619,0.0,0.0,0.0,3611,86624,54165,-32459
21620,0.0,0.0,0.0,3611,86628,54165,-32463
21621,0.0,0.0,0.0,3611,86632,54165,-32467
21622,0.0,0.0,0.0,3611,86636,54165,-32471
21625,0.0,0.0,0.0,3611,86640,54165,-32475
21627,0.0,0.0,0.0,3611,86644,54165,-32479
21628,0.0,0.0,0.0,3611,86648,54165,-32483
21629,0.0,0.0,0.0,3611,86652,54165,-32487
21630,0.0,0.0,0.0,3611,86656,54165,-32491
21632,0.0,0.0,0.0,3611,86660,54165,-32495
21633,0.0,0.0,0.0,3611,86664,54165,-32499
21634,0.0,0.0,0.0,3611,86668,54165,-32503
21636,0.0,0.0,0.0,3611,86672,54165,-32507
21637,0.0,0.0,0.0,3611,86676,54165,-32511
21638,0.0,0.0,0.0,3611,86680,54165,-32515
21639,0.0,0.0,0.0,3611,86684,54165,-32519
21640,0.0,0.0,0.0,3611,86688,54165,-32523
21641,0.0,0.0,0.0,3611,86692,54165,-32527
21643,0.0,0.0,0.0,3611,86696,54165,-32531
21644,0.0,0.0,0.0,3611,86700,54165,-32535
21645,0.0,0.0,0.0,3611,86704,54165,-32539
21646,0.0,0.0,0.0,3611,86708,54165,-32543
21647,0.0,0.0,0.0,3611,86712,54165,-32547
21649,0.0,0.0,0.0,3611,86716,54165,-32551
21650,0.0,0.0,0.0,3611,86720,54165,-32555
21651,0.0,0.0,0.0,3611,86724,54165,-32559
21652,0.0,0.0,0.0,3611,86728,54165,-32563
21653,0.0,0.0,0.0,3611,86732,54165,-32567
21654,0.0,0.0,0.0,3611,86736,54165,-32571
21656,0.0,0.0,0.0,3611,86740,54165,-32575
21658,0.0,0.0,0.0,3611,86744,54165,-32579
21659,0.0,0.0,0.0,3611,86748,54165,-32583
21661,0.0,0.0,0.0,3611,86752,54165,-32587
21662,0.0,0.0,0.0,3611,86756,54165,-32591
21666,0.0,0.0,0.0,3611,86760,54165,-32595
21667,0.0,0.0,0.0,3611,86764,54165,-32599
21668,0.0,0.0,0.0,3611,86768,54165,-32603
21669,0.0,0.0,0.0,3611,86772,54165,-32607
21670,0.0,0.0,0.0,3611,86776,54165,-32611
21671,0.0,0.0,0.0,3611,86780,54165,-32615
21672,0.0,0.0,0.0,3611,86784,54165,-32619
21673,0.0,0.0,0.0,3611,86788,54165,-32623
21674,0.0,0.0,0.0,3611,86792,54165,-32627
21675,0.0,0.0,0.0,3611,86796,54165,-32631
21677,0.0,0.0,0.0,3611,86800,54165,-32635
21679,0.0,0.0,0.0,3611,86804,54165,-32639
21680,0.0,0.0,0.0,3611,86808,54165,-32643
21681,0.0,0.0,0.0,3611,86812,54165,-32647
21682,0.0,0.0,0.0,3611,86816,54165,-32651
21683,0.0,0.0,0.0,3611,86820,54165,-32655
21684,0.0,0.0,0.0,3611,86824,54165,-32659
21686,0.0,0.0,0.0,3611,86828,54165,-32663
21687,0.0,0.0,0.0,3611,86832,54165,-32667
21688,0.0,0.0,0.0,3611,86836,54165,-32671
21690,0.0,0.0,0.0,3611,86840,54165,-32675
21692,0.0,0.0,0.0,3611,86844,54165,-32679
21693,0.0,0.0,0.0,3611,86848,54165,-32683
21695,0.0,0.0,0.0,3611,86852,54165,-32687
21697,0.0,0.0,0.0,3611,86856,54165,-32691
21698,0.0,0.0,0.0,3611,86860,54165,-32695
21699,0.0,0.0,0.0,3611,86864,54165,-32699
21708,0.0,0.0,0.0,3611,86868,54165,-32703
21709,0.0,0.0,0.0,3611,86872,54165,-32707
21710,0.0,0.0,0.0,3611,86876,54165,-32711
21711,0.0,0.0,0.0,3611,86880,54165,-32715
21712,0.0,0.0,0.0,3611,86884,54165,-32719
21713,0.0,0.0,0.0,3611,86888,54165,-32723
21714,0.0,0.0,0.0,3611,86892,54165,-32727
21715,0.0,0.0,0.0,3611,86896,54165,-32731
21717,0.0,0.0,0.0,3611,86900,54165,-32735
21718,0.0,0.0,0.0,3611,86904,54165,-32739
21719,0.0,0.0,0.0,3611,86908,54165,-32743
21720,0.0,0.0,0.0,3611,86912,54165,-32747
21722,0.0,0.0,0.0,3611,86916,54165,-32751
21723,0.0,0.0,0.0,3611,86920,54165,-32755
21725,0.0,0.0,0.0,3611,86924,54165,-32759
21726,0.0,0.0,0.0,3611,86928,54165,-32763
21728,0.0,0.0,0.0,3611,86932,54165,-32767
21729,0.0,0.0,0.0,3611,86936,54165,-32771
21730,0.0,0.0,0.0,3611,86940,54165,-32775
21733,0.0,0.0,0.0,3611,86944,54165,-32779
21734,0.0,0.0,0.0,3611,86948,54165,-32783
21735,0.0,0.0,0.0,3611,86952,54165,-32787
21736,0.0,0.0,0.0,3611,86956,54165,-32791
21737,0.0,0.0,0.0,3611,86960,54165,-32795
