index,actual,predicted,probability,cumulative_pos,cost,revenue,profit
1,0.0,0.0,0.0,0,4,0,-4
2,1.0,1.0,1.0,1,8,15,7
3,0.0,0.0,0.0,1,12,15,3
4,0.0,0.0,0.5,1,16,15,-1
5,0.0,0.0,0.0,1,20,15,-5
6,0.0,0.0,0.0,1,24,15,-9
7,0.0,0.0,0.0,1,28,15,-13
8,0.0,0.0,0.0,1,32,15,-17
9,0.0,0.0,0.0,1,36,15,-21
10,1.0,1.0,1.0,2,40,30,-10
11,1.0,0.0,0.5,3,44,45,1
12,0.0,0.0,0.0,3,48,45,-3
13,0.0,0.0,0.0,3,52,45,-7
14,0.0,0.0,0.0,3,56,45,-11
15,0.0,0.0,0.0,3,60,45,-15
16,0.0,0.0,0.0,3,64,45,-19
17,0.0,0.0,0.0,3,68,45,-23
18,0.0,0.0,0.0,3,72,45,-27
19,0.0,0.0,0.0,3,76,45,-31
20,0.0,0.0,0.0,3,80,45,-35
21,0.0,0.0,0.0,3,84,45,-39
22,0.0,0.0,0.0,3,88,45,-43
23,0.0,0.0,0.0,3,92,45,-47
24,0.0,0.0,0.0,3,96,45,-51
25,0.0,0.0,0.0,3,100,45,-55
26,0.0,0.0,0.0,3,104,45,-59
27,0.0,0.0,0.0,3,108,45,-63
28,0.0,0.0,0.0,3,112,45,-67
29,1.0,1.0,1.0,4,116,60,-56
30,0.0,0.0,0.0,4,120,60,-60
31,0.0,0.0,0.0,4,124,60,-64
32,1.0,1.0,1.0,5,128,75,-53
33,0.0,0.0,0.0,5,132,75,-57
34,0.0,0.0,0.0,5,136,75,-61
35,0.0,0.0,0.2,5,140,75,-65
36,0.0,0.0,0.0,5,144,75,-69
37,0.0,0.0,0.0,5,148,75,-73
38,0.0,0.0,0.0,5,152,75,-77
39,0.0,1.0,0.6666666666666666,5,156,75,-81
40,0.0,0.0,0.0,5,160,75,-85
41,0.0,0.0,0.0,5,164,75,-89
42,0.0,0.0,0.0,5,168,75,-93
43,0.0,0.0,0.0,5,172,75,-97
44,0.0,0.0,0.0,5,176,75,-101
45,0.0,0.0,0.0,5,180,75,-105
46,1.0,0.0,0.5,6,184,90,-94
47,1.0,1.0,1.0,7,188,105,-83
48,0.0,0.0,0.0,7,192,105,-87
49,0.0,0.0,0.0,7,196,105,-91
50,0.0,0.0,0.0,7,200,105,-95
51,0.0,0.0,0.0,7,204,105,-99
52,0.0,0.0,0.0,7,208,105,-103
53,1.0,0.0,0.2,8,212,120,-92
54,0.0,0.0,0.0,8,216,120,-96
55,0.0,0.0,0.0,8,220,120,-100
56,0.0,0.0,0.0,8,224,120,-104
57,0.0,0.0,0.0,8,228,120,-108
58,0.0,0.0,0.0,8,232,120,-112
59,0.0,0.0,0.0,8,236,120,-116
60,0.0,0.0,0.0,8,240,120,-120
61,1.0,1.0,0.6666666666666666,9,244,135,-109
62,0.0,0.0,0.0,9,248,135,-113
63,1.0,1.0,1.0,10,252,150,-102
64,0.0,0.0,0.0,10,256,150,-106
65,0.0,0.0,0.0,10,260,150,-110
66,0.0,0.0,0.0,10,264,150,-114
67,0.0,0.0,0.0,10,268,150,-118
68,0.0,0.0,0.0,10,272,150,-122
69,0.0,0.0,0.0,10,276,150,-126
70,1.0,0.0,0.25,11,280,165,-115
71,1.0,1.0,1.0,12,284,180,-104
72,0.0,0.0,0.0,12,288,180,-108
73,0.0,0.0,0.0,12,292,180,-112
74,0.0,0.0,0.5,12,296,180,-116
75,1.0,1.0,1.0,13,300,195,-105
76,0.0,0.0,0.0,13,304,195,-109
77,0.0,0.0,0.0,13,308,195,-113
78,0.0,0.0,0.0,13,312,195,-117
79,0.0,0.0,0.0,13,316,195,-121
80,0.0,0.0,0.0,13,320,195,-125
81,1.0,1.0,1.0,14,324,210,-114
82,0.0,0.0,0.0,14,328,210,-118
83,0.0,0.0,0.0,14,332,210,-122
84,0.0,0.0,0.0,14,336,210,-126
85,1.0,1.0,1.0,15,340,225,-115
86,0.0,0.0,0.0,15,344,225,-119
87,0.0,0.0,0.0,15,348,225,-123
88,0.0,0.0,0.0,15,352,225,-127
89,1.0,1.0,0.6666666666666666,16,356,240,-116
90,0.0,0.0,0.0,16,360,240,-120
91,1.0,1.0,0.6666666666666666,17,364,255,-109
92,0.0,0.0,0.0,17,368,255,-113
93,0.0,0.0,0.0,17,372,255,-117
94,0.0,0.0,0.0,17,376,255,-121
95,0.0,0.0,0.0,17,380,255,-125
96,1.0,1.0,1.0,18,384,270,-114
97,0.0,0.0,0.0,18,388,270,-118
98,0.0,0.0,0.0,18,392,270,-122
99,0.0,0.0,0.0,18,396,270,-126
100,0.0,0.0,0.0,18,400,270,-130
101,0.0,0.0,0.0,18,404,270,-134
102,0.0,0.0,0.0,18,408,270,-138
103,1.0,1.0,0.8,19,412,285,-127
104,0.0,0.0,0.0,19,416,285,-131
105,0.0,0.0,0.0,19,420,285,-135
106,0.0,0.0,0.0,19,424,285,-139
107,0.0,0.0,0.0,19,428,285,-143
108,0.0,0.0,0.0,19,432,285,-147
109,0.0,0.0,0.0,19,436,285,-151
110,0.0,0.0,0.0,19,440,285,-155
111,1.0,1.0,0.6666666666666666,20,444,300,-144
112,0.0,0.0,0.0,20,448,300,-148
113,0.0,0.0,0.0,20,452,300,-152
114,0.0,0.0,0.0,20,456,300,-156
115,0.0,0.0,0.0,20,460,300,-160
116,0.0,0.0,0.0,20,464,300,-164
117,0.0,0.0,0.0,20,468,300,-168
118,0.0,0.0,0.25,20,472,300,-172
119,0.0,0.0,0.0,20,476,300,-176
120,0.0,0.0,0.0,20,480,300,-180
121,0.0,0.0,0.0,20,484,300,-184
122,0.0,0.0,0.0,20,488,300,-188
123,0.0,0.0,0.0,20,492,300,-192
124,0.0,0.0,0.0,20,496,300,-196
125,1.0,1.0,1.0,21,500,315,-185
126,0.0,0.0,0.0,21,504,315,-189
127,0.0,0.0,0.0,21,508,315,-193
128,0.0,0.0,0.0,21,512,315,-197
129,0.0,0.0,0.0,21,516,315,-201
130,0.0,0.0,0.25,21,520,315,-205
131,1.0,1.0,1.0,22,524,330,-194
132,0.0,0.0,0.0,22,528,330,-198
133,0.0,0.0,0.0,22,532,330,-202
134,0.0,0.0,0.0,22,536,330,-206
135,0.0,0.0,0.0,22,540,330,-210
136,0.0,0.0,0.0,22,544,330,-214
137,0.0,0.0,0.0,22,548,330,-218
138,0.0,0.0,0.0,22,552,330,-222
139,0.0,0.0,0.0,22,556,330,-226
140,1.0,1.0,1.0,23,560,345,-215
141,0.0,0.0,0.0,23,564,345,-219
142,0.0,0.0,0.0,23,568,345,-223
143,1.0,1.0,1.0,24,572,360,-212
144,0.0,0.0,0.0,24,576,360,-216
145,0.0,0.0,0.0,24,580,360,-220
146,1.0,1.0,0.6666666666666666,25,584,375,-209
147,0.0,0.0,0.0,25,588,375,-213
148,0.0,0.0,0.0,25,592,375,-217
149,0.0,0.0,0.0,25,596,375,-221
150,0.0,0.0,0.0,25,600,375,-225
151,0.0,0.0,0.0,25,604,375,-229
152,0.0,0.0,0.0,25,608,375,-233
153,0.0,0.0,0.0,25,612,375,-237
154,0.0,0.0,0.0,25,616,375,-241
155,0.0,0.0,0.0,25,620,375,-245
156,0.0,0.0,0.0,25,624,375,-249
157,0.0,0.0,0.0,25,628,375,-253
158,0.0,0.0,0.0,25,632,375,-257
159,0.0,0.0,0.0,25,636,375,-261
160,0.0,1.0,0.6,25,640,375,-265
161,0.0,0.0,0.0,25,644,375,-269
162,0.0,0.0,0.0,25,648,375,-273
163,0.0,0.0,0.0,25,652,375,-277
164,0.0,0.0,0.0,25,656,375,-281
165,1.0,1.0,1.0,26,660,390,-270
166,0.0,0.0,0.0,26,664,390,-274
167,0.0,0.0,0.0,26,668,390,-278
168,1.0,1.0,1.0,27,672,405,-267
169,0.0,0.0,0.0,27,676,405,-271
170,1.0,1.0,1.0,28,680,420,-260
171,1.0,1.0,0.6,29,684,435,-249
172,0.0,0.0,0.0,29,688,435,-253
173,0.0,0.0,0.0,29,692,435,-257
174,0.0,0.0,0.0,29,696,435,-261
175,1.0,1.0,1.0,30,700,450,-250
176,0.0,0.0,0.0,30,704,450,-254
177,0.0,0.0,0.0,30,708,450,-258
178,0.0,0.0,0.0,30,712,450,-262
179,0.0,0.0,0.0,30,716,450,-266
180,0.0,0.0,0.0,30,720,450,-270
181,1.0,1.0,1.0,31,724,465,-259
182,0.0,0.0,0.3333333333333333,31,728,465,-263
183,0.0,0.0,0.0,31,732,465,-267
184,0.0,0.0,0.0,31,736,465,-271
185,0.0,0.0,0.5,31,740,465,-275
186,0.0,0.0,0.0,31,744,465,-279
187,0.0,0.0,0.0,31,748,465,-283
188,0.0,0.0,0.0,31,752,465,-287
189,0.0,0.0,0.0,31,756,465,-291
190,1.0,0.0,0.3333333333333333,32,760,480,-280
191,0.0,0.0,0.0,32,764,480,-284
192,0.0,0.0,0.0,32,768,480,-288
193,1.0,1.0,1.0,33,772,495,-277
194,0.0,0.0,0.0,33,776,495,-281
195,1.0,1.0,1.0,34,780,510,-270
196,0.0,0.0,0.0,34,784,510,-274
197,0.0,0.0,0.0,34,788,510,-278
198,0.0,0.0,0.0,34,792,510,-282
199,0.0,0.0,0.0,34,796,510,-286
200,0.0,0.0,0.0,34,800,510,-290
201,1.0,1.0,1.0,35,804,525,-279
202,1.0,1.0,1.0,36,808,540,-268
203,1.0,1.0,1.0,37,812,555,-257
204,0.0,0.0,0.0,37,816,555,-261
205,0.0,0.0,0.3333333333333333,37,820,555,-265
206,0.0,0.0,0.0,37,824,555,-269
207,0.0,0.0,0.0,37,828,555,-273
208,0.0,0.0,0.0,37,832,555,-277
209,0.0,0.0,0.0,37,836,555,-281
210,0.0,0.0,0.0,37,840,555,-285
211,0.0,0.0,0.0,37,844,555,-289
212,0.0,0.0,0.0,37,848,555,-293
213,0.0,0.0,0.0,37,852,555,-297
214,0.0,0.0,0.0,37,856,555,-301
215,0.0,0.0,0.0,37,860,555,-305
216,0.0,0.0,0.0,37,864,555,-309
217,0.0,0.0,0.0,37,868,555,-313
218,0.0,0.0,0.0,37,872,555,-317
219,0.0,0.0,0.0,37,876,555,-321
220,0.0,0.0,0.0,37,880,555,-325
221,0.0,0.0,0.0,37,884,555,-329
222,0.0,0.0,0.0,37,888,555,-333
223,0.0,0.0,0.0,37,892,555,-337
224,0.0,0.0,0.0,37,896,555,-341
225,0.0,0.0,0.0,37,900,555,-345
226,0.0,0.0,0.0,37,904,555,-349
227,0.0,0.0,0.0,37,908,555,-353
228,0.0,0.0,0.0,37,912,555,-357
229,1.0,1.0,1.0,38,916,570,-346
230,0.0,0.0,0.3333333333333333,38,920,570,-350
231,0.0,0.0,0.0,38,924,570,-354
232,0.0,0.0,0.0,38,928,570,-358
233,0.0,0.0,0.0,38,932,570,-362
234,0.0,0.0,0.0,38,936,570,-366
235,1.0,1.0,1.0,39,940,585,-355
236,0.0,0.0,0.0,39,944,585,-359
237,0.0,0.0,0.0,39,948,585,-363
238,1.0,1.0,0.6666666666666666,40,952,600,-352
239,1.0,1.0,1.0,41,956,615,-341
240,0.0,0.0,0.0,41,960,615,-345
241,1.0,0.0,0.5,42,964,630,-334
242,0.0,0.0,0.0,42,968,630,-338
243,0.0,0.0,0.0,42,972,630,-342
244,0.0,0.0,0.0,42,976,630,-346
245,0.0,0.0,0.0,42,980,630,-350
246,0.0,0.0,0.2,42,984,630,-354
247,0.0,0.0,0.0,42,988,630,-358
248,0.0,0.0,0.0,42,992,630,-362
249,0.0,0.0,0.0,42,996,630,-366
250,0.0,0.0,0.0,42,1000,630,-370
251,0.0,0.0,0.0,42,1004,630,-374
252,0.0,0.0,0.0,42,1008,630,-378
253,0.0,0.0,0.0,42,1012,630,-382
254,0.0,0.0,0.0,42,1016,630,-386
255,0.0,0.0,0.0,42,1020,630,-390
256,0.0,0.0,0.0,42,1024,630,-394
257,0.0,0.0,0.0,42,1028,630,-398
258,0.0,0.0,0.0,42,1032,630,-402
259,0.0,0.0,0.0,42,1036,630,-406
260,1.0,1.0,1.0,43,1040,645,-395
261,0.0,0.0,0.0,43,1044,645,-399
262,1.0,1.0,1.0,44,1048,660,-388
263,0.0,0.0,0.0,44,1052,660,-392
264,0.0,0.0,0.0,44,1056,660,-396
265,0.0,0.0,0.0,44,1060,660,-400
266,0.0,0.0,0.0,44,1064,660,-404
267,0.0,0.0,0.0,44,1068,660,-408
268,0.0,0.0,0.0,44,1072,660,-412
269,0.0,0.0,0.0,44,1076,660,-416
270,0.0,0.0,0.0,44,1080,660,-420
271,0.0,0.0,0.0,44,1084,660,-424
272,0.0,0.0,0.0,44,1088,660,-428
273,1.0,1.0,0.75,45,1092,675,-417
274,0.0,0.0,0.0,45,1096,675,-421
275,1.0,1.0,1.0,46,1100,690,-410
276,1.0,1.0,1.0,47,1104,705,-399
277,0.0,0.0,0.2,47,1108,705,-403
278,0.0,0.0,0.0,47,1112,705,-407
279,0.0,0.0,0.0,47,1116,705,-411
280,0.0,0.0,0.0,47,1120,705,-415
281,0.0,0.0,0.0,47,1124,705,-419
282,0.0,0.0,0.0,47,1128,705,-423
283,0.0,0.0,0.0,47,1132,705,-427
284,0.0,0.0,0.0,47,1136,705,-431
285,0.0,0.0,0.0,47,1140,705,-435
286,0.0,0.0,0.0,47,1144,705,-439
287,1.0,1.0,1.0,48,1148,720,-428
288,0.0,0.0,0.0,48,1152,720,-432
289,0.0,0.0,0.0,48,1156,720,-436
290,0.0,0.0,0.0,48,1160,720,-440
291,0.0,0.0,0.0,48,1164,720,-444
292,0.0,0.0,0.0,48,1168,720,-448
293,1.0,1.0,1.0,49,1172,735,-437
294,0.0,0.0,0.0,49,1176,735,-441
295,0.0,0.0,0.0,49,1180,735,-445
296,0.0,0.0,0.0,49,1184,735,-449
297,0.0,0.0,0.0,49,1188,735,-453
298,0.0,0.0,0.0,49,1192,735,-457
299,0.0,0.0,0.0,49,1196,735,-461
300,1.0,1.0,0.6666666666666666,50,1200,750,-450
301,0.0,0.0,0.0,50,1204,750,-454
302,0.0,0.0,0.0,50,1208,750,-458
303,0.0,0.0,0.0,50,1212,750,-462
304,0.0,0.0,0.0,50,1216,750,-466
305,0.0,0.0,0.0,50,1220,750,-470
306,0.0,0.0,0.0,50,1224,750,-474
307,1.0,1.0,1.0,51,1228,765,-463
308,0.0,0.0,0.0,51,1232,765,-467
309,1.0,1.0,1.0,52,1236,780,-456
310,0.0,0.0,0.0,52,1240,780,-460
311,1.0,1.0,1.0,53,1244,795,-449
312,0.0,0.0,0.0,53,1248,795,-453
313,0.0,0.0,0.0,53,1252,795,-457
314,0.0,0.0,0.0,53,1256,795,-461
315,0.0,0.0,0.0,53,1260,795,-465
316,0.0,0.0,0.0,53,1264,795,-469
317,1.0,1.0,1.0,54,1268,810,-458
318,0.0,0.0,0.0,54,1272,810,-462
319,0.0,0.0,0.0,54,1276,810,-466
320,0.0,0.0,0.0,54,1280,810,-470
321,0.0,0.0,0.0,54,1284,810,-474
322,0.0,0.0,0.0,54,1288,810,-478
323,1.0,1.0,1.0,55,1292,825,-467
324,0.0,0.0,0.0,55,1296,825,-471
325,0.0,0.0,0.0,55,1300,825,-475
326,1.0,1.0,1.0,56,1304,840,-464
327,0.0,0.0,0.0,56,1308,840,-468
328,0.0,0.0,0.0,56,1312,840,-472
329,0.0,0.0,0.0,56,1316,840,-476
330,0.0,0.0,0.0,56,1320,840,-480
331,0.0,0.0,0.0,56,1324,840,-484
332,1.0,1.0,1.0,57,1328,855,-473
333,0.0,0.0,0.0,57,1332,855,-477
334,0.0,0.0,0.0,57,1336,855,-481
335,1.0,1.0,1.0,58,1340,870,-470
336,0.0,0.0,0.3333333333333333,58,1344,870,-474
337,0.0,0.0,0.0,58,1348,870,-478
338,1.0,1.0,1.0,59,1352,885,-467
339,0.0,0.0,0.0,59,1356,885,-471
340,1.0,1.0,1.0,60,1360,900,-460
341,0.0,0.0,0.0,60,1364,900,-464
342,0.0,0.0,0.0,60,1368,900,-468
343,0.0,0.0,0.0,60,1372,900,-472
344,0.0,0.0,0.0,60,1376,900,-476
345,0.0,0.0,0.0,60,1380,900,-480
346,0.0,0.0,0.0,60,1384,900,-484
347,0.0,0.0,0.0,60,1388,900,-488
348,0.0,0.0,0.0,60,1392,900,-492
349,0.0,0.0,0.0,60,1396,900,-496
350,0.0,0.0,0.0,60,1400,900,-500
351,0.0,0.0,0.0,60,1404,900,-504
352,0.0,0.0,0.0,60,1408,900,-508
353,1.0,0.0,0.25,61,1412,915,-497
354,0.0,0.0,0.0,61,1416,915,-501
355,0.0,0.0,0.0,61,1420,915,-505
356,0.0,0.0,0.0,61,1424,915,-509
357,0.0,0.0,0.0,61,1428,915,-513
358,0.0,0.0,0.0,61,1432,915,-517
359,0.0,0.0,0.0,61,1436,915,-521
360,0.0,0.0,0.0,61,1440,915,-525
361,1.0,1.0,1.0,62,1444,930,-514
362,0.0,0.0,0.0,62,1448,930,-518
363,0.0,0.0,0.0,62,1452,930,-522
364,0.0,0.0,0.0,62,1456,930,-526
365,0.0,0.0,0.0,62,1460,930,-530
366,0.0,0.0,0.0,62,1464,930,-534
367,0.0,0.0,0.0,62,1468,930,-538
368,0.0,0.0,0.3333333333333333,62,1472,930,-542
369,0.0,0.0,0.0,62,1476,930,-546
370,0.0,0.0,0.0,62,1480,930,-550
371,0.0,0.0,0.0,62,1484,930,-554
372,0.0,0.0,0.0,62,1488,930,-558
373,0.0,0.0,0.0,62,1492,930,-562
374,0.0,0.0,0.0,62,1496,930,-566
375,0.0,0.0,0.0,62,1500,930,-570
376,0.0,0.0,0.0,62,1504,930,-574
377,0.0,0.0,0.0,62,1508,930,-578
378,0.0,0.0,0.0,62,1512,930,-582
379,0.0,0.0,0.0,62,1516,930,-586
380,0.0,0.0,0.0,62,1520,930,-590
381,0.0,0.0,0.0,62,1524,930,-594
382,1.0,1.0,1.0,63,1528,945,-583
383,0.0,0.0,0.0,63,1532,945,-587
384,0.0,0.0,0.0,63,1536,945,-591
385,0.0,0.0,0.0,63,1540,945,-595
386,0.0,0.0,0.0,63,1544,945,-599
387,0.0,0.0,0.0,63,1548,945,-603
388,0.0,0.0,0.0,63,1552,945,-607
389,0.0,0.0,0.0,63,1556,945,-611
390,1.0,1.0,1.0,64,1560,960,-600
391,0.0,0.0,0.0,64,1564,960,-604
392,0.0,0.0,0.0,64,1568,960,-608
393,0.0,0.0,0.0,64,1572,960,-612
394,0.0,0.0,0.0,64,1576,960,-616
395,1.0,1.0,1.0,65,1580,975,-605
396,0.0,0.0,0.0,65,1584,975,-609
397,0.0,0.0,0.0,65,1588,975,-613
398,0.0,0.0,0.0,65,1592,975,-617
399,0.0,0.0,0.0,65,1596,975,-621
400,0.0,0.0,0.0,65,1600,975,-625
401,0.0,0.0,0.0,65,1604,975,-629
402,0.0,0.0,0.0,65,1608,975,-633
403,0.0,0.0,0.0,65,1612,975,-637
404,0.0,0.0,0.0,65,1616,975,-641
405,0.0,0.0,0.0,65,1620,975,-645
406,1.0,1.0,1.0,66,1624,990,-634
407,0.0,1.0,0.6666666666666666,66,1628,990,-638
408,1.0,1.0,0.6,67,1632,1005,-627
409,0.0,0.0,0.0,67,1636,1005,-631
410,0.0,0.0,0.0,67,1640,1005,-635
411,0.0,0.0,0.0,67,1644,1005,-639
412,0.0,0.0,0.0,67,1648,1005,-643
413,0.0,0.0,0.0,67,1652,1005,-647
414,1.0,1.0,0.8,68,1656,1020,-636
415,0.0,0.0,0.0,68,1660,1020,-640
416,0.0,0.0,0.0,68,1664,1020,-644
417,0.0,0.0,0.0,68,1668,1020,-648
418,0.0,0.0,0.0,68,1672,1020,-652
419,0.0,0.0,0.0,68,1676,1020,-656
420,0.0,0.0,0.0,68,1680,1020,-660
421,0.0,0.0,0.0,68,1684,1020,-664
422,0.0,0.0,0.0,68,1688,1020,-668
423,0.0,0.0,0.0,68,1692,1020,-672
424,0.0,0.0,0.0,68,1696,1020,-676
425,1.0,1.0,1.0,69,1700,1035,-665
426,1.0,1.0,1.0,70,1704,1050,-654
427,1.0,1.0,1.0,71,1708,1065,-643
428,0.0,0.0,0.0,71,1712,1065,-647
429,0.0,0.0,0.0,71,1716,1065,-651
430,1.0,1.0,0.6666666666666666,72,1720,1080,-640
431,0.0,0.0,0.0,72,1724,1080,-644
432,0.0,0.0,0.0,72,1728,1080,-648
433,0.0,0.0,0.0,72,1732,1080,-652
434,1.0,0.0,0.3333333333333333,73,1736,1095,-641
435,1.0,1.0,1.0,74,1740,1110,-630
436,0.0,0.0,0.0,74,1744,1110,-634
437,0.0,0.0,0.0,74,1748,1110,-638
438,1.0,1.0,1.0,75,1752,1125,-627
439,0.0,0.0,0.0,75,1756,1125,-631
440,0.0,0.0,0.0,75,1760,1125,-635
441,0.0,0.0,0.0,75,1764,1125,-639
442,0.0,0.0,0.0,75,1768,1125,-643
443,1.0,1.0,1.0,76,1772,1140,-632
444,0.0,0.0,0.0,76,1776,1140,-636
445,0.0,0.0,0.0,76,1780,1140,-640
446,1.0,1.0,1.0,77,1784,1155,-629
447,0.0,0.0,0.0,77,1788,1155,-633
448,0.0,0.0,0.0,77,1792,1155,-637
449,1.0,1.0,0.6666666666666666,78,1796,1170,-626
450,0.0,0.0,0.0,78,1800,1170,-630
451,0.0,0.0,0.0,78,1804,1170,-634
452,0.0,0.0,0.0,78,1808,1170,-638
453,0.0,0.0,0.0,78,1812,1170,-642
454,1.0,1.0,1.0,79,1816,1185,-631
455,0.0,0.0,0.0,79,1820,1185,-635
456,0.0,0.0,0.0,79,1824,1185,-639
457,0.0,0.0,0.4,79,1828,1185,-643
458,1.0,1.0,1.0,80,1832,1200,-632
459,0.0,0.0,0.0,80,1836,1200,-636
460,0.0,0.0,0.0,80,1840,1200,-640
461,0.0,0.0,0.0,80,1844,1200,-644
462,0.0,0.0,0.0,80,1848,1200,-648
463,0.0,0.0,0.0,80,1852,1200,-652
464,0.0,0.0,0.0,80,1856,1200,-656
465,1.0,1.0,1.0,81,1860,1215,-645
466,0.0,0.0,0.5,81,1864,1215,-649
467,0.0,0.0,0.0,81,1868,1215,-653
468,0.0,0.0,0.3333333333333333,81,1872,1215,-657
469,0.0,0.0,0.2,81,1876,1215,-661
470,0.0,0.0,0.0,81,1880,1215,-665
471,1.0,1.0,0.8,82,1884,1230,-654
472,0.0,0.0,0.0,82,1888,1230,-658
473,0.0,0.0,0.0,82,1892,1230,-662
474,0.0,0.0,0.0,82,1896,1230,-666
475,0.0,0.0,0.0,82,1900,1230,-670
476,0.0,0.0,0.0,82,1904,1230,-674
477,0.0,0.0,0.0,82,1908,1230,-678
478,0.0,0.0,0.0,82,1912,1230,-682
479,0.0,0.0,0.0,82,1916,1230,-686
480,0.0,0.0,0.0,82,1920,1230,-690
481,0.0,0.0,0.0,82,1924,1230,-694
482,0.0,0.0,0.0,82,1928,1230,-698
483,0.0,0.0,0.0,82,1932,1230,-702
484,0.0,0.0,0.0,82,1936,1230,-706
485,0.0,0.0,0.0,82,1940,1230,-710
486,1.0,1.0,1.0,83,1944,1245,-699
487,0.0,0.0,0.0,83,1948,1245,-703
488,0.0,0.0,0.0,83,1952,1245,-707
489,0.0,0.0,0.0,83,1956,1245,-711
490,0.0,0.0,0.0,83,1960,1245,-715
491,0.0,1.0,0.6666666666666666,83,1964,1245,-719
492,0.0,0.0,0.0,83,1968,1245,-723
493,0.0,0.0,0.0,83,1972,1245,-727
494,1.0,1.0,0.6666666666666666,84,1976,1260,-716
495,0.0,0.0,0.0,84,1980,1260,-720
496,0.0,0.0,0.0,84,1984,1260,-724
497,0.0,0.0,0.0,84,1988,1260,-728
498,0.0,0.0,0.0,84,1992,1260,-732
499,0.0,0.0,0.0,84,1996,1260,-736
500,1.0,1.0,1.0,85,2000,1275,-725
501,0.0,0.0,0.0,85,2004,1275,-729
502,0.0,0.0,0.0,85,2008,1275,-733
503,1.0,1.0,1.0,86,2012,1290,-722
504,0.0,0.0,0.0,86,2016,1290,-726
505,0.0,0.0,0.0,86,2020,1290,-730
506,0.0,0.0,0.0,86,2024,1290,-734
507,0.0,0.0,0.0,86,2028,1290,-738
508,0.0,0.0,0.0,86,2032,1290,-742
509,0.0,0.0,0.0,86,2036,1290,-746
510,0.0,0.0,0.0,86,2040,1290,-750
511,0.0,0.0,0.3333333333333333,86,2044,1290,-754
512,0.0,0.0,0.0,86,2048,1290,-758
513,0.0,0.0,0.0,86,2052,1290,-762
514,0.0,0.0,0.0,86,2056,1290,-766
515,0.0,0.0,0.0,86,2060,1290,-770
516,0.0,0.0,0.0,86,2064,1290,-774
517,0.0,0.0,0.0,86,2068,1290,-778
518,0.0,0.0,0.0,86,2072,1290,-782
519,0.0,0.0,0.0,86,2076,1290,-786
520,1.0,0.0,0.2,87,2080,1305,-775
521,0.0,0.0,0.0,87,2084,1305,-779
522,1.0,1.0,0.6666666666666666,88,2088,1320,-768
523,0.0,0.0,0.0,88,2092,1320,-772
524,0.0,0.0,0.0,88,2096,1320,-776
525,0.0,0.0,0.0,88,2100,1320,-780
526,0.0,0.0,0.0,88,2104,1320,-784
527,0.0,0.0,0.0,88,2108,1320,-788
528,0.0,0.0,0.0,88,2112,1320,-792
529,0.0,0.0,0.0,88,2116,1320,-796
530,0.0,0.0,0.0,88,2120,1320,-800
531,0.0,0.0,0.0,88,2124,1320,-804
532,0.0,0.0,0.0,88,2128,1320,-808
533,0.0,0.0,0.0,88,2132,1320,-812
534,0.0,0.0,0.0,88,2136,1320,-816
535,0.0,0.0,0.0,88,2140,1320,-820
536,0.0,0.0,0.0,88,2144,1320,-824
537,0.0,0.0,0.0,88,2148,1320,-828
538,1.0,1.0,1.0,89,2152,1335,-817
539,0.0,0.0,0.0,89,2156,1335,-821
540,0.0,0.0,0.0,89,2160,1335,-825
541,0.0,0.0,0.0,89,2164,1335,-829
542,0.0,0.0,0.0,89,2168,1335,-833
543,1.0,1.0,1.0,90,2172,1350,-822
544,0.0,0.0,0.0,90,2176,1350,-826
545,0.0,0.0,0.0,90,2180,1350,-830
546,0.0,0.0,0.0,90,2184,1350,-834
547,0.0,0.0,0.0,90,2188,1350,-838
548,0.0,0.0,0.0,90,2192,1350,-842
549,0.0,0.0,0.0,90,2196,1350,-846
550,1.0,1.0,1.0,91,2200,1365,-835
551,0.0,0.0,0.0,91,2204,1365,-839
552,0.0,0.0,0.0,91,2208,1365,-843
553,1.0,1.0,1.0,92,2212,1380,-832
554,0.0,0.0,0.0,92,2216,1380,-836
555,0.0,0.0,0.2,92,2220,1380,-840
556,0.0,0.0,0.0,92,2224,1380,-844
557,0.0,0.0,0.0,92,2228,1380,-848
558,0.0,0.0,0.0,92,2232,1380,-852
559,0.0,0.0,0.0,92,2236,1380,-856
560,0.0,0.0,0.0,92,2240,1380,-860
561,0.0,0.0,0.0,92,2244,1380,-864
562,0.0,0.0,0.0,92,2248,1380,-868
563,0.0,0.0,0.0,92,2252,1380,-872
564,0.0,0.0,0.0,92,2256,1380,-876
565,0.0,0.0,0.0,92,2260,1380,-880
566,0.0,0.0,0.0,92,2264,1380,-884
567,0.0,0.0,0.0,92,2268,1380,-888
568,0.0,0.0,0.0,92,2272,1380,-892
569,0.0,0.0,0.0,92,2276,1380,-896
570,0.0,0.0,0.0,92,2280,1380,-900
571,0.0,0.0,0.0,92,2284,1380,-904
572,0.0,0.0,0.0,92,2288,1380,-908
573,0.0,0.0,0.0,92,2292,1380,-912
574,0.0,0.0,0.0,92,2296,1380,-916
575,0.0,0.0,0.0,92,2300,1380,-920
576,0.0,0.0,0.0,92,2304,1380,-924
577,0.0,0.0,0.0,92,2308,1380,-928
578,1.0,1.0,1.0,93,2312,1395,-917
579,0.0,0.0,0.0,93,2316,1395,-921
580,1.0,1.0,1.0,94,2320,1410,-910
581,0.0,0.0,0.0,94,2324,1410,-914
582,0.0,0.0,0.0,94,2328,1410,-918
583,0.0,0.0,0.0,94,2332,1410,-922
584,0.0,0.0,0.0,94,2336,1410,-926
585,0.0,0.0,0.0,94,2340,1410,-930
586,0.0,0.0,0.0,94,2344,1410,-934
587,0.0,0.0,0.0,94,2348,1410,-938
588,0.0,0.0,0.0,94,2352,1410,-942
589,0.0,0.0,0.0,94,2356,1410,-946
590,0.0,0.0,0.0,94,2360,1410,-950
591,0.0,0.0,0.0,94,2364,1410,-954
592,0.0,0.0,0.0,94,2368,1410,-958
593,0.0,0.0,0.0,94,2372,1410,-962
594,0.0,0.0,0.5,94,2376,1410,-966
595,0.0,0.0,0.0,94,2380,1410,-970
596,0.0,0.0,0.0,94,2384,1410,-974
597,0.0,0.0,0.0,94,2388,1410,-978
598,0.0,0.0,0.0,94,2392,1410,-982
599,0.0,0.0,0.0,94,2396,1410,-986
600,0.0,0.0,0.0,94,2400,1410,-990
601,1.0,1.0,1.0,95,2404,1425,-979
602,0.0,0.0,0.0,95,2408,1425,-983
603,0.0,0.0,0.0,95,2412,1425,-987
604,0.0,0.0,0.0,95,2416,1425,-991
605,0.0,0.0,0.0,95,2420,1425,-995
606,0.0,0.0,0.0,95,2424,1425,-999
607,1.0,1.0,1.0,96,2428,1440,-988
608,0.0,0.0,0.0,96,2432,1440,-992
609,0.0,0.0,0.0,96,2436,1440,-996
610,1.0,1.0,1.0,97,2440,1455,-985
611,0.0,0.0,0.3333333333333333,97,2444,1455,-989
612,0.0,0.0,0.0,97,2448,1455,-993
613,0.0,0.0,0.0,97,2452,1455,-997
614,0.0,0.0,0.0,97,2456,1455,-1001
615,0.0,0.0,0.0,97,2460,1455,-1005
616,0.0,0.0,0.0,97,2464,1455,-1009
617,1.0,1.0,1.0,98,2468,1470,-998
618,0.0,0.0,0.0,98,2472,1470,-1002
619,0.0,0.0,0.0,98,2476,1470,-1006
620,0.0,0.0,0.0,98,2480,1470,-1010
621,0.0,0.0,0.0,98,2484,1470,-1014
622,0.0,0.0,0.0,98,2488,1470,-1018
623,0.0,0.0,0.0,98,2492,1470,-1022
624,0.0,0.0,0.0,98,2496,1470,-1026
625,0.0,0.0,0.0,98,2500,1470,-1030
626,0.0,1.0,0.6666666666666666,98,2504,1470,-1034
627,0.0,0.0,0.0,98,2508,1470,-1038
628,0.0,0.0,0.0,98,2512,1470,-1042
629,0.0,0.0,0.0,98,2516,1470,-1046
630,0.0,0.0,0.0,98,2520,1470,-1050
631,0.0,0.0,0.3333333333333333,98,2524,1470,-1054
632,0.0,0.0,0.25,98,2528,1470,-1058
633,0.0,0.0,0.0,98,2532,1470,-1062
634,0.0,0.0,0.0,98,2536,1470,-1066
635,0.0,0.0,0.0,98,2540,1470,-1070
636,0.0,0.0,0.0,98,2544,1470,-1074
637,0.0,0.0,0.0,98,2548,1470,-1078
638,0.0,0.0,0.0,98,2552,1470,-1082
639,0.0,0.0,0.25,98,2556,1470,-1086
640,0.0,0.0,0.0,98,2560,1470,-1090
641,0.0,0.0,0.0,98,2564,1470,-1094
642,0.0,0.0,0.0,98,2568,1470,-1098
643,0.0,0.0,0.0,98,2572,1470,-1102
644,0.0,0.0,0.0,98,2576,1470,-1106
645,0.0,0.0,0.0,98,2580,1470,-1110
646,0.0,0.0,0.0,98,2584,1470,-1114
647,0.0,0.0,0.0,98,2588,1470,-1118
648,0.0,0.0,0.0,98,2592,1470,-1122
649,0.0,0.0,0.0,98,2596,1470,-1126
650,0.0,0.0,0.0,98,2600,1470,-1130
651,0.0,0.0,0.0,98,2604,1470,-1134
652,0.0,0.0,0.0,98,2608,1470,-1138
653,0.0,0.0,0.0,98,2612,1470,-1142
654,0.0,0.0,0.0,98,2616,1470,-1146
655,0.0,0.0,0.0,98,2620,1470,-1150
656,1.0,1.0,1.0,99,2624,1485,-1139
657,0.0,0.0,0.0,99,2628,1485,-1143
658,0.0,0.0,0.0,99,2632,1485,-1147
659,0.0,0.0,0.0,99,2636,1485,-1151
660,0.0,0.0,0.0,99,2640,1485,-1155
661,0.0,0.0,0.2,99,2644,1485,-1159
662,1.0,1.0,1.0,100,2648,1500,-1148
663,0.0,0.0,0.2,100,2652,1500,-1152
664,0.0,0.0,0.0,100,2656,1500,-1156
665,0.0,0.0,0.0,100,2660,1500,-1160
666,0.0,0.0,0.0,100,2664,1500,-1164
667,0.0,0.0,0.0,100,2668,1500,-1168
668,1.0,1.0,1.0,101,2672,1515,-1157
669,1.0,1.0,1.0,102,2676,1530,-1146
670,0.0,0.0,0.0,102,2680,1530,-1150
671,0.0,0.0,0.0,102,2684,1530,-1154
672,0.0,0.0,0.0,102,2688,1530,-1158
673,0.0,0.0,0.0,102,2692,1530,-1162
674,0.0,0.0,0.0,102,2696,1530,-1166
675,0.0,0.0,0.0,102,2700,1530,-1170
676,0.0,0.0,0.0,102,2704,1530,-1174
677,1.0,1.0,1.0,103,2708,1545,-1163
678,0.0,0.0,0.0,103,2712,1545,-1167
679,1.0,1.0,1.0,104,2716,1560,-1156
680,0.0,0.0,0.0,104,2720,1560,-1160
681,0.0,0.0,0.0,104,2724,1560,-1164
682,0.0,0.0,0.0,104,2728,1560,-1168
683,0.0,0.0,0.0,104,2732,1560,-1172
684,0.0,0.0,0.0,104,2736,1560,-1176
685,0.0,0.0,0.0,104,2740,1560,-1180
686,0.0,0.0,0.0,104,2744,1560,-1184
687,0.0,0.0,0.0,104,2748,1560,-1188
688,0.0,0.0,0.0,104,2752,1560,-1192
689,0.0,0.0,0.0,104,2756,1560,-1196
690,0.0,0.0,0.0,104,2760,1560,-1200
691,0.0,0.0,0.0,104,2764,1560,-1204
692,0.0,0.0,0.0,104,2768,1560,-1208
693,0.0,0.0,0.0,104,2772,1560,-1212
694,0.0,0.0,0.0,104,2776,1560,-1216
695,0.0,0.0,0.3333333333333333,104,2780,1560,-1220
696,0.0,0.0,0.0,104,2784,1560,-1224
697,0.0,0.0,0.0,104,2788,1560,-1228
698,1.0,0.0,0.25,105,2792,1575,-1217
699,1.0,1.0,1.0,106,2796,1590,-1206
700,0.0,0.0,0.0,106,2800,1590,-1210
701,0.0,0.0,0.0,106,2804,1590,-1214
702,0.0,0.0,0.0,106,2808,1590,-1218
703,0.0,0.0,0.0,106,2812,1590,-1222
704,0.0,0.0,0.0,106,2816,1590,-1226
705,0.0,0.0,0.0,106,2820,1590,-1230
706,0.0,0.0,0.0,106,2824,1590,-1234
707,0.0,0.0,0.0,106,2828,1590,-1238
708,0.0,0.0,0.0,106,2832,1590,-1242
709,0.0,0.0,0.0,106,2836,1590,-1246
710,0.0,0.0,0.0,106,2840,1590,-1250
711,0.0,0.0,0.0,106,2844,1590,-1254
712,0.0,0.0,0.0,106,2848,1590,-1258
713,0.0,0.0,0.0,106,2852,1590,-1262
714,0.0,0.0,0.0,106,2856,1590,-1266
715,0.0,0.0,0.0,106,2860,1590,-1270
716,0.0,0.0,0.0,106,2864,1590,-1274
717,0.0,0.0,0.0,106,2868,1590,-1278
718,0.0,0.0,0.2,106,2872,1590,-1282
719,1.0,1.0,1.0,107,2876,1605,-1271
720,0.0,0.0,0.0,107,2880,1605,-1275
721,0.0,0.0,0.0,107,2884,1605,-1279
722,0.0,0.0,0.0,107,2888,1605,-1283
723,0.0,0.0,0.0,107,2892,1605,-1287
724,0.0,0.0,0.0,107,2896,1605,-1291
725,0.0,0.0,0.0,107,2900,1605,-1295
726,1.0,1.0,1.0,108,2904,1620,-1284
727,1.0,1.0,0.6,109,2908,1635,-1273
728,0.0,1.0,0.75,109,2912,1635,-1277
729,0.0,0.0,0.0,109,2916,1635,-1281
730,0.0,0.0,0.0,109,2920,1635,-1285
731,1.0,1.0,1.0,110,2924,1650,-1274
732,0.0,0.0,0.0,110,2928,1650,-1278
733,0.0,0.0,0.0,110,2932,1650,-1282
734,0.0,0.0,0.4,110,2936,1650,-1286
735,1.0,1.0,1.0,111,2940,1665,-1275
736,0.0,0.0,0.0,111,2944,1665,-1279
737,0.0,0.0,0.0,111,2948,1665,-1283
738,0.0,0.0,0.0,111,2952,1665,-1287
739,0.0,0.0,0.0,111,2956,1665,-1291
740,0.0,0.0,0.0,111,2960,1665,-1295
741,0.0,0.0,0.0,111,2964,1665,-1299
742,0.0,0.0,0.3333333333333333,111,2968,1665,-1303
743,0.0,0.0,0.0,111,2972,1665,-1307
744,1.0,1.0,1.0,112,2976,1680,-1296
745,0.0,0.0,0.0,112,2980,1680,-1300
746,0.0,0.0,0.25,112,2984,1680,-1304
747,0.0,0.0,0.0,112,2988,1680,-1308
748,1.0,1.0,1.0,113,2992,1695,-1297
749,0.0,0.0,0.0,113,2996,1695,-1301
750,0.0,0.0,0.0,113,3000,1695,-1305
751,0.0,0.0,0.0,113,3004,1695,-1309
752,0.0,0.0,0.0,113,3008,1695,-1313
753,0.0,0.0,0.5,113,3012,1695,-1317
754,0.0,0.0,0.0,113,3016,1695,-1321
755,1.0,0.0,0.3333333333333333,114,3020,1710,-1310
756,0.0,0.0,0.0,114,3024,1710,-1314
757,0.0,0.0,0.0,114,3028,1710,-1318
758,0.0,0.0,0.0,114,3032,1710,-1322
759,1.0,1.0,1.0,115,3036,1725,-1311
760,0.0,0.0,0.0,115,3040,1725,-1315
761,0.0,0.0,0.0,115,3044,1725,-1319
762,0.0,0.0,0.0,115,3048,1725,-1323
763,0.0,0.0,0.0,115,3052,1725,-1327
764,0.0,0.0,0.0,115,3056,1725,-1331
765,0.0,0.0,0.3333333333333333,115,3060,1725,-1335
766,0.0,0.0,0.0,115,3064,1725,-1339
767,0.0,0.0,0.0,115,3068,1725,-1343
768,0.0,0.0,0.0,115,3072,1725,-1347
769,0.0,0.0,0.0,115,3076,1725,-1351
770,0.0,0.0,0.4,115,3080,1725,-1355
771,0.0,0.0,0.0,115,3084,1725,-1359
772,0.0,0.0,0.0,115,3088,1725,-1363
773,0.0,0.0,0.0,115,3092,1725,-1367
774,0.0,0.0,0.0,115,3096,1725,-1371
775,1.0,1.0,1.0,116,3100,1740,-1360
776,0.0,0.0,0.0,116,3104,1740,-1364
777,0.0,0.0,0.0,116,3108,1740,-1368
778,0.0,0.0,0.0,116,3112,1740,-1372
779,0.0,0.0,0.0,116,3116,1740,-1376
780,0.0,0.0,0.0,116,3120,1740,-1380
781,0.0,0.0,0.0,116,3124,1740,-1384
782,0.0,0.0,0.0,116,3128,1740,-1388
783,0.0,0.0,0.0,116,3132,1740,-1392
784,0.0,0.0,0.0,116,3136,1740,-1396
785,0.0,0.0,0.0,116,3140,1740,-1400
786,0.0,0.0,0.0,116,3144,1740,-1404
787,0.0,0.0,0.0,116,3148,1740,-1408
788,0.0,0.0,0.0,116,3152,1740,-1412
789,0.0,0.0,0.0,116,3156,1740,-1416
790,0.0,0.0,0.0,116,3160,1740,-1420
791,0.0,0.0,0.0,116,3164,1740,-1424
792,0.0,0.0,0.0,116,3168,1740,-1428
793,0.0,0.0,0.0,116,3172,1740,-1432
794,0.0,0.0,0.0,116,3176,1740,-1436
795,1.0,1.0,0.6666666666666666,117,3180,1755,-1425
796,0.0,0.0,0.0,117,3184,1755,-1429
797,0.0,0.0,0.0,117,3188,1755,-1433
798,0.0,0.0,0.0,117,3192,1755,-1437
799,0.0,0.0,0.0,117,3196,1755,-1441
800,0.0,0.0,0.0,117,3200,1755,-1445
801,0.0,0.0,0.0,117,3204,1755,-1449
802,0.0,0.0,0.0,117,3208,1755,-1453
803,0.0,0.0,0.0,117,3212,1755,-1457
804,0.0,0.0,0.0,117,3216,1755,-1461
805,0.0,0.0,0.0,117,3220,1755,-1465
806,0.0,0.0,0.0,117,3224,1755,-1469
807,1.0,1.0,0.6666666666666666,118,3228,1770,-1458
808,0.0,0.0,0.0,118,3232,1770,-1462
809,0.0,0.0,0.0,118,3236,1770,-1466
810,0.0,0.0,0.0,118,3240,1770,-1470
811,1.0,0.0,0.5,119,3244,1785,-1459
812,0.0,0.0,0.0,119,3248,1785,-1463
813,0.0,0.0,0.0,119,3252,1785,-1467
814,0.0,0.0,0.0,119,3256,1785,-1471
815,0.0,0.0,0.0,119,3260,1785,-1475
816,0.0,0.0,0.0,119,3264,1785,-1479
817,1.0,1.0,1.0,120,3268,1800,-1468
818,1.0,1.0,1.0,121,3272,1815,-1457
819,0.0,0.0,0.0,121,3276,1815,-1461
820,1.0,1.0,1.0,122,3280,1830,-1450
821,0.0,0.0,0.0,122,3284,1830,-1454
822,0.0,0.0,0.0,122,3288,1830,-1458
823,0.0,0.0,0.0,122,3292,1830,-1462
824,0.0,0.0,0.0,122,3296,1830,-1466
825,0.0,0.0,0.0,122,3300,1830,-1470
826,1.0,1.0,1.0,123,3304,1845,-1459
827,0.0,0.0,0.3333333333333333,123,3308,1845,-1463
828,0.0,0.0,0.0,123,3312,1845,-1467
829,0.0,0.0,0.0,123,3316,1845,-1471
830,0.0,0.0,0.0,123,3320,1845,-1475
831,0.0,0.0,0.0,123,3324,1845,-1479
832,0.0,0.0,0.0,123,3328,1845,-1483
833,0.0,0.0,0.0,123,3332,1845,-1487
834,0.0,0.0,0.0,123,3336,1845,-1491
835,0.0,0.0,0.0,123,3340,1845,-1495
836,0.0,0.0,0.0,123,3344,1845,-1499
837,0.0,0.0,0.0,123,3348,1845,-1503
838,0.0,0.0,0.0,123,3352,1845,-1507
839,0.0,0.0,0.0,123,3356,1845,-1511
840,0.0,0.0,0.0,123,3360,1845,-1515
841,0.0,0.0,0.0,123,3364,1845,-1519
842,0.0,0.0,0.0,123,3368,1845,-1523
843,0.0,0.0,0.0,123,3372,1845,-1527
844,1.0,1.0,1.0,124,3376,1860,-1516
845,0.0,0.0,0.0,124,3380,1860,-1520
846,0.0,0.0,0.0,124,3384,1860,-1524
847,0.0,0.0,0.0,124,3388,1860,-1528
848,0.0,0.0,0.0,124,3392,1860,-1532
849,0.0,0.0,0.0,124,3396,1860,-1536
850,0.0,0.0,0.0,124,3400,1860,-1540
851,1.0,1.0,1.0,125,3404,1875,-1529
852,0.0,0.0,0.0,125,3408,1875,-1533
853,1.0,1.0,1.0,126,3412,1890,-1522
854,0.0,0.0,0.0,126,3416,1890,-1526
855,0.0,0.0,0.0,126,3420,1890,-1530
856,0.0,0.0,0.0,126,3424,1890,-1534
857,1.0,1.0,1.0,127,3428,1905,-1523
858,0.0,0.0,0.0,127,3432,1905,-1527
859,0.0,0.0,0.0,127,3436,1905,-1531
860,0.0,0.0,0.0,127,3440,1905,-1535
861,0.0,0.0,0.0,127,3444,1905,-1539
862,0.0,0.0,0.0,127,3448,1905,-1543
863,1.0,1.0,1.0,128,3452,1920,-1532
864,0.0,0.0,0.0,128,3456,1920,-1536
865,0.0,0.0,0.0,128,3460,1920,-1540
866,0.0,0.0,0.0,128,3464,1920,-1544
867,0.0,0.0,0.0,128,3468,1920,-1548
868,0.0,0.0,0.0,128,3472,1920,-1552
869,0.0,0.0,0.0,128,3476,1920,-1556
870,0.0,0.0,0.0,128,3480,1920,-1560
871,0.0,0.0,0.0,128,3484,1920,-1564
872,0.0,0.0,0.0,128,3488,1920,-1568
873,0.0,0.0,0.0,128,3492,1920,-1572
874,0.0,0.0,0.0,128,3496,1920,-1576
875,1.0,1.0,1.0,129,3500,1935,-1565
876,1.0,1.0,1.0,130,3504,1950,-1554
877,0.0,0.0,0.0,130,3508,1950,-1558
878,0.0,0.0,0.0,130,3512,1950,-1562
879,0.0,0.0,0.0,130,3516,1950,-1566
880,0.0,0.0,0.0,130,3520,1950,-1570
881,1.0,1.0,1.0,131,3524,1965,-1559
882,0.0,0.0,0.2,131,3528,1965,-1563
883,0.0,0.0,0.0,131,3532,1965,-1567
884,0.0,0.0,0.0,131,3536,1965,-1571
885,0.0,0.0,0.0,131,3540,1965,-1575
886,0.0,0.0,0.0,131,3544,1965,-1579
887,0.0,0.0,0.0,131,3548,1965,-1583
888,0.0,0.0,0.0,131,3552,1965,-1587
889,0.0,0.0,0.0,131,3556,1965,-1591
890,0.0,0.0,0.0,131,3560,1965,-1595
891,0.0,0.0,0.0,131,3564,1965,-1599
892,0.0,0.0,0.0,131,3568,1965,-1603
893,0.0,0.0,0.0,131,3572,1965,-1607
894,0.0,0.0,0.0,131,3576,1965,-1611
895,0.0,0.0,0.0,131,3580,1965,-1615
896,0.0,1.0,0.6666666666666666,131,3584,1965,-1619
897,0.0,0.0,0.0,131,3588,1965,-1623
898,1.0,1.0,1.0,132,3592,1980,-1612
899,0.0,0.0,0.0,132,3596,1980,-1616
900,0.0,0.0,0.2,132,3600,1980,-1620
901,1.0,0.0,0.4,133,3604,1995,-1609
902,0.0,0.0,0.0,133,3608,1995,-1613
903,0.0,0.0,0.0,133,3612,1995,-1617
904,0.0,0.0,0.0,133,3616,1995,-1621
905,0.0,0.0,0.0,133,3620,1995,-1625
906,0.0,0.0,0.0,133,3624,1995,-1629
907,0.0,0.0,0.0,133,3628,1995,-1633
908,0.0,0.0,0.0,133,3632,1995,-1637
909,1.0,1.0,1.0,134,3636,2010,-1626
910,0.0,0.0,0.0,134,3640,2010,-1630
911,0.0,0.0,0.0,134,3644,2010,-1634
912,0.0,0.0,0.0,134,3648,2010,-1638
913,0.0,0.0,0.0,134,3652,2010,-1642
914,1.0,0.0,0.4,135,3656,2025,-1631
915,1.0,1.0,1.0,136,3660,2040,-1620
916,0.0,0.0,0.0,136,3664,2040,-1624
917,0.0,0.0,0.0,136,3668,2040,-1628
918,0.0,0.0,0.0,136,3672,2040,-1632
919,0.0,0.0,0.0,136,3676,2040,-1636
920,0.0,0.0,0.0,136,3680,2040,-1640
921,0.0,0.0,0.0,136,3684,2040,-1644
922,0.0,0.0,0.0,136,3688,2040,-1648
923,0.0,1.0,0.6,136,3692,2040,-1652
924,1.0,1.0,1.0,137,3696,2055,-1641
925,0.0,0.0,0.0,137,3700,2055,-1645
926,0.0,0.0,0.0,137,3704,2055,-1649
927,0.0,0.0,0.0,137,3708,2055,-1653
928,0.0,0.0,0.0,137,3712,2055,-1657
929,0.0,0.0,0.0,137,3716,2055,-1661
930,1.0,1.0,1.0,138,3720,2070,-1650
931,0.0,0.0,0.0,138,3724,2070,-1654
932,0.0,0.0,0.0,138,3728,2070,-1658
933,0.0,0.0,0.0,138,3732,2070,-1662
934,0.0,0.0,0.0,138,3736,2070,-1666
935,0.0,0.0,0.0,138,3740,2070,-1670
936,0.0,0.0,0.0,138,3744,2070,-1674
937,0.0,0.0,0.0,138,3748,2070,-1678
938,0.0,0.0,0.3333333333333333,138,3752,2070,-1682
939,0.0,0.0,0.0,138,3756,2070,-1686
940,0.0,0.0,0.0,138,3760,2070,-1690
941,1.0,1.0,1.0,139,3764,2085,-1679
942,0.0,0.0,0.0,139,3768,2085,-1683
943,0.0,0.0,0.0,139,3772,2085,-1687
944,0.0,0.0,0.0,139,3776,2085,-1691
945,0.0,0.0,0.0,139,3780,2085,-1695
946,0.0,0.0,0.0,139,3784,2085,-1699
947,0.0,0.0,0.0,139,3788,2085,-1703
948,0.0,0.0,0.0,139,3792,2085,-1707
949,0.0,0.0,0.0,139,3796,2085,-1711
950,0.0,0.0,0.0,139,3800,2085,-1715
951,1.0,1.0,1.0,140,3804,2100,-1704
952,0.0,0.0,0.0,140,3808,2100,-1708
953,0.0,0.0,0.0,140,3812,2100,-1712
954,0.0,0.0,0.0,140,3816,2100,-1716
955,1.0,0.0,0.3333333333333333,141,3820,2115,-1705
956,0.0,0.0,0.0,141,3824,2115,-1709
957,0.0,0.0,0.0,141,3828,2115,-1713
958,1.0,1.0,1.0,142,3832,2130,-1702
959,0.0,0.0,0.0,142,3836,2130,-1706
960,0.0,0.0,0.0,142,3840,2130,-1710
961,0.0,0.0,0.0,142,3844,2130,-1714
962,0.0,0.0,0.0,142,3848,2130,-1718
963,0.0,0.0,0.0,142,3852,2130,-1722
964,0.0,0.0,0.0,142,3856,2130,-1726
965,0.0,0.0,0.3333333333333333,142,3860,2130,-1730
966,0.0,0.0,0.0,142,3864,2130,-1734
967,0.0,0.0,0.0,142,3868,2130,-1738
968,0.0,0.0,0.0,142,3872,2130,-1742
969,0.0,0.0,0.0,142,3876,2130,-1746
970,0.0,0.0,0.0,142,3880,2130,-1750
971,0.0,0.0,0.0,142,3884,2130,-1754
972,0.0,0.0,0.0,142,3888,2130,-1758
973,0.0,0.0,0.5,142,3892,2130,-1762
974,0.0,0.0,0.0,142,3896,2130,-1766
975,1.0,1.0,1.0,143,3900,2145,-1755
976,0.0,0.0,0.0,143,3904,2145,-1759
977,1.0,1.0,1.0,144,3908,2160,-1748
978,1.0,1.0,1.0,145,3912,2175,-1737
979,0.0,0.0,0.0,145,3916,2175,-1741
980,1.0,1.0,1.0,146,3920,2190,-1730
981,0.0,0.0,0.5,146,3924,2190,-1734
982,0.0,0.0,0.0,146,3928,2190,-1738
983,0.0,0.0,0.0,146,3932,2190,-1742
984,0.0,0.0,0.0,146,3936,2190,-1746
985,0.0,0.0,0.0,146,3940,2190,-1750
986,0.0,0.0,0.0,146,3944,2190,-1754
987,0.0,0.0,0.0,146,3948,2190,-1758
988,0.0,0.0,0.0,146,3952,2190,-1762
989,0.0,0.0,0.0,146,3956,2190,-1766
990,0.0,0.0,0.0,146,3960,2190,-1770
991,0.0,0.0,0.0,146,3964,2190,-1774
992,0.0,0.0,0.0,146,3968,2190,-1778
993,1.0,1.0,1.0,147,3972,2205,-1767
994,0.0,0.0,0.0,147,3976,2205,-1771
995,0.0,0.0,0.0,147,3980,2205,-1775
996,0.0,0.0,0.0,147,3984,2205,-1779
997,0.0,0.0,0.0,147,3988,2205,-1783
998,0.0,0.0,0.0,147,3992,2205,-1787
999,1.0,1.0,1.0,148,3996,2220,-1776
1000,0.0,0.0,0.0,148,4000,2220,-1780
1001,0.0,0.0,0.0,148,4004,2220,-1784
1002,0.0,0.0,0.0,148,4008,2220,-1788
1003,0.0,0.0,0.0,148,4012,2220,-1792
1004,0.0,0.0,0.0,148,4016,2220,-1796
1005,1.0,1.0,1.0,149,4020,2235,-1785
1006,1.0,1.0,1.0,150,4024,2250,-1774
1007,0.0,0.0,0.0,150,4028,2250,-1778
1008,0.0,0.0,0.0,150,4032,2250,-1782
1009,0.0,0.0,0.0,150,4036,2250,-1786
1010,1.0,1.0,1.0,151,4040,2265,-1775
1011,0.0,0.0,0.0,151,4044,2265,-1779
1012,0.0,0.0,0.2,151,4048,2265,-1783
1013,0.0,0.0,0.0,151,4052,2265,-1787
1014,0.0,0.0,0.4,151,4056,2265,-1791
1015,0.0,0.0,0.0,151,4060,2265,-1795
1016,0.0,0.0,0.0,151,4064,2265,-1799
1017,0.0,0.0,0.0,151,4068,2265,-1803
1018,0.0,0.0,0.0,151,4072,2265,-1807
1019,0.0,0.0,0.0,151,4076,2265,-1811
1020,1.0,1.0,1.0,152,4080,2280,-1800
1021,1.0,1.0,1.0,153,4084,2295,-1789
1022,0.0,0.0,0.4,153,4088,2295,-1793
1023,0.0,0.0,0.0,153,4092,2295,-1797
1024,0.0,0.0,0.0,153,4096,2295,-1801
1025,0.0,0.0,0.0,153,4100,2295,-1805
1026,0.0,0.0,0.0,153,4104,2295,-1809
1027,0.0,0.0,0.25,153,4108,2295,-1813
1028,1.0,1.0,1.0,154,4112,2310,-1802
1029,1.0,1.0,1.0,155,4116,2325,-1791
1030,0.0,0.0,0.0,155,4120,2325,-1795
1031,1.0,1.0,1.0,156,4124,2340,-1784
1032,0.0,0.0,0.0,156,4128,2340,-1788
1033,0.0,0.0,0.0,156,4132,2340,-1792
1034,1.0,1.0,1.0,157,4136,2355,-1781
1035,0.0,0.0,0.0,157,4140,2355,-1785
1036,0.0,0.0,0.0,157,4144,2355,-1789
1037,0.0,0.0,0.0,157,4148,2355,-1793
1038,0.0,0.0,0.0,157,4152,2355,-1797
1039,0.0,0.0,0.0,157,4156,2355,-1801
1040,0.0,0.0,0.0,157,4160,2355,-1805
1041,0.0,0.0,0.0,157,4164,2355,-1809
1042,0.0,0.0,0.0,157,4168,2355,-1813
1043,0.0,0.0,0.0,157,4172,2355,-1817
1044,0.0,0.0,0.0,157,4176,2355,-1821
1045,0.0,1.0,0.6666666666666666,157,4180,2355,-1825
1046,1.0,1.0,1.0,158,4184,2370,-1814
1047,1.0,0.0,0.25,159,4188,2385,-1803
1048,1.0,1.0,1.0,160,4192,2400,-1792
1049,0.0,0.0,0.0,160,4196,2400,-1796
1050,0.0,0.0,0.0,160,4200,2400,-1800
1051,0.0,0.0,0.0,160,4204,2400,-1804
1052,0.0,0.0,0.0,160,4208,2400,-1808
1053,0.0,0.0,0.0,160,4212,2400,-1812
1054,0.0,0.0,0.0,160,4216,2400,-1816
1055,0.0,0.0,0.0,160,4220,2400,-1820
1056,0.0,0.0,0.0,160,4224,2400,-1824
1057,0.0,0.0,0.0,160,4228,2400,-1828
1058,0.0,0.0,0.0,160,4232,2400,-1832
1059,1.0,1.0,1.0,161,4236,2415,-1821
1060,0.0,0.0,0.0,161,4240,2415,-1825
1061,0.0,0.0,0.0,161,4244,2415,-1829
1062,0.0,0.0,0.0,161,4248,2415,-1833
1063,0.0,0.0,0.0,161,4252,2415,-1837
1064,1.0,1.0,1.0,162,4256,2430,-1826
1065,0.0,0.0,0.0,162,4260,2430,-1830
1066,0.0,0.0,0.0,162,4264,2430,-1834
1067,0.0,0.0,0.0,162,4268,2430,-1838
1068,0.0,0.0,0.0,162,4272,2430,-1842
1069,0.0,0.0,0.0,162,4276,2430,-1846
1070,0.0,0.0,0.0,162,4280,2430,-1850
1071,1.0,1.0,1.0,163,4284,2445,-1839
1072,0.0,0.0,0.0,163,4288,2445,-1843
1073,1.0,1.0,1.0,164,4292,2460,-1832
1074,1.0,1.0,1.0,165,4296,2475,-1821
1075,0.0,0.0,0.0,165,4300,2475,-1825
1076,1.0,1.0,1.0,166,4304,2490,-1814
1077,0.0,0.0,0.0,166,4308,2490,-1818
1078,0.0,0.0,0.0,166,4312,2490,-1822
1079,0.0,0.0,0.0,166,4316,2490,-1826
1080,1.0,1.0,1.0,167,4320,2505,-1815
1081,0.0,0.0,0.2,167,4324,2505,-1819
1082,1.0,1.0,0.6666666666666666,168,4328,2520,-1808
1083,0.0,0.0,0.0,168,4332,2520,-1812
1084,0.0,0.0,0.0,168,4336,2520,-1816
1085,0.0,0.0,0.0,168,4340,2520,-1820
1086,0.0,0.0,0.2,168,4344,2520,-1824
1087,0.0,0.0,0.0,168,4348,2520,-1828
1088,0.0,0.0,0.0,168,4352,2520,-1832
1089,0.0,0.0,0.0,168,4356,2520,-1836
1090,1.0,1.0,1.0,169,4360,2535,-1825
1091,0.0,0.0,0.0,169,4364,2535,-1829
1092,1.0,1.0,1.0,170,4368,2550,-1818
1093,1.0,1.0,1.0,171,4372,2565,-1807
1094,0.0,0.0,0.0,171,4376,2565,-1811
1095,0.0,0.0,0.0,171,4380,2565,-1815
1096,0.0,0.0,0.0,171,4384,2565,-1819
1097,0.0,0.0,0.0,171,4388,2565,-1823
1098,1.0,1.0,1.0,172,4392,2580,-1812
1099,0.0,0.0,0.0,172,4396,2580,-1816
1100,1.0,1.0,1.0,173,4400,2595,-1805
1101,1.0,0.0,0.5,174,4404,2610,-1794
1102,0.0,0.0,0.0,174,4408,2610,-1798
1103,0.0,0.0,0.0,174,4412,2610,-1802
1104,0.0,0.0,0.0,174,4416,2610,-1806
1105,0.0,0.0,0.0,174,4420,2610,-1810
1106,0.0,0.0,0.0,174,4424,2610,-1814
1107,0.0,0.0,0.0,174,4428,2610,-1818
1108,0.0,0.0,0.0,174,4432,2610,-1822
1109,0.0,0.0,0.0,174,4436,2610,-1826
1110,0.0,0.0,0.0,174,4440,2610,-1830
1111,0.0,0.0,0.0,174,4444,2610,-1834
1112,0.0,0.0,0.0,174,4448,2610,-1838
1113,0.0,0.0,0.0,174,4452,2610,-1842
1114,1.0,1.0,1.0,175,4456,2625,-1831
1115,0.0,0.0,0.0,175,4460,2625,-1835
1116,0.0,0.0,0.0,175,4464,2625,-1839
1117,0.0,0.0,0.0,175,4468,2625,-1843
1118,0.0,0.0,0.0,175,4472,2625,-1847
1119,0.0,0.0,0.0,175,4476,2625,-1851
1120,0.0,0.0,0.0,175,4480,2625,-1855
1121,1.0,1.0,1.0,176,4484,2640,-1844
1122,0.0,0.0,0.0,176,4488,2640,-1848
1123,0.0,0.0,0.0,176,4492,2640,-1852
1124,1.0,1.0,1.0,177,4496,2655,-1841
1125,0.0,0.0,0.0,177,4500,2655,-1845
1126,0.0,0.0,0.0,177,4504,2655,-1849
1127,0.0,0.0,0.0,177,4508,2655,-1853
1128,0.0,0.0,0.0,177,4512,2655,-1857
1129,0.0,0.0,0.0,177,4516,2655,-1861
1130,0.0,0.0,0.0,177,4520,2655,-1865
1131,0.0,0.0,0.0,177,4524,2655,-1869
1132,0.0,0.0,0.0,177,4528,2655,-1873
1133,0.0,0.0,0.0,177,4532,2655,-1877
1134,0.0,0.0,0.0,177,4536,2655,-1881
1135,0.0,0.0,0.0,177,4540,2655,-1885
1136,0.0,0.0,0.0,177,4544,2655,-1889
1137,0.0,0.0,0.0,177,4548,2655,-1893
1138,0.0,0.0,0.0,177,4552,2655,-1897
1139,0.0,0.0,0.3333333333333333,177,4556,2655,-1901
1140,0.0,0.0,0.0,177,4560,2655,-1905
1141,0.0,0.0,0.0,177,4564,2655,-1909
1142,1.0,1.0,1.0,178,4568,2670,-1898
1143,0.0,0.0,0.0,178,4572,2670,-1902
1144,0.0,0.0,0.0,178,4576,2670,-1906
1145,0.0,0.0,0.0,178,4580,2670,-1910
1146,0.0,0.0,0.0,178,4584,2670,-1914
1147,0.0,0.0,0.0,178,4588,2670,-1918
1148,0.0,0.0,0.0,178,4592,2670,-1922
1149,0.0,0.0,0.0,178,4596,2670,-1926
1150,0.0,0.0,0.0,178,4600,2670,-1930
1151,1.0,1.0,1.0,179,4604,2685,-1919
1152,0.0,0.0,0.0,179,4608,2685,-1923
1153,0.0,0.0,0.0,179,4612,2685,-1927
1154,0.0,0.0,0.0,179,4616,2685,-1931
1155,0.0,0.0,0.0,179,4620,2685,-1935
1156,0.0,0.0,0.0,179,4624,2685,-1939
1157,0.0,0.0,0.0,179,4628,2685,-1943
1158,0.0,0.0,0.5,179,4632,2685,-1947
1159,0.0,0.0,0.0,179,4636,2685,-1951
1160,0.0,0.0,0.0,179,4640,2685,-1955
1161,0.0,0.0,0.0,179,4644,2685,-1959
1162,0.0,0.0,0.0,179,4648,2685,-1963
1163,0.0,0.0,0.0,179,4652,2685,-1967
1164,0.0,0.0,0.0,179,4656,2685,-1971
1165,0.0,0.0,0.0,179,4660,2685,-1975
1166,0.0,0.0,0.0,179,4664,2685,-1979
1167,0.0,0.0,0.0,179,4668,2685,-1983
1168,0.0,0.0,0.0,179,4672,2685,-1987
1169,0.0,0.0,0.0,179,4676,2685,-1991
1170,1.0,1.0,1.0,180,4680,2700,-1980
1171,0.0,1.0,0.75,180,4684,2700,-1984
1172,0.0,0.0,0.0,180,4688,2700,-1988
1173,0.0,0.0,0.0,180,4692,2700,-1992
1174,0.0,0.0,0.0,180,4696,2700,-1996
1175,0.0,0.0,0.0,180,4700,2700,-2000
1176,0.0,0.0,0.0,180,4704,2700,-2004
1177,0.0,0.0,0.0,180,4708,2700,-2008
1178,0.0,0.0,0.0,180,4712,2700,-2012
1179,0.0,0.0,0.0,180,4716,2700,-2016
1180,0.0,0.0,0.0,180,4720,2700,-2020
1181,0.0,0.0,0.0,180,4724,2700,-2024
1182,0.0,0.0,0.0,180,4728,2700,-2028
1183,0.0,0.0,0.0,180,4732,2700,-2032
1184,0.0,0.0,0.0,180,4736,2700,-2036
1185,0.0,0.0,0.0,180,4740,2700,-2040
1186,0.0,0.0,0.0,180,4744,2700,-2044
1187,0.0,0.0,0.0,180,4748,2700,-2048
1188,0.0,0.0,0.0,180,4752,2700,-2052
1189,0.0,0.0,0.0,180,4756,2700,-2056
1190,0.0,0.0,0.0,180,4760,2700,-2060
1191,0.0,0.0,0.0,180,4764,2700,-2064
1192,0.0,0.0,0.0,180,4768,2700,-2068
1193,1.0,1.0,1.0,181,4772,2715,-2057
1194,1.0,1.0,1.0,182,4776,2730,-2046
1195,1.0,1.0,1.0,183,4780,2745,-2035
1196,0.0,0.0,0.0,183,4784,2745,-2039
1197,0.0,0.0,0.0,183,4788,2745,-2043
1198,0.0,0.0,0.0,183,4792,2745,-2047
1199,0.0,0.0,0.0,183,4796,2745,-2051
1200,0.0,0.0,0.0,183,4800,2745,-2055
1201,1.0,1.0,1.0,184,4804,2760,-2044
1202,0.0,0.0,0.0,184,4808,2760,-2048
1203,0.0,0.0,0.0,184,4812,2760,-2052
1204,0.0,0.0,0.0,184,4816,2760,-2056
1205,0.0,0.0,0.0,184,4820,2760,-2060
1206,1.0,1.0,1.0,185,4824,2775,-2049
1207,0.0,0.0,0.0,185,4828,2775,-2053
1208,0.0,0.0,0.0,185,4832,2775,-2057
1209,0.0,0.0,0.0,185,4836,2775,-2061
1210,0.0,0.0,0.0,185,4840,2775,-2065
1211,0.0,0.0,0.0,185,4844,2775,-2069
1212,0.0,0.0,0.0,185,4848,2775,-2073
1213,0.0,0.0,0.0,185,4852,2775,-2077
1214,0.0,0.0,0.0,185,4856,2775,-2081
1215,0.0,0.0,0.0,185,4860,2775,-2085
1216,0.0,0.0,0.0,185,4864,2775,-2089
1217,0.0,0.0,0.0,185,4868,2775,-2093
1218,0.0,0.0,0.0,185,4872,2775,-2097
1219,0.0,0.0,0.0,185,4876,2775,-2101
1220,0.0,0.0,0.0,185,4880,2775,-2105
1221,0.0,0.0,0.0,185,4884,2775,-2109
1222,0.0,0.0,0.0,185,4888,2775,-2113
1223,0.0,0.0,0.0,185,4892,2775,-2117
1224,0.0,0.0,0.0,185,4896,2775,-2121
1225,0.0,0.0,0.0,185,4900,2775,-2125
1226,0.0,0.0,0.0,185,4904,2775,-2129
1227,0.0,0.0,0.0,185,4908,2775,-2133
1228,0.0,1.0,0.6666666666666666,185,4912,2775,-2137
1229,1.0,1.0,0.6666666666666666,186,4916,2790,-2126
1230,0.0,0.0,0.0,186,4920,2790,-2130
1231,1.0,1.0,1.0,187,4924,2805,-2119
1232,0.0,1.0,0.75,187,4928,2805,-2123
1233,0.0,0.0,0.2,187,4932,2805,-2127
1234,0.0,0.0,0.0,187,4936,2805,-2131
1235,0.0,0.0,0.0,187,4940,2805,-2135
1236,1.0,1.0,1.0,188,4944,2820,-2124
1237,0.0,0.0,0.0,188,4948,2820,-2128
1238,0.0,0.0,0.3333333333333333,188,4952,2820,-2132
1239,0.0,0.0,0.0,188,4956,2820,-2136
1240,0.0,0.0,0.0,188,4960,2820,-2140
1241,0.0,0.0,0.0,188,4964,2820,-2144
1242,0.0,0.0,0.0,188,4968,2820,-2148
1243,0.0,0.0,0.0,188,4972,2820,-2152
1244,0.0,0.0,0.0,188,4976,2820,-2156
1245,0.0,0.0,0.0,188,4980,2820,-2160
1246,0.0,0.0,0.0,188,4984,2820,-2164
1247,0.0,0.0,0.0,188,4988,2820,-2168
1248,0.0,0.0,0.0,188,4992,2820,-2172
1249,0.0,0.0,0.0,188,4996,2820,-2176
1250,0.0,0.0,0.0,188,5000,2820,-2180
1251,0.0,0.0,0.0,188,5004,2820,-2184
1252,0.0,0.0,0.0,188,5008,2820,-2188
1253,0.0,0.0,0.0,188,5012,2820,-2192
1254,0.0,0.0,0.0,188,5016,2820,-2196
1255,0.0,0.0,0.0,188,5020,2820,-2200
1256,0.0,0.0,0.0,188,5024,2820,-2204
1257,0.0,0.0,0.0,188,5028,2820,-2208
1258,0.0,0.0,0.0,188,5032,2820,-2212
1259,1.0,0.0,0.5,189,5036,2835,-2201
1260,0.0,0.0,0.0,189,5040,2835,-2205
1261,0.0,0.0,0.3333333333333333,189,5044,2835,-2209
1262,0.0,0.0,0.0,189,5048,2835,-2213
1263,0.0,0.0,0.0,189,5052,2835,-2217
1264,0.0,0.0,0.0,189,5056,2835,-2221
1265,0.0,0.0,0.3333333333333333,189,5060,2835,-2225
1266,1.0,1.0,1.0,190,5064,2850,-2214
1267,0.0,0.0,0.0,190,5068,2850,-2218
1268,0.0,0.0,0.0,190,5072,2850,-2222
1269,0.0,0.0,0.0,190,5076,2850,-2226
1270,0.0,0.0,0.0,190,5080,2850,-2230
1271,0.0,0.0,0.0,190,5084,2850,-2234
1272,0.0,0.0,0.0,190,5088,2850,-2238
1273,0.0,0.0,0.0,190,5092,2850,-2242
1274,1.0,1.0,0.75,191,5096,2865,-2231
1275,0.0,0.0,0.0,191,5100,2865,-2235
1276,0.0,0.0,0.0,191,5104,2865,-2239
1277,0.0,0.0,0.0,191,5108,2865,-2243
1278,0.0,0.0,0.3333333333333333,191,5112,2865,-2247
1279,0.0,0.0,0.0,191,5116,2865,-2251
1280,1.0,1.0,1.0,192,5120,2880,-2240
1281,0.0,0.0,0.0,192,5124,2880,-2244
1282,0.0,0.0,0.0,192,5128,2880,-2248
1283,1.0,1.0,1.0,193,5132,2895,-2237
1284,0.0,0.0,0.0,193,5136,2895,-2241
1285,0.0,0.0,0.0,193,5140,2895,-2245
1286,1.0,1.0,1.0,194,5144,2910,-2234
1287,1.0,1.0,1.0,195,5148,2925,-2223
1288,0.0,0.0,0.0,195,5152,2925,-2227
1289,0.0,1.0,0.6666666666666666,195,5156,2925,-2231
1290,0.0,0.0,0.0,195,5160,2925,-2235
1291,0.0,0.0,0.0,195,5164,2925,-2239
1292,0.0,1.0,0.75,195,5168,2925,-2243
1293,0.0,0.0,0.0,195,5172,2925,-2247
1294,0.0,0.0,0.0,195,5176,2925,-2251
1295,0.0,0.0,0.0,195,5180,2925,-2255
1296,0.0,0.0,0.0,195,5184,2925,-2259
1297,0.0,0.0,0.0,195,5188,2925,-2263
1298,0.0,0.0,0.0,195,5192,2925,-2267
1299,0.0,0.0,0.0,195,5196,2925,-2271
1300,0.0,0.0,0.0,195,5200,2925,-2275
1301,0.0,0.0,0.0,195,5204,2925,-2279
1302,1.0,1.0,1.0,196,5208,2940,-2268
1303,0.0,0.0,0.0,196,5212,2940,-2272
1304,0.0,0.0,0.0,196,5216,2940,-2276
1305,0.0,0.0,0.0,196,5220,2940,-2280
1306,0.0,0.0,0.0,196,5224,2940,-2284
1307,1.0,0.0,0.5,197,5228,2955,-2273
1308,1.0,1.0,1.0,198,5232,2970,-2262
1309,1.0,1.0,1.0,199,5236,2985,-2251
1310,0.0,0.0,0.0,199,5240,2985,-2255
1311,0.0,0.0,0.0,199,5244,2985,-2259
1312,0.0,0.0,0.0,199,5248,2985,-2263
1313,0.0,0.0,0.0,199,5252,2985,-2267
1314,0.0,0.0,0.0,199,5256,2985,-2271
1315,0.0,0.0,0.0,199,5260,2985,-2275
1316,0.0,0.0,0.0,199,5264,2985,-2279
1317,0.0,0.0,0.0,199,5268,2985,-2283
1318,0.0,0.0,0.0,199,5272,2985,-2287
1319,1.0,1.0,0.6666666666666666,200,5276,3000,-2276
1320,0.0,0.0,0.0,200,5280,3000,-2280
1321,1.0,1.0,1.0,201,5284,3015,-2269
1322,0.0,0.0,0.0,201,5288,3015,-2273
1323,0.0,0.0,0.0,201,5292,3015,-2277
1324,0.0,0.0,0.0,201,5296,3015,-2281
1325,0.0,0.0,0.0,201,5300,3015,-2285
1326,0.0,0.0,0.2,201,5304,3015,-2289
1327,0.0,0.0,0.5,201,5308,3015,-2293
1328,1.0,1.0,1.0,202,5312,3030,-2282
1329,0.0,0.0,0.0,202,5316,3030,-2286
1330,1.0,0.0,0.5,203,5320,3045,-2275
1331,0.0,0.0,0.0,203,5324,3045,-2279
1332,1.0,1.0,0.6666666666666666,204,5328,3060,-2268
1333,0.0,1.0,0.6666666666666666,204,5332,3060,-2272
1334,0.0,0.0,0.0,204,5336,3060,-2276
1335,0.0,0.0,0.0,204,5340,3060,-2280
1336,0.0,0.0,0.0,204,5344,3060,-2284
1337,0.0,0.0,0.0,204,5348,3060,-2288
1338,0.0,0.0,0.0,204,5352,3060,-2292
1339,0.0,0.0,0.0,204,5356,3060,-2296
1340,0.0,0.0,0.0,204,5360,3060,-2300
1341,0.0,0.0,0.0,204,5364,3060,-2304
1342,0.0,0.0,0.0,204,5368,3060,-2308
1343,0.0,0.0,0.25,204,5372,3060,-2312
1344,0.0,0.0,0.0,204,5376,3060,-2316
1345,0.0,0.0,0.0,204,5380,3060,-2320
1346,0.0,0.0,0.0,204,5384,3060,-2324
1347,0.0,0.0,0.0,204,5388,3060,-2328
1348,1.0,1.0,1.0,205,5392,3075,-2317
1349,1.0,0.0,0.3333333333333333,206,5396,3090,-2306
1350,1.0,1.0,1.0,207,5400,3105,-2295
1351,0.0,0.0,0.0,207,5404,3105,-2299
1352,0.0,0.0,0.0,207,5408,3105,-2303
1353,0.0,0.0,0.0,207,5412,3105,-2307
1354,0.0,0.0,0.0,207,5416,3105,-2311
1355,0.0,0.0,0.0,207,5420,3105,-2315
1356,0.0,0.0,0.0,207,5424,3105,-2319
1357,0.0,0.0,0.0,207,5428,3105,-2323
1358,0.0,0.0,0.0,207,5432,3105,-2327
1359,0.0,0.0,0.0,207,5436,3105,-2331
1360,0.0,0.0,0.25,207,5440,3105,-2335
1361,0.0,0.0,0.0,207,5444,3105,-2339
1362,0.0,0.0,0.0,207,5448,3105,-2343
1363,0.0,0.0,0.0,207,5452,3105,-2347
1364,0.0,0.0,0.0,207,5456,3105,-2351
1365,0.0,0.0,0.0,207,5460,3105,-2355
1366,0.0,0.0,0.3333333333333333,207,5464,3105,-2359
1367,0.0,0.0,0.0,207,5468,3105,-2363
1368,1.0,1.0,1.0,208,5472,3120,-2352
1369,0.0,0.0,0.0,208,5476,3120,-2356
1370,0.0,0.0,0.0,208,5480,3120,-2360
1371,0.0,0.0,0.0,208,5484,3120,-2364
1372,0.0,0.0,0.0,208,5488,3120,-2368
1373,0.0,0.0,0.0,208,5492,3120,-2372
1374,0.0,0.0,0.0,208,5496,3120,-2376
1375,0.0,0.0,0.0,208,5500,3120,-2380
1376,0.0,0.0,0.0,208,5504,3120,-2384
1377,0.0,0.0,0.0,208,5508,3120,-2388
1378,0.0,0.0,0.0,208,5512,3120,-2392
1379,0.0,0.0,0.0,208,5516,3120,-2396
1380,0.0,0.0,0.0,208,5520,3120,-2400
1381,0.0,0.0,0.0,208,5524,3120,-2404
1382,0.0,0.0,0.0,208,5528,3120,-2408
1383,0.0,0.0,0.0,208,5532,3120,-2412
1384,0.0,0.0,0.0,208,5536,3120,-2416
1385,0.0,0.0,0.0,208,5540,3120,-2420
1386,0.0,0.0,0.0,208,5544,3120,-2424
1387,0.0,0.0,0.0,208,5548,3120,-2428
1388,0.0,0.0,0.0,208,5552,3120,-2432
1389,0.0,0.0,0.0,208,5556,3120,-2436
1390,0.0,0.0,0.0,208,5560,3120,-2440
1391,0.0,0.0,0.0,208,5564,3120,-2444
1392,0.0,0.0,0.0,208,5568,3120,-2448
1393,0.0,0.0,0.0,208,5572,3120,-2452
1394,1.0,1.0,1.0,209,5576,3135,-2441
1395,0.0,0.0,0.0,209,5580,3135,-2445
1396,1.0,0.0,0.3333333333333333,210,5584,3150,-2434
1397,0.0,0.0,0.0,210,5588,3150,-2438
1398,0.0,0.0,0.0,210,5592,3150,-2442
1399,1.0,1.0,1.0,211,5596,3165,-2431
1400,1.0,1.0,1.0,212,5600,3180,-2420
1401,1.0,1.0,1.0,213,5604,3195,-2409
1402,0.0,0.0,0.0,213,5608,3195,-2413
1403,0.0,0.0,0.0,213,5612,3195,-2417
1404,0.0,0.0,0.0,213,5616,3195,-2421
1405,0.0,0.0,0.0,213,5620,3195,-2425
1406,0.0,0.0,0.0,213,5624,3195,-2429
1407,0.0,0.0,0.0,213,5628,3195,-2433
1408,0.0,0.0,0.0,213,5632,3195,-2437
1409,0.0,0.0,0.0,213,5636,3195,-2441
1410,0.0,0.0,0.0,213,5640,3195,-2445
1411,0.0,0.0,0.0,213,5644,3195,-2449
1412,0.0,0.0,0.0,213,5648,3195,-2453
1413,0.0,0.0,0.0,213,5652,3195,-2457
1414,0.0,0.0,0.0,213,5656,3195,-2461
1415,0.0,0.0,0.0,213,5660,3195,-2465
1416,0.0,0.0,0.0,213,5664,3195,-2469
1417,1.0,1.0,1.0,214,5668,3210,-2458
1418,0.0,0.0,0.0,214,5672,3210,-2462
1419,0.0,0.0,0.0,214,5676,3210,-2466
1420,0.0,0.0,0.0,214,5680,3210,-2470
1421,0.0,0.0,0.0,214,5684,3210,-2474
1422,0.0,0.0,0.5,214,5688,3210,-2478
1423,0.0,0.0,0.0,214,5692,3210,-2482
1424,0.0,0.0,0.0,214,5696,3210,-2486
1425,0.0,0.0,0.0,214,5700,3210,-2490
1426,1.0,1.0,0.75,215,5704,3225,-2479
1427,1.0,0.0,0.25,216,5708,3240,-2468
1428,0.0,0.0,0.0,216,5712,3240,-2472
1429,0.0,0.0,0.0,216,5716,3240,-2476
1430,1.0,1.0,1.0,217,5720,3255,-2465
1431,0.0,0.0,0.0,217,5724,3255,-2469
1432,0.0,0.0,0.0,217,5728,3255,-2473
1433,0.0,0.0,0.0,217,5732,3255,-2477
1434,0.0,0.0,0.0,217,5736,3255,-2481
1435,0.0,0.0,0.3333333333333333,217,5740,3255,-2485
1436,0.0,0.0,0.0,217,5744,3255,-2489
1437,0.0,0.0,0.0,217,5748,3255,-2493
1438,0.0,0.0,0.0,217,5752,3255,-2497
1439,1.0,1.0,1.0,218,5756,3270,-2486
1440,1.0,1.0,1.0,219,5760,3285,-2475
1441,0.0,0.0,0.0,219,5764,3285,-2479
1442,0.0,0.0,0.0,219,5768,3285,-2483
1443,0.0,0.0,0.0,219,5772,3285,-2487
1444,0.0,0.0,0.3333333333333333,219,5776,3285,-2491
1445,0.0,0.0,0.0,219,5780,3285,-2495
1446,0.0,0.0,0.0,219,5784,3285,-2499
1447,0.0,0.0,0.0,219,5788,3285,-2503
1448,0.0,0.0,0.0,219,5792,3285,-2507
1449,0.0,0.0,0.0,219,5796,3285,-2511
1450,0.0,0.0,0.3333333333333333,219,5800,3285,-2515
1451,0.0,0.0,0.0,219,5804,3285,-2519
1452,0.0,0.0,0.0,219,5808,3285,-2523
1453,0.0,0.0,0.0,219,5812,3285,-2527
1454,0.0,0.0,0.0,219,5816,3285,-2531
1455,0.0,0.0,0.0,219,5820,3285,-2535
1456,0.0,0.0,0.0,219,5824,3285,-2539
1457,0.0,0.0,0.0,219,5828,3285,-2543
1458,1.0,1.0,1.0,220,5832,3300,-2532
1459,0.0,0.0,0.0,220,5836,3300,-2536
1460,0.0,0.0,0.0,220,5840,3300,-2540
1461,0.0,0.0,0.0,220,5844,3300,-2544
1462,0.0,0.0,0.0,220,5848,3300,-2548
1463,0.0,0.0,0.0,220,5852,3300,-2552
1464,0.0,0.0,0.0,220,5856,3300,-2556
1465,1.0,1.0,0.6666666666666666,221,5860,3315,-2545
1466,0.0,0.0,0.0,221,5864,3315,-2549
1467,0.0,0.0,0.0,221,5868,3315,-2553
1468,0.0,0.0,0.0,221,5872,3315,-2557
1469,1.0,0.0,0.5,222,5876,3330,-2546
1470,0.0,0.0,0.0,222,5880,3330,-2550
1471,0.0,0.0,0.0,222,5884,3330,-2554
1472,0.0,0.0,0.0,222,5888,3330,-2558
1473,0.0,0.0,0.0,222,5892,3330,-2562
1474,0.0,0.0,0.0,222,5896,3330,-2566
1475,0.0,0.0,0.0,222,5900,3330,-2570
1476,0.0,0.0,0.0,222,5904,3330,-2574
1477,0.0,0.0,0.0,222,5908,3330,-2578
1478,0.0,0.0,0.0,222,5912,3330,-2582
1479,0.0,0.0,0.0,222,5916,3330,-2586
1480,0.0,0.0,0.0,222,5920,3330,-2590
1481,0.0,0.0,0.0,222,5924,3330,-2594
1482,0.0,0.0,0.0,222,5928,3330,-2598
1483,0.0,0.0,0.3333333333333333,222,5932,3330,-2602
1484,1.0,1.0,1.0,223,5936,3345,-2591
1485,0.0,0.0,0.0,223,5940,3345,-2595
1486,0.0,0.0,0.0,223,5944,3345,-2599
1487,0.0,0.0,0.0,223,5948,3345,-2603
1488,0.0,0.0,0.0,223,5952,3345,-2607
1489,1.0,1.0,0.75,224,5956,3360,-2596
1490,0.0,0.0,0.0,224,5960,3360,-2600
1491,0.0,0.0,0.0,224,5964,3360,-2604
1492,0.0,0.0,0.0,224,5968,3360,-2608
1493,0.0,0.0,0.0,224,5972,3360,-2612
1494,0.0,0.0,0.0,224,5976,3360,-2616
1495,0.0,0.0,0.0,224,5980,3360,-2620
1496,0.0,0.0,0.0,224,5984,3360,-2624
1497,0.0,0.0,0.0,224,5988,3360,-2628
1498,0.0,0.0,0.0,224,5992,3360,-2632
1499,1.0,1.0,1.0,225,5996,3375,-2621
1500,0.0,0.0,0.0,225,6000,3375,-2625
1501,0.0,0.0,0.0,225,6004,3375,-2629
1502,0.0,0.0,0.0,225,6008,3375,-2633
1503,1.0,1.0,1.0,226,6012,3390,-2622
1504,1.0,1.0,0.6666666666666666,227,6016,3405,-2611
1505,0.0,0.0,0.0,227,6020,3405,-2615
1506,0.0,0.0,0.0,227,6024,3405,-2619
1507,0.0,0.0,0.0,227,6028,3405,-2623
1508,1.0,1.0,1.0,228,6032,3420,-2612
1509,0.0,0.0,0.0,228,6036,3420,-2616
1510,1.0,1.0,1.0,229,6040,3435,-2605
1511,0.0,0.0,0.0,229,6044,3435,-2609
1512,0.0,0.0,0.0,229,6048,3435,-2613
1513,0.0,0.0,0.0,229,6052,3435,-2617
1514,0.0,0.0,0.0,229,6056,3435,-2621
1515,1.0,1.0,1.0,230,6060,3450,-2610
1516,0.0,0.0,0.0,230,6064,3450,-2614
1517,0.0,0.0,0.0,230,6068,3450,-2618
1518,0.0,0.0,0.0,230,6072,3450,-2622
1519,0.0,0.0,0.0,230,6076,3450,-2626
1520,1.0,1.0,1.0,231,6080,3465,-2615
1521,1.0,1.0,1.0,232,6084,3480,-2604
1522,0.0,0.0,0.0,232,6088,3480,-2608
1523,1.0,1.0,0.6666666666666666,233,6092,3495,-2597
1524,1.0,1.0,1.0,234,6096,3510,-2586
1525,0.0,0.0,0.0,234,6100,3510,-2590
1526,0.0,0.0,0.0,234,6104,3510,-2594
1527,0.0,0.0,0.0,234,6108,3510,-2598
1528,0.0,0.0,0.0,234,6112,3510,-2602
1529,0.0,0.0,0.0,234,6116,3510,-2606
1530,0.0,0.0,0.0,234,6120,3510,-2610
1531,0.0,0.0,0.0,234,6124,3510,-2614
1532,0.0,0.0,0.2,234,6128,3510,-2618
1533,0.0,0.0,0.0,234,6132,3510,-2622
1534,0.0,0.0,0.0,234,6136,3510,-2626
1535,0.0,0.0,0.0,234,6140,3510,-2630
1536,1.0,1.0,1.0,235,6144,3525,-2619
1537,0.0,0.0,0.3333333333333333,235,6148,3525,-2623
1538,1.0,1.0,1.0,236,6152,3540,-2612
1539,0.0,0.0,0.0,236,6156,3540,-2616
1540,1.0,1.0,0.6666666666666666,237,6160,3555,-2605
1541,1.0,1.0,1.0,238,6164,3570,-2594
1542,0.0,0.0,0.0,238,6168,3570,-2598
1543,0.0,0.0,0.0,238,6172,3570,-2602
1544,0.0,0.0,0.0,238,6176,3570,-2606
1545,0.0,0.0,0.0,238,6180,3570,-2610
1546,0.0,0.0,0.0,238,6184,3570,-2614
1547,0.0,0.0,0.0,238,6188,3570,-2618
1548,0.0,0.0,0.0,238,6192,3570,-2622
1549,0.0,0.0,0.0,238,6196,3570,-2626
1550,0.0,0.0,0.0,238,6200,3570,-2630
1551,0.0,0.0,0.0,238,6204,3570,-2634
1552,0.0,0.0,0.0,238,6208,3570,-2638
1553,0.0,0.0,0.0,238,6212,3570,-2642
1554,0.0,0.0,0.0,238,6216,3570,-2646
1555,1.0,1.0,1.0,239,6220,3585,-2635
1556,0.0,0.0,0.0,239,6224,3585,-2639
1557,0.0,0.0,0.0,239,6228,3585,-2643
1558,0.0,0.0,0.0,239,6232,3585,-2647
1559,0.0,0.0,0.0,239,6236,3585,-2651
1560,0.0,0.0,0.0,239,6240,3585,-2655
1561,0.0,0.0,0.0,239,6244,3585,-2659
1562,0.0,0.0,0.0,239,6248,3585,-2663
1563,0.0,0.0,0.0,239,6252,3585,-2667
1564,0.0,1.0,0.6,239,6256,3585,-2671
1565,0.0,0.0,0.0,239,6260,3585,-2675
1566,0.0,0.0,0.0,239,6264,3585,-2679
1567,0.0,0.0,0.0,239,6268,3585,-2683
1568,0.0,0.0,0.0,239,6272,3585,-2687
1569,0.0,0.0,0.0,239,6276,3585,-2691
1570,0.0,0.0,0.0,239,6280,3585,-2695
1571,0.0,0.0,0.0,239,6284,3585,-2699
1572,0.0,0.0,0.0,239,6288,3585,-2703
1573,0.0,0.0,0.0,239,6292,3585,-2707
1574,1.0,1.0,1.0,240,6296,3600,-2696
1575,0.0,0.0,0.0,240,6300,3600,-2700
1576,0.0,0.0,0.0,240,6304,3600,-2704
1577,0.0,0.0,0.0,240,6308,3600,-2708
1578,1.0,1.0,1.0,241,6312,3615,-2697
1579,0.0,0.0,0.0,241,6316,3615,-2701
1580,0.0,0.0,0.0,241,6320,3615,-2705
1581,0.0,0.0,0.0,241,6324,3615,-2709
1582,0.0,0.0,0.0,241,6328,3615,-2713
1583,1.0,0.0,0.4,242,6332,3630,-2702
1584,1.0,1.0,1.0,243,6336,3645,-2691
1585,0.0,0.0,0.0,243,6340,3645,-2695
1586,0.0,0.0,0.0,243,6344,3645,-2699
1587,0.0,0.0,0.0,243,6348,3645,-2703
1588,1.0,1.0,1.0,244,6352,3660,-2692
1589,1.0,1.0,1.0,245,6356,3675,-2681
1590,1.0,1.0,1.0,246,6360,3690,-2670
1591,0.0,0.0,0.0,246,6364,3690,-2674
1592,0.0,0.0,0.0,246,6368,3690,-2678
1593,0.0,0.0,0.0,246,6372,3690,-2682
1594,0.0,0.0,0.0,246,6376,3690,-2686
1595,0.0,0.0,0.0,246,6380,3690,-2690
1596,1.0,0.0,0.25,247,6384,3705,-2679
1597,0.0,0.0,0.0,247,6388,3705,-2683
1598,1.0,0.0,0.5,248,6392,3720,-2672
1599,0.0,0.0,0.0,248,6396,3720,-2676
1600,0.0,0.0,0.0,248,6400,3720,-2680
1601,0.0,0.0,0.0,248,6404,3720,-2684
1602,0.0,0.0,0.0,248,6408,3720,-2688
1603,0.0,0.0,0.0,248,6412,3720,-2692
1604,0.0,0.0,0.0,248,6416,3720,-2696
1605,0.0,0.0,0.0,248,6420,3720,-2700
1606,1.0,1.0,1.0,249,6424,3735,-2689
1607,0.0,0.0,0.0,249,6428,3735,-2693
1608,1.0,1.0,1.0,250,6432,3750,-2682
1609,0.0,0.0,0.0,250,6436,3750,-2686
1610,0.0,0.0,0.0,250,6440,3750,-2690
1611,0.0,0.0,0.0,250,6444,3750,-2694
1612,0.0,0.0,0.0,250,6448,3750,-2698
1613,0.0,0.0,0.0,250,6452,3750,-2702
1614,0.0,0.0,0.0,250,6456,3750,-2706
1615,0.0,0.0,0.0,250,6460,3750,-2710
1616,0.0,0.0,0.0,250,6464,3750,-2714
1617,0.0,0.0,0.2,250,6468,3750,-2718
1618,0.0,0.0,0.25,250,6472,3750,-2722
1619,0.0,0.0,0.0,250,6476,3750,-2726
1620,0.0,0.0,0.0,250,6480,3750,-2730
1621,0.0,0.0,0.0,250,6484,3750,-2734
1622,0.0,0.0,0.0,250,6488,3750,-2738
1623,0.0,0.0,0.3333333333333333,250,6492,3750,-2742
1624,0.0,0.0,0.3333333333333333,250,6496,3750,-2746
1625,0.0,0.0,0.3333333333333333,250,6500,3750,-2750
1626,0.0,0.0,0.0,250,6504,3750,-2754
1627,0.0,0.0,0.0,250,6508,3750,-2758
1628,0.0,0.0,0.0,250,6512,3750,-2762
1629,0.0,0.0,0.0,250,6516,3750,-2766
1630,0.0,0.0,0.0,250,6520,3750,-2770
1631,1.0,1.0,0.75,251,6524,3765,-2759
1632,0.0,0.0,0.0,251,6528,3765,-2763
1633,0.0,0.0,0.0,251,6532,3765,-2767
1634,0.0,0.0,0.0,251,6536,3765,-2771
1635,1.0,1.0,1.0,252,6540,3780,-2760
1636,1.0,1.0,1.0,253,6544,3795,-2749
1637,0.0,0.0,0.0,253,6548,3795,-2753
1638,0.0,0.0,0.0,253,6552,3795,-2757
1639,0.0,0.0,0.0,253,6556,3795,-2761
1640,0.0,0.0,0.0,253,6560,3795,-2765
1641,1.0,1.0,1.0,254,6564,3810,-2754
1642,0.0,0.0,0.0,254,6568,3810,-2758
1643,0.0,0.0,0.0,254,6572,3810,-2762
1644,1.0,1.0,1.0,255,6576,3825,-2751
1645,0.0,0.0,0.0,255,6580,3825,-2755
1646,0.0,0.0,0.0,255,6584,3825,-2759
1647,0.0,0.0,0.0,255,6588,3825,-2763
1648,0.0,0.0,0.0,255,6592,3825,-2767
1649,1.0,1.0,0.6666666666666666,256,6596,3840,-2756
1650,0.0,0.0,0.0,256,6600,3840,-2760
1651,0.0,0.0,0.0,256,6604,3840,-2764
1652,1.0,1.0,0.6666666666666666,257,6608,3855,-2753
1653,1.0,1.0,1.0,258,6612,3870,-2742
1654,0.0,0.0,0.0,258,6616,3870,-2746
1655,0.0,0.0,0.0,258,6620,3870,-2750
1656,1.0,0.0,0.5,259,6624,3885,-2739
1657,0.0,0.0,0.0,259,6628,3885,-2743
1658,0.0,0.0,0.0,259,6632,3885,-2747
1659,0.0,0.0,0.0,259,6636,3885,-2751
1660,1.0,1.0,1.0,260,6640,3900,-2740
1661,0.0,0.0,0.0,260,6644,3900,-2744
1662,0.0,0.0,0.0,260,6648,3900,-2748
1663,0.0,0.0,0.0,260,6652,3900,-2752
1664,0.0,0.0,0.2,260,6656,3900,-2756
1665,0.0,0.0,0.0,260,6660,3900,-2760
1666,0.0,0.0,0.0,260,6664,3900,-2764
1667,1.0,1.0,1.0,261,6668,3915,-2753
1668,0.0,0.0,0.0,261,6672,3915,-2757
1669,0.0,0.0,0.25,261,6676,3915,-2761
1670,0.0,0.0,0.0,261,6680,3915,-2765
1671,0.0,0.0,0.0,261,6684,3915,-2769
1672,0.0,0.0,0.0,261,6688,3915,-2773
1673,0.0,0.0,0.0,261,6692,3915,-2777
1674,0.0,0.0,0.5,261,6696,3915,-2781
1675,0.0,0.0,0.0,261,6700,3915,-2785
1676,0.0,0.0,0.0,261,6704,3915,-2789
1677,0.0,0.0,0.0,261,6708,3915,-2793
1678,0.0,0.0,0.0,261,6712,3915,-2797
1679,0.0,0.0,0.0,261,6716,3915,-2801
1680,0.0,0.0,0.3333333333333333,261,6720,3915,-2805
1681,0.0,0.0,0.0,261,6724,3915,-2809
1682,1.0,1.0,1.0,262,6728,3930,-2798
1683,0.0,0.0,0.0,262,6732,3930,-2802
1684,1.0,1.0,1.0,263,6736,3945,-2791
1685,0.0,0.0,0.0,263,6740,3945,-2795
1686,0.0,0.0,0.0,263,6744,3945,-2799
1687,0.0,0.0,0.0,263,6748,3945,-2803
1688,0.0,0.0,0.0,263,6752,3945,-2807
1689,0.0,0.0,0.0,263,6756,3945,-2811
1690,0.0,0.0,0.0,263,6760,3945,-2815
1691,1.0,1.0,1.0,264,6764,3960,-2804
1692,0.0,0.0,0.0,264,6768,3960,-2808
1693,0.0,0.0,0.0,264,6772,3960,-2812
1694,0.0,0.0,0.0,264,6776,3960,-2816
1695,0.0,0.0,0.0,264,6780,3960,-2820
1696,0.0,0.0,0.0,264,6784,3960,-2824
1697,0.0,0.0,0.0,264,6788,3960,-2828
1698,1.0,1.0,1.0,265,6792,3975,-2817
1699,0.0,0.0,0.0,265,6796,3975,-2821
1700,0.0,0.0,0.0,265,6800,3975,-2825
1701,1.0,1.0,1.0,266,6804,3990,-2814
1702,1.0,1.0,1.0,267,6808,4005,-2803
1703,0.0,0.0,0.0,267,6812,4005,-2807
1704,0.0,0.0,0.5,267,6816,4005,-2811
1705,0.0,0.0,0.0,267,6820,4005,-2815
1706,0.0,0.0,0.0,267,6824,4005,-2819
1707,0.0,0.0,0.0,267,6828,4005,-2823
1708,0.0,0.0,0.0,267,6832,4005,-2827
1709,0.0,0.0,0.0,267,6836,4005,-2831
1710,0.0,0.0,0.0,267,6840,4005,-2835
1711,0.0,0.0,0.0,267,6844,4005,-2839
1712,0.0,0.0,0.0,267,6848,4005,-2843
1713,0.0,0.0,0.0,267,6852,4005,-2847
1714,0.0,0.0,0.0,267,6856,4005,-2851
1715,0.0,0.0,0.25,267,6860,4005,-2855
1716,0.0,0.0,0.0,267,6864,4005,-2859
1717,0.0,0.0,0.0,267,6868,4005,-2863
1718,0.0,0.0,0.0,267,6872,4005,-2867
1719,0.0,0.0,0.0,267,6876,4005,-2871
1720,0.0,0.0,0.0,267,6880,4005,-2875
1721,0.0,0.0,0.0,267,6884,4005,-2879
1722,0.0,0.0,0.0,267,6888,4005,-2883
1723,1.0,0.0,0.4,268,6892,4020,-2872
1724,0.0,0.0,0.0,268,6896,4020,-2876
1725,0.0,0.0,0.0,268,6900,4020,-2880
1726,0.0,0.0,0.0,268,6904,4020,-2884
1727,0.0,0.0,0.0,268,6908,4020,-2888
1728,0.0,0.0,0.0,268,6912,4020,-2892
1729,1.0,1.0,1.0,269,6916,4035,-2881
1730,0.0,0.0,0.0,269,6920,4035,-2885
1731,0.0,0.0,0.0,269,6924,4035,-2889
1732,0.0,0.0,0.0,269,6928,4035,-2893
1733,0.0,0.0,0.0,269,6932,4035,-2897
1734,1.0,1.0,1.0,270,6936,4050,-2886
1735,0.0,0.0,0.0,270,6940,4050,-2890
1736,1.0,1.0,0.75,271,6944,4065,-2879
1737,0.0,0.0,0.0,271,6948,4065,-2883
1738,1.0,0.0,0.5,272,6952,4080,-2872
1739,0.0,0.0,0.0,272,6956,4080,-2876
1740,0.0,0.0,0.0,272,6960,4080,-2880
1741,0.0,0.0,0.0,272,6964,4080,-2884
1742,0.0,0.0,0.0,272,6968,4080,-2888
1743,0.0,0.0,0.0,272,6972,4080,-2892
1744,0.0,0.0,0.0,272,6976,4080,-2896
1745,0.0,0.0,0.0,272,6980,4080,-2900
1746,0.0,0.0,0.0,272,6984,4080,-2904
1747,0.0,0.0,0.0,272,6988,4080,-2908
1748,0.0,0.0,0.0,272,6992,4080,-2912
1749,0.0,0.0,0.0,272,6996,4080,-2916
1750,0.0,0.0,0.0,272,7000,4080,-2920
1751,0.0,0.0,0.0,272,7004,4080,-2924
1752,0.0,0.0,0.0,272,7008,4080,-2928
1753,0.0,0.0,0.0,272,7012,4080,-2932
1754,0.0,0.0,0.0,272,7016,4080,-2936
1755,0.0,0.0,0.0,272,7020,4080,-2940
1756,0.0,0.0,0.0,272,7024,4080,-2944
1757,1.0,1.0,1.0,273,7028,4095,-2933
1758,0.0,0.0,0.0,273,7032,4095,-2937
1759,0.0,0.0,0.0,273,7036,4095,-2941
1760,0.0,0.0,0.0,273,7040,4095,-2945
1761,0.0,0.0,0.0,273,7044,4095,-2949
1762,0.0,0.0,0.0,273,7048,4095,-2953
1763,1.0,1.0,1.0,274,7052,4110,-2942
1764,1.0,1.0,0.6666666666666666,275,7056,4125,-2931
1765,1.0,1.0,1.0,276,7060,4140,-2920
1766,0.0,0.0,0.0,276,7064,4140,-2924
1767,1.0,1.0,1.0,277,7068,4155,-2913
1768,1.0,0.0,0.5,278,7072,4170,-2902
1769,0.0,0.0,0.0,278,7076,4170,-2906
1770,0.0,0.0,0.0,278,7080,4170,-2910
1771,0.0,0.0,0.0,278,7084,4170,-2914
1772,0.0,0.0,0.0,278,7088,4170,-2918
1773,0.0,0.0,0.0,278,7092,4170,-2922
1774,1.0,1.0,1.0,279,7096,4185,-2911
1775,0.0,0.0,0.0,279,7100,4185,-2915
1776,0.0,0.0,0.0,279,7104,4185,-2919
1777,0.0,0.0,0.0,279,7108,4185,-2923
1778,0.0,0.0,0.0,279,7112,4185,-2927
1779,0.0,0.0,0.0,279,7116,4185,-2931
1780,0.0,0.0,0.0,279,7120,4185,-2935
1781,0.0,0.0,0.0,279,7124,4185,-2939
1782,1.0,1.0,1.0,280,7128,4200,-2928
1783,0.0,0.0,0.0,280,7132,4200,-2932
1784,0.0,0.0,0.0,280,7136,4200,-2936
1785,0.0,0.0,0.0,280,7140,4200,-2940
1786,0.0,0.0,0.0,280,7144,4200,-2944
1787,1.0,1.0,1.0,281,7148,4215,-2933
1788,0.0,0.0,0.0,281,7152,4215,-2937
1789,0.0,0.0,0.0,281,7156,4215,-2941
1790,1.0,1.0,1.0,282,7160,4230,-2930
1791,1.0,1.0,0.6,283,7164,4245,-2919
1792,0.0,0.0,0.0,283,7168,4245,-2923
1793,0.0,0.0,0.0,283,7172,4245,-2927
1794,0.0,0.0,0.0,283,7176,4245,-2931
1795,0.0,0.0,0.0,283,7180,4245,-2935
1796,0.0,0.0,0.0,283,7184,4245,-2939
1797,0.0,0.0,0.0,283,7188,4245,-2943
1798,1.0,1.0,1.0,284,7192,4260,-2932
1799,1.0,0.0,0.5,285,7196,4275,-2921
1800,1.0,1.0,1.0,286,7200,4290,-2910
1801,0.0,0.0,0.0,286,7204,4290,-2914
1802,0.0,0.0,0.0,286,7208,4290,-2918
1803,0.0,0.0,0.0,286,7212,4290,-2922
1804,0.0,0.0,0.0,286,7216,4290,-2926
1805,0.0,0.0,0.0,286,7220,4290,-2930
1806,0.0,0.0,0.0,286,7224,4290,-2934
1807,0.0,0.0,0.0,286,7228,4290,-2938
1808,0.0,0.0,0.0,286,7232,4290,-2942
1809,0.0,0.0,0.0,286,7236,4290,-2946
1810,0.0,0.0,0.0,286,7240,4290,-2950
1811,0.0,0.0,0.0,286,7244,4290,-2954
1812,0.0,0.0,0.0,286,7248,4290,-2958
1813,1.0,1.0,1.0,287,7252,4305,-2947
1814,0.0,0.0,0.0,287,7256,4305,-2951
1815,0.0,0.0,0.0,287,7260,4305,-2955
1816,0.0,0.0,0.0,287,7264,4305,-2959
1817,0.0,0.0,0.0,287,7268,4305,-2963
1818,0.0,0.0,0.0,287,7272,4305,-2967
1819,0.0,0.0,0.0,287,7276,4305,-2971
1820,0.0,0.0,0.0,287,7280,4305,-2975
1821,0.0,0.0,0.0,287,7284,4305,-2979
1822,1.0,1.0,1.0,288,7288,4320,-2968
1823,0.0,0.0,0.0,288,7292,4320,-2972
1824,0.0,0.0,0.0,288,7296,4320,-2976
1825,1.0,1.0,1.0,289,7300,4335,-2965
1826,0.0,0.0,0.0,289,7304,4335,-2969
1827,0.0,0.0,0.0,289,7308,4335,-2973
1828,0.0,0.0,0.0,289,7312,4335,-2977
1829,0.0,0.0,0.4,289,7316,4335,-2981
1830,0.0,0.0,0.0,289,7320,4335,-2985
1831,1.0,1.0,0.6666666666666666,290,7324,4350,-2974
1832,0.0,0.0,0.0,290,7328,4350,-2978
1833,0.0,0.0,0.0,290,7332,4350,-2982
1834,0.0,0.0,0.0,290,7336,4350,-2986
1835,1.0,0.0,0.3333333333333333,291,7340,4365,-2975
1836,0.0,0.0,0.0,291,7344,4365,-2979
1837,0.0,0.0,0.3333333333333333,291,7348,4365,-2983
1838,0.0,0.0,0.0,291,7352,4365,-2987
1839,0.0,0.0,0.0,291,7356,4365,-2991
1840,0.0,0.0,0.0,291,7360,4365,-2995
1841,0.0,0.0,0.0,291,7364,4365,-2999
1842,0.0,0.0,0.0,291,7368,4365,-3003
1843,0.0,0.0,0.0,291,7372,4365,-3007
1844,0.0,0.0,0.0,291,7376,4365,-3011
1845,1.0,1.0,0.8,292,7380,4380,-3000
1846,0.0,0.0,0.0,292,7384,4380,-3004
1847,0.0,0.0,0.3333333333333333,292,7388,4380,-3008
1848,0.0,0.0,0.0,292,7392,4380,-3012
1849,0.0,1.0,0.75,292,7396,4380,-3016
1850,0.0,0.0,0.0,292,7400,4380,-3020
1851,0.0,0.0,0.0,292,7404,4380,-3024
1852,0.0,0.0,0.0,292,7408,4380,-3028
1853,0.0,0.0,0.2,292,7412,4380,-3032
1854,0.0,0.0,0.0,292,7416,4380,-3036
1855,0.0,0.0,0.0,292,7420,4380,-3040
1856,0.0,0.0,0.0,292,7424,4380,-3044
1857,0.0,0.0,0.0,292,7428,4380,-3048
1858,0.0,0.0,0.0,292,7432,4380,-3052
1859,0.0,0.0,0.0,292,7436,4380,-3056
1860,0.0,0.0,0.0,292,7440,4380,-3060
1861,0.0,0.0,0.0,292,7444,4380,-3064
1862,0.0,0.0,0.0,292,7448,4380,-3068
1863,0.0,0.0,0.0,292,7452,4380,-3072
1864,0.0,0.0,0.0,292,7456,4380,-3076
1865,0.0,0.0,0.0,292,7460,4380,-3080
1866,1.0,1.0,1.0,293,7464,4395,-3069
1867,0.0,0.0,0.0,293,7468,4395,-3073
1868,0.0,0.0,0.0,293,7472,4395,-3077
1869,0.0,0.0,0.0,293,7476,4395,-3081
1870,1.0,1.0,1.0,294,7480,4410,-3070
1871,0.0,0.0,0.0,294,7484,4410,-3074
1872,1.0,1.0,1.0,295,7488,4425,-3063
1873,0.0,0.0,0.0,295,7492,4425,-3067
1874,0.0,0.0,0.0,295,7496,4425,-3071
1875,0.0,0.0,0.0,295,7500,4425,-3075
1876,0.0,0.0,0.0,295,7504,4425,-3079
1877,0.0,0.0,0.0,295,7508,4425,-3083
1878,0.0,0.0,0.0,295,7512,4425,-3087
1879,0.0,0.0,0.0,295,7516,4425,-3091
1880,0.0,0.0,0.5,295,7520,4425,-3095
1881,0.0,0.0,0.0,295,7524,4425,-3099
1882,1.0,1.0,1.0,296,7528,4440,-3088
1883,0.0,0.0,0.0,296,7532,4440,-3092
1884,1.0,1.0,1.0,297,7536,4455,-3081
1885,0.0,0.0,0.0,297,7540,4455,-3085
1886,1.0,1.0,1.0,298,7544,4470,-3074
1887,0.0,0.0,0.0,298,7548,4470,-3078
1888,0.0,0.0,0.0,298,7552,4470,-3082
1889,0.0,0.0,0.0,298,7556,4470,-3086
1890,0.0,0.0,0.0,298,7560,4470,-3090
1891,0.0,0.0,0.0,298,7564,4470,-3094
1892,1.0,0.0,0.5,299,7568,4485,-3083
1893,1.0,1.0,0.6666666666666666,300,7572,4500,-3072
1894,0.0,0.0,0.0,300,7576,4500,-3076
1895,0.0,0.0,0.0,300,7580,4500,-3080
1896,0.0,0.0,0.0,300,7584,4500,-3084
1897,0.0,1.0,0.6,300,7588,4500,-3088
1898,0.0,0.0,0.0,300,7592,4500,-3092
1899,0.0,0.0,0.0,300,7596,4500,-3096
1900,1.0,1.0,1.0,301,7600,4515,-3085
1901,0.0,0.0,0.0,301,7604,4515,-3089
1902,1.0,1.0,1.0,302,7608,4530,-3078
1903,0.0,0.0,0.0,302,7612,4530,-3082
1904,0.0,0.0,0.0,302,7616,4530,-3086
1905,0.0,0.0,0.25,302,7620,4530,-3090
1906,1.0,1.0,1.0,303,7624,4545,-3079
1907,1.0,0.0,0.5,304,7628,4560,-3068
1908,0.0,0.0,0.0,304,7632,4560,-3072
1909,1.0,1.0,1.0,305,7636,4575,-3061
1910,0.0,0.0,0.0,305,7640,4575,-3065
1911,0.0,0.0,0.0,305,7644,4575,-3069
1912,0.0,0.0,0.0,305,7648,4575,-3073
1913,0.0,0.0,0.0,305,7652,4575,-3077
1914,0.0,0.0,0.3333333333333333,305,7656,4575,-3081
1915,0.0,0.0,0.0,305,7660,4575,-3085
1916,0.0,0.0,0.0,305,7664,4575,-3089
1917,0.0,0.0,0.0,305,7668,4575,-3093
1918,1.0,1.0,1.0,306,7672,4590,-3082
1919,0.0,0.0,0.0,306,7676,4590,-3086
1920,0.0,0.0,0.0,306,7680,4590,-3090
1921,0.0,0.0,0.0,306,7684,4590,-3094
1922,0.0,0.0,0.0,306,7688,4590,-3098
1923,0.0,0.0,0.0,306,7692,4590,-3102
1924,1.0,1.0,1.0,307,7696,4605,-3091
1925,0.0,0.0,0.0,307,7700,4605,-3095
1926,0.0,1.0,0.6,307,7704,4605,-3099
1927,0.0,0.0,0.0,307,7708,4605,-3103
1928,1.0,1.0,1.0,308,7712,4620,-3092
1929,0.0,0.0,0.0,308,7716,4620,-3096
1930,1.0,1.0,1.0,309,7720,4635,-3085
1931,0.0,0.0,0.0,309,7724,4635,-3089
1932,1.0,1.0,0.6,310,7728,4650,-3078
1933,0.0,0.0,0.0,310,7732,4650,-3082
1934,0.0,0.0,0.0,310,7736,4650,-3086
1935,0.0,0.0,0.0,310,7740,4650,-3090
1936,0.0,0.0,0.0,310,7744,4650,-3094
1937,0.0,0.0,0.0,310,7748,4650,-3098
1938,0.0,0.0,0.0,310,7752,4650,-3102
1939,0.0,0.0,0.0,310,7756,4650,-3106
1940,0.0,0.0,0.0,310,7760,4650,-3110
1941,0.0,0.0,0.0,310,7764,4650,-3114
1942,1.0,1.0,1.0,311,7768,4665,-3103
1943,0.0,0.0,0.0,311,7772,4665,-3107
1944,0.0,0.0,0.3333333333333333,311,7776,4665,-3111
1945,0.0,0.0,0.0,311,7780,4665,-3115
1946,0.0,0.0,0.0,311,7784,4665,-3119
1947,0.0,0.0,0.0,311,7788,4665,-3123
1948,0.0,0.0,0.0,311,7792,4665,-3127
1949,0.0,0.0,0.25,311,7796,4665,-3131
1950,0.0,0.0,0.0,311,7800,4665,-3135
1951,0.0,0.0,0.0,311,7804,4665,-3139
1952,1.0,1.0,1.0,312,7808,4680,-3128
1953,1.0,0.0,0.3333333333333333,313,7812,4695,-3117
1954,0.0,0.0,0.0,313,7816,4695,-3121
1955,1.0,1.0,1.0,314,7820,4710,-3110
1956,0.0,0.0,0.0,314,7824,4710,-3114
1957,0.0,0.0,0.0,314,7828,4710,-3118
1958,0.0,0.0,0.0,314,7832,4710,-3122
1959,0.0,0.0,0.0,314,7836,4710,-3126
1960,0.0,0.0,0.0,314,7840,4710,-3130
1961,0.0,0.0,0.0,314,7844,4710,-3134
1962,1.0,1.0,1.0,315,7848,4725,-3123
1963,0.0,0.0,0.0,315,7852,4725,-3127
1964,1.0,0.0,0.3333333333333333,316,7856,4740,-3116
1965,0.0,0.0,0.0,316,7860,4740,-3120
1966,0.0,0.0,0.0,316,7864,4740,-3124
1967,0.0,0.0,0.0,316,7868,4740,-3128
1968,0.0,0.0,0.0,316,7872,4740,-3132
1969,0.0,0.0,0.3333333333333333,316,7876,4740,-3136
1970,0.0,0.0,0.0,316,7880,4740,-3140
1971,0.0,0.0,0.0,316,7884,4740,-3144
1972,0.0,0.0,0.0,316,7888,4740,-3148
1973,0.0,1.0,0.6666666666666666,316,7892,4740,-3152
1974,0.0,0.0,0.0,316,7896,4740,-3156
1975,1.0,1.0,1.0,317,7900,4755,-3145
1976,0.0,0.0,0.0,317,7904,4755,-3149
1977,0.0,0.0,0.4,317,7908,4755,-3153
1978,1.0,1.0,1.0,318,7912,4770,-3142
1979,0.0,0.0,0.0,318,7916,4770,-3146
1980,0.0,0.0,0.0,318,7920,4770,-3150
1981,0.0,0.0,0.0,318,7924,4770,-3154
1982,0.0,0.0,0.0,318,7928,4770,-3158
1983,0.0,0.0,0.0,318,7932,4770,-3162
1984,0.0,0.0,0.0,318,7936,4770,-3166
1985,1.0,1.0,1.0,319,7940,4785,-3155
1986,0.0,0.0,0.0,319,7944,4785,-3159
1987,0.0,0.0,0.0,319,7948,4785,-3163
1988,1.0,1.0,1.0,320,7952,4800,-3152
1989,0.0,0.0,0.3333333333333333,320,7956,4800,-3156
1990,0.0,0.0,0.0,320,7960,4800,-3160
1991,0.0,0.0,0.0,320,7964,4800,-3164
1992,0.0,0.0,0.0,320,7968,4800,-3168
1993,0.0,0.0,0.0,320,7972,4800,-3172
1994,0.0,1.0,0.6666666666666666,320,7976,4800,-3176
1995,0.0,0.0,0.0,320,7980,4800,-3180
1996,0.0,0.0,0.0,320,7984,4800,-3184
1997,1.0,1.0,1.0,321,7988,4815,-3173
1998,0.0,0.0,0.4,321,7992,4815,-3177
1999,0.0,0.0,0.0,321,7996,4815,-3181
2000,0.0,0.0,0.0,321,8000,4815,-3185
2001,0.0,0.0,0.0,321,8004,4815,-3189
2002,0.0,0.0,0.0,321,8008,4815,-3193
2003,0.0,0.0,0.0,321,8012,4815,-3197
2004,0.0,0.0,0.0,321,8016,4815,-3201
2005,0.0,0.0,0.0,321,8020,4815,-3205
2006,0.0,0.0,0.0,321,8024,4815,-3209
2007,1.0,1.0,1.0,322,8028,4830,-3198
2008,1.0,1.0,1.0,323,8032,4845,-3187
2009,0.0,0.0,0.0,323,8036,4845,-3191
2010,0.0,0.0,0.0,323,8040,4845,-3195
2011,0.0,0.0,0.0,323,8044,4845,-3199
2012,1.0,1.0,1.0,324,8048,4860,-3188
2013,0.0,0.0,0.0,324,8052,4860,-3192
2014,0.0,0.0,0.0,324,8056,4860,-3196
2015,0.0,0.0,0.0,324,8060,4860,-3200
2016,0.0,0.0,0.0,324,8064,4860,-3204
2017,0.0,0.0,0.0,324,8068,4860,-3208
2018,1.0,1.0,1.0,325,8072,4875,-3197
2019,0.0,0.0,0.0,325,8076,4875,-3201
2020,0.0,0.0,0.0,325,8080,4875,-3205
2021,0.0,0.0,0.0,325,8084,4875,-3209
2022,0.0,0.0,0.0,325,8088,4875,-3213
2023,0.0,0.0,0.0,325,8092,4875,-3217
2024,0.0,0.0,0.0,325,8096,4875,-3221
2025,0.0,0.0,0.0,325,8100,4875,-3225
2026,1.0,1.0,1.0,326,8104,4890,-3214
2027,0.0,0.0,0.0,326,8108,4890,-3218
2028,0.0,0.0,0.0,326,8112,4890,-3222
2029,0.0,0.0,0.0,326,8116,4890,-3226
2030,1.0,1.0,0.6666666666666666,327,8120,4905,-3215
2031,0.0,0.0,0.0,327,8124,4905,-3219
2032,0.0,0.0,0.0,327,8128,4905,-3223
2033,1.0,1.0,1.0,328,8132,4920,-3212
2034,0.0,0.0,0.0,328,8136,4920,-3216
2035,1.0,1.0,1.0,329,8140,4935,-3205
2036,0.0,0.0,0.0,329,8144,4935,-3209
2037,0.0,0.0,0.4,329,8148,4935,-3213
2038,0.0,0.0,0.0,329,8152,4935,-3217
2039,0.0,0.0,0.0,329,8156,4935,-3221
2040,0.0,0.0,0.0,329,8160,4935,-3225
2041,0.0,0.0,0.0,329,8164,4935,-3229
2042,0.0,0.0,0.0,329,8168,4935,-3233
2043,0.0,0.0,0.0,329,8172,4935,-3237
2044,0.0,0.0,0.0,329,8176,4935,-3241
2045,0.0,0.0,0.0,329,8180,4935,-3245
2046,0.0,0.0,0.0,329,8184,4935,-3249
2047,0.0,0.0,0.0,329,8188,4935,-3253
2048,0.0,0.0,0.0,329,8192,4935,-3257
2049,0.0,0.0,0.0,329,8196,4935,-3261
2050,0.0,0.0,0.0,329,8200,4935,-3265
2051,0.0,0.0,0.0,329,8204,4935,-3269
2052,1.0,1.0,1.0,330,8208,4950,-3258
2053,0.0,0.0,0.0,330,8212,4950,-3262
2054,0.0,0.0,0.0,330,8216,4950,-3266
2055,0.0,1.0,0.6666666666666666,330,8220,4950,-3270
2056,0.0,0.0,0.0,330,8224,4950,-3274
2057,0.0,0.0,0.0,330,8228,4950,-3278
2058,1.0,1.0,1.0,331,8232,4965,-3267
2059,0.0,0.0,0.0,331,8236,4965,-3271
2060,0.0,0.0,0.0,331,8240,4965,-3275
2061,0.0,0.0,0.0,331,8244,4965,-3279
2062,0.0,0.0,0.0,331,8248,4965,-3283
2063,0.0,0.0,0.0,331,8252,4965,-3287
2064,0.0,0.0,0.0,331,8256,4965,-3291
2065,0.0,0.0,0.0,331,8260,4965,-3295
2066,0.0,0.0,0.0,331,8264,4965,-3299
2067,0.0,0.0,0.0,331,8268,4965,-3303
2068,1.0,1.0,1.0,332,8272,4980,-3292
2069,0.0,0.0,0.5,332,8276,4980,-3296
2070,0.0,0.0,0.0,332,8280,4980,-3300
2071,0.0,0.0,0.0,332,8284,4980,-3304
2072,0.0,0.0,0.0,332,8288,4980,-3308
2073,1.0,0.0,0.4,333,8292,4995,-3297
2074,1.0,1.0,0.6666666666666666,334,8296,5010,-3286
2075,0.0,0.0,0.0,334,8300,5010,-3290
2076,0.0,0.0,0.0,334,8304,5010,-3294
2077,0.0,0.0,0.0,334,8308,5010,-3298
2078,0.0,0.0,0.0,334,8312,5010,-3302
2079,0.0,0.0,0.0,334,8316,5010,-3306
2080,0.0,0.0,0.0,334,8320,5010,-3310
2081,0.0,0.0,0.0,334,8324,5010,-3314
2082,0.0,0.0,0.0,334,8328,5010,-3318
2083,1.0,1.0,1.0,335,8332,5025,-3307
2084,0.0,0.0,0.0,335,8336,5025,-3311
2085,0.0,0.0,0.0,335,8340,5025,-3315
2086,0.0,0.0,0.0,335,8344,5025,-3319
2087,0.0,0.0,0.0,335,8348,5025,-3323
2088,0.0,0.0,0.0,335,8352,5025,-3327
2089,0.0,0.0,0.0,335,8356,5025,-3331
2090,0.0,0.0,0.0,335,8360,5025,-3335
2091,1.0,1.0,1.0,336,8364,5040,-3324
2092,0.0,0.0,0.0,336,8368,5040,-3328
2093,0.0,0.0,0.0,336,8372,5040,-3332
2094,0.0,0.0,0.0,336,8376,5040,-3336
2095,1.0,1.0,0.8,337,8380,5055,-3325
2096,0.0,0.0,0.0,337,8384,5055,-3329
2097,0.0,0.0,0.0,337,8388,5055,-3333
2098,0.0,0.0,0.0,337,8392,5055,-3337
2099,0.0,0.0,0.0,337,8396,5055,-3341
2100,0.0,0.0,0.0,337,8400,5055,-3345
2101,0.0,0.0,0.0,337,8404,5055,-3349
2102,0.0,0.0,0.0,337,8408,5055,-3353
2103,0.0,0.0,0.0,337,8412,5055,-3357
2104,0.0,0.0,0.0,337,8416,5055,-3361
2105,0.0,0.0,0.0,337,8420,5055,-3365
2106,0.0,0.0,0.0,337,8424,5055,-3369
2107,0.0,0.0,0.0,337,8428,5055,-3373
2108,1.0,1.0,1.0,338,8432,5070,-3362
2109,0.0,0.0,0.0,338,8436,5070,-3366
2110,0.0,0.0,0.0,338,8440,5070,-3370
2111,0.0,0.0,0.0,338,8444,5070,-3374
2112,0.0,0.0,0.0,338,8448,5070,-3378
2113,0.0,0.0,0.0,338,8452,5070,-3382
2114,0.0,0.0,0.0,338,8456,5070,-3386
2115,0.0,0.0,0.0,338,8460,5070,-3390
2116,1.0,0.0,0.3333333333333333,339,8464,5085,-3379
2117,0.0,0.0,0.0,339,8468,5085,-3383
2118,0.0,0.0,0.0,339,8472,5085,-3387
2119,0.0,0.0,0.0,339,8476,5085,-3391
2120,0.0,0.0,0.0,339,8480,5085,-3395
2121,0.0,0.0,0.0,339,8484,5085,-3399
2122,0.0,0.0,0.0,339,8488,5085,-3403
2123,0.0,0.0,0.0,339,8492,5085,-3407
2124,0.0,0.0,0.0,339,8496,5085,-3411
2125,0.0,0.0,0.0,339,8500,5085,-3415
2126,0.0,0.0,0.0,339,8504,5085,-3419
2127,0.0,0.0,0.0,339,8508,5085,-3423
2128,0.0,0.0,0.0,339,8512,5085,-3427
2129,0.0,0.0,0.0,339,8516,5085,-3431
2130,1.0,1.0,1.0,340,8520,5100,-3420
2131,0.0,0.0,0.0,340,8524,5100,-3424
2132,0.0,0.0,0.0,340,8528,5100,-3428
2133,0.0,0.0,0.0,340,8532,5100,-3432
2134,0.0,0.0,0.0,340,8536,5100,-3436
2135,0.0,0.0,0.0,340,8540,5100,-3440
2136,0.0,0.0,0.0,340,8544,5100,-3444
2137,0.0,0.0,0.0,340,8548,5100,-3448
2138,1.0,1.0,1.0,341,8552,5115,-3437
2139,0.0,0.0,0.0,341,8556,5115,-3441
2140,0.0,0.0,0.0,341,8560,5115,-3445
2141,0.0,0.0,0.0,341,8564,5115,-3449
2142,0.0,0.0,0.0,341,8568,5115,-3453
2143,0.0,0.0,0.0,341,8572,5115,-3457
2144,0.0,0.0,0.0,341,8576,5115,-3461
2145,0.0,0.0,0.0,341,8580,5115,-3465
2146,0.0,0.0,0.0,341,8584,5115,-3469
2147,1.0,1.0,1.0,342,8588,5130,-3458
2148,0.0,0.0,0.0,342,8592,5130,-3462
2149,0.0,0.0,0.0,342,8596,5130,-3466
2150,0.0,0.0,0.0,342,8600,5130,-3470
2151,0.0,0.0,0.0,342,8604,5130,-3474
2152,0.0,0.0,0.0,342,8608,5130,-3478
2153,1.0,1.0,1.0,343,8612,5145,-3467
2154,0.0,0.0,0.0,343,8616,5145,-3471
2155,0.0,0.0,0.0,343,8620,5145,-3475
2156,0.0,0.0,0.0,343,8624,5145,-3479
2157,0.0,0.0,0.0,343,8628,5145,-3483
2158,1.0,1.0,1.0,344,8632,5160,-3472
2159,0.0,0.0,0.0,344,8636,5160,-3476
2160,1.0,1.0,1.0,345,8640,5175,-3465
2161,0.0,0.0,0.0,345,8644,5175,-3469
2162,0.0,0.0,0.0,345,8648,5175,-3473
2163,0.0,0.0,0.0,345,8652,5175,-3477
2164,0.0,0.0,0.0,345,8656,5175,-3481
2165,0.0,0.0,0.0,345,8660,5175,-3485
2166,1.0,1.0,1.0,346,8664,5190,-3474
2167,1.0,1.0,1.0,347,8668,5205,-3463
2168,0.0,0.0,0.0,347,8672,5205,-3467
2169,0.0,0.0,0.0,347,8676,5205,-3471
2170,0.0,0.0,0.0,347,8680,5205,-3475
2171,1.0,1.0,1.0,348,8684,5220,-3464
2172,0.0,0.0,0.0,348,8688,5220,-3468
2173,0.0,0.0,0.0,348,8692,5220,-3472
2174,0.0,0.0,0.0,348,8696,5220,-3476
2175,1.0,1.0,1.0,349,8700,5235,-3465
2176,0.0,0.0,0.3333333333333333,349,8704,5235,-3469
2177,0.0,0.0,0.0,349,8708,5235,-3473
2178,0.0,0.0,0.3333333333333333,349,8712,5235,-3477
2179,1.0,1.0,0.8,350,8716,5250,-3466
2180,0.0,0.0,0.0,350,8720,5250,-3470
2181,0.0,0.0,0.5,350,8724,5250,-3474
2182,1.0,1.0,1.0,351,8728,5265,-3463
2183,0.0,0.0,0.0,351,8732,5265,-3467
2184,0.0,0.0,0.0,351,8736,5265,-3471
2185,1.0,1.0,1.0,352,8740,5280,-3460
2186,0.0,0.0,0.0,352,8744,5280,-3464
2187,0.0,0.0,0.0,352,8748,5280,-3468
2188,0.0,0.0,0.0,352,8752,5280,-3472
2189,0.0,0.0,0.0,352,8756,5280,-3476
2190,0.0,0.0,0.0,352,8760,5280,-3480
2191,0.0,0.0,0.0,352,8764,5280,-3484
2192,0.0,0.0,0.0,352,8768,5280,-3488
2193,0.0,0.0,0.0,352,8772,5280,-3492
2194,0.0,0.0,0.0,352,8776,5280,-3496
2195,0.0,0.0,0.0,352,8780,5280,-3500
2196,0.0,0.0,0.0,352,8784,5280,-3504
2197,0.0,0.0,0.0,352,8788,5280,-3508
2198,0.0,0.0,0.0,352,8792,5280,-3512
2199,0.0,0.0,0.0,352,8796,5280,-3516
2200,1.0,1.0,1.0,353,8800,5295,-3505
2201,0.0,0.0,0.0,353,8804,5295,-3509
2202,0.0,0.0,0.0,353,8808,5295,-3513
2203,0.0,0.0,0.0,353,8812,5295,-3517
2204,1.0,1.0,1.0,354,8816,5310,-3506
2205,0.0,0.0,0.0,354,8820,5310,-3510
2206,0.0,0.0,0.0,354,8824,5310,-3514
2207,0.0,0.0,0.0,354,8828,5310,-3518
2208,0.0,0.0,0.0,354,8832,5310,-3522
2209,1.0,1.0,1.0,355,8836,5325,-3511
2210,1.0,1.0,1.0,356,8840,5340,-3500
2211,0.0,0.0,0.0,356,8844,5340,-3504
2212,0.0,1.0,0.8,356,8848,5340,-3508
2213,0.0,0.0,0.0,356,8852,5340,-3512
2214,0.0,0.0,0.0,356,8856,5340,-3516
2215,1.0,1.0,1.0,357,8860,5355,-3505
2216,0.0,0.0,0.2,357,8864,5355,-3509
2217,0.0,0.0,0.0,357,8868,5355,-3513
2218,1.0,1.0,1.0,358,8872,5370,-3502
2219,0.0,0.0,0.4,358,8876,5370,-3506
2220,0.0,0.0,0.0,358,8880,5370,-3510
2221,0.0,0.0,0.0,358,8884,5370,-3514
2222,0.0,1.0,0.6,358,8888,5370,-3518
2223,0.0,0.0,0.0,358,8892,5370,-3522
2224,0.0,0.0,0.0,358,8896,5370,-3526
2225,0.0,0.0,0.0,358,8900,5370,-3530
2226,1.0,1.0,0.6666666666666666,359,8904,5385,-3519
2227,0.0,0.0,0.0,359,8908,5385,-3523
2228,0.0,0.0,0.0,359,8912,5385,-3527
2229,1.0,1.0,1.0,360,8916,5400,-3516
2230,0.0,0.0,0.0,360,8920,5400,-3520
2231,1.0,1.0,1.0,361,8924,5415,-3509
2232,1.0,1.0,0.75,362,8928,5430,-3498
2233,1.0,1.0,1.0,363,8932,5445,-3487
2234,0.0,0.0,0.0,363,8936,5445,-3491
2235,1.0,0.0,0.3333333333333333,364,8940,5460,-3480
2236,0.0,0.0,0.0,364,8944,5460,-3484
2237,1.0,1.0,1.0,365,8948,5475,-3473
2238,0.0,0.0,0.0,365,8952,5475,-3477
2239,0.0,0.0,0.0,365,8956,5475,-3481
2240,1.0,1.0,1.0,366,8960,5490,-3470
2241,0.0,0.0,0.0,366,8964,5490,-3474
2242,0.0,0.0,0.0,366,8968,5490,-3478
2243,0.0,0.0,0.0,366,8972,5490,-3482
2244,0.0,0.0,0.0,366,8976,5490,-3486
2245,1.0,1.0,1.0,367,8980,5505,-3475
2246,0.0,0.0,0.0,367,8984,5505,-3479
2247,1.0,1.0,1.0,368,8988,5520,-3468
2248,0.0,0.0,0.0,368,8992,5520,-3472
2249,1.0,1.0,1.0,369,8996,5535,-3461
2250,1.0,1.0,1.0,370,9000,5550,-3450
2251,0.0,0.0,0.4,370,9004,5550,-3454
2252,0.0,0.0,0.0,370,9008,5550,-3458
2253,0.0,0.0,0.0,370,9012,5550,-3462
2254,0.0,0.0,0.0,370,9016,5550,-3466
2255,1.0,1.0,1.0,371,9020,5565,-3455
2256,0.0,0.0,0.0,371,9024,5565,-3459
2257,0.0,0.0,0.0,371,9028,5565,-3463
2258,1.0,1.0,0.6666666666666666,372,9032,5580,-3452
2259,0.0,0.0,0.0,372,9036,5580,-3456
2260,0.0,0.0,0.0,372,9040,5580,-3460
2261,1.0,1.0,1.0,373,9044,5595,-3449
2262,0.0,0.0,0.0,373,9048,5595,-3453
2263,0.0,1.0,0.6666666666666666,373,9052,5595,-3457
2264,0.0,0.0,0.0,373,9056,5595,-3461
2265,0.0,0.0,0.0,373,9060,5595,-3465
2266,0.0,0.0,0.0,373,9064,5595,-3469
2267,0.0,0.0,0.0,373,9068,5595,-3473
2268,0.0,0.0,0.0,373,9072,5595,-3477
2269,1.0,1.0,1.0,374,9076,5610,-3466
2270,0.0,0.0,0.0,374,9080,5610,-3470
2271,0.0,0.0,0.0,374,9084,5610,-3474
2272,0.0,0.0,0.0,374,9088,5610,-3478
2273,0.0,0.0,0.0,374,9092,5610,-3482
2274,0.0,0.0,0.0,374,9096,5610,-3486
2275,1.0,0.0,0.4,375,9100,5625,-3475
2276,0.0,0.0,0.0,375,9104,5625,-3479
2277,1.0,1.0,1.0,376,9108,5640,-3468
2278,0.0,0.0,0.0,376,9112,5640,-3472
2279,0.0,0.0,0.0,376,9116,5640,-3476
2280,0.0,0.0,0.0,376,9120,5640,-3480
2281,1.0,1.0,0.6,377,9124,5655,-3469
2282,0.0,0.0,0.0,377,9128,5655,-3473
2283,0.0,0.0,0.0,377,9132,5655,-3477
2284,0.0,0.0,0.0,377,9136,5655,-3481
2285,0.0,0.0,0.0,377,9140,5655,-3485
2286,0.0,0.0,0.0,377,9144,5655,-3489
2287,0.0,0.0,0.0,377,9148,5655,-3493
2288,0.0,0.0,0.0,377,9152,5655,-3497
2289,0.0,0.0,0.0,377,9156,5655,-3501
2290,0.0,0.0,0.0,377,9160,5655,-3505
2291,0.0,0.0,0.0,377,9164,5655,-3509
2292,1.0,0.0,0.2,378,9168,5670,-3498
2293,0.0,1.0,0.6666666666666666,378,9172,5670,-3502
2294,0.0,0.0,0.0,378,9176,5670,-3506
2295,0.0,0.0,0.0,378,9180,5670,-3510
2296,0.0,0.0,0.0,378,9184,5670,-3514
2297,0.0,0.0,0.0,378,9188,5670,-3518
2298,0.0,0.0,0.0,378,9192,5670,-3522
2299,0.0,0.0,0.0,378,9196,5670,-3526
2300,0.0,0.0,0.0,378,9200,5670,-3530
2301,0.0,0.0,0.0,378,9204,5670,-3534
2302,0.0,0.0,0.0,378,9208,5670,-3538
2303,0.0,0.0,0.0,378,9212,5670,-3542
2304,0.0,0.0,0.0,378,9216,5670,-3546
2305,1.0,1.0,0.8,379,9220,5685,-3535
2306,0.0,0.0,0.0,379,9224,5685,-3539
2307,0.0,0.0,0.0,379,9228,5685,-3543
2308,0.0,0.0,0.0,379,9232,5685,-3547
2309,0.0,0.0,0.0,379,9236,5685,-3551
2310,0.0,0.0,0.0,379,9240,5685,-3555
2311,0.0,0.0,0.0,379,9244,5685,-3559
2312,0.0,0.0,0.0,379,9248,5685,-3563
2313,1.0,1.0,0.8,380,9252,5700,-3552
2314,0.0,0.0,0.0,380,9256,5700,-3556
2315,0.0,0.0,0.0,380,9260,5700,-3560
2316,0.0,0.0,0.0,380,9264,5700,-3564
2317,0.0,0.0,0.0,380,9268,5700,-3568
2318,0.0,0.0,0.0,380,9272,5700,-3572
2319,0.0,0.0,0.0,380,9276,5700,-3576
2320,0.0,0.0,0.0,380,9280,5700,-3580
2321,0.0,0.0,0.0,380,9284,5700,-3584
2322,0.0,0.0,0.0,380,9288,5700,-3588
2323,0.0,0.0,0.0,380,9292,5700,-3592
2324,0.0,0.0,0.0,380,9296,5700,-3596
2325,0.0,0.0,0.0,380,9300,5700,-3600
2326,0.0,0.0,0.0,380,9304,5700,-3604
2327,1.0,1.0,1.0,381,9308,5715,-3593
2328,0.0,0.0,0.0,381,9312,5715,-3597
2329,0.0,0.0,0.0,381,9316,5715,-3601
2330,0.0,0.0,0.0,381,9320,5715,-3605
2331,0.0,0.0,0.0,381,9324,5715,-3609
2332,1.0,1.0,1.0,382,9328,5730,-3598
2333,1.0,1.0,1.0,383,9332,5745,-3587
2334,1.0,1.0,1.0,384,9336,5760,-3576
2335,0.0,0.0,0.0,384,9340,5760,-3580
2336,1.0,1.0,0.75,385,9344,5775,-3569
2337,0.0,0.0,0.0,385,9348,5775,-3573
2338,1.0,1.0,1.0,386,9352,5790,-3562
2339,0.0,0.0,0.0,386,9356,5790,-3566
2340,0.0,0.0,0.0,386,9360,5790,-3570
2341,0.0,0.0,0.0,386,9364,5790,-3574
2342,0.0,0.0,0.0,386,9368,5790,-3578
2343,0.0,0.0,0.0,386,9372,5790,-3582
2344,0.0,0.0,0.0,386,9376,5790,-3586
2345,0.0,0.0,0.0,386,9380,5790,-3590
2346,0.0,0.0,0.0,386,9384,5790,-3594
2347,0.0,0.0,0.0,386,9388,5790,-3598
2348,0.0,0.0,0.0,386,9392,5790,-3602
2349,0.0,0.0,0.0,386,9396,5790,-3606
2350,0.0,0.0,0.0,386,9400,5790,-3610
2351,0.0,0.0,0.0,386,9404,5790,-3614
2352,0.0,0.0,0.0,386,9408,5790,-3618
2353,0.0,0.0,0.0,386,9412,5790,-3622
2354,1.0,0.0,0.4,387,9416,5805,-3611
2355,1.0,1.0,1.0,388,9420,5820,-3600
2356,0.0,0.0,0.0,388,9424,5820,-3604
2357,0.0,0.0,0.0,388,9428,5820,-3608
2358,0.0,0.0,0.0,388,9432,5820,-3612
2359,1.0,1.0,1.0,389,9436,5835,-3601
2360,0.0,0.0,0.0,389,9440,5835,-3605
2361,0.0,0.0,0.0,389,9444,5835,-3609
2362,0.0,1.0,0.75,389,9448,5835,-3613
2363,0.0,0.0,0.0,389,9452,5835,-3617
2364,0.0,0.0,0.0,389,9456,5835,-3621
2365,0.0,0.0,0.0,389,9460,5835,-3625
2366,0.0,0.0,0.0,389,9464,5835,-3629
2367,0.0,0.0,0.0,389,9468,5835,-3633
2368,0.0,0.0,0.0,389,9472,5835,-3637
2369,0.0,0.0,0.0,389,9476,5835,-3641
2370,0.0,0.0,0.0,389,9480,5835,-3645
2371,0.0,0.0,0.0,389,9484,5835,-3649
2372,0.0,0.0,0.0,389,9488,5835,-3653
2373,0.0,0.0,0.0,389,9492,5835,-3657
2374,0.0,0.0,0.0,389,9496,5835,-3661
2375,0.0,0.0,0.0,389,9500,5835,-3665
2376,1.0,1.0,1.0,390,9504,5850,-3654
2377,0.0,0.0,0.0,390,9508,5850,-3658
2378,0.0,0.0,0.0,390,9512,5850,-3662
2379,0.0,0.0,0.0,390,9516,5850,-3666
2380,0.0,0.0,0.0,390,9520,5850,-3670
2381,0.0,0.0,0.0,390,9524,5850,-3674
2382,0.0,0.0,0.0,390,9528,5850,-3678
2383,0.0,0.0,0.0,390,9532,5850,-3682
2384,0.0,0.0,0.0,390,9536,5850,-3686
2385,0.0,0.0,0.0,390,9540,5850,-3690
2386,0.0,0.0,0.0,390,9544,5850,-3694
2387,0.0,0.0,0.0,390,9548,5850,-3698
2388,0.0,0.0,0.0,390,9552,5850,-3702
2389,0.0,0.0,0.0,390,9556,5850,-3706
2390,0.0,0.0,0.0,390,9560,5850,-3710
2391,0.0,0.0,0.0,390,9564,5850,-3714
2392,1.0,1.0,1.0,391,9568,5865,-3703
2393,1.0,1.0,1.0,392,9572,5880,-3692
2394,0.0,0.0,0.0,392,9576,5880,-3696
2395,0.0,0.0,0.0,392,9580,5880,-3700
2396,0.0,0.0,0.0,392,9584,5880,-3704
2397,0.0,0.0,0.0,392,9588,5880,-3708
2398,0.0,0.0,0.0,392,9592,5880,-3712
2399,0.0,0.0,0.0,392,9596,5880,-3716
2400,0.0,0.0,0.0,392,9600,5880,-3720
2401,0.0,0.0,0.0,392,9604,5880,-3724
2402,0.0,0.0,0.0,392,9608,5880,-3728
2403,0.0,0.0,0.0,392,9612,5880,-3732
2404,0.0,0.0,0.0,392,9616,5880,-3736
2405,0.0,0.0,0.0,392,9620,5880,-3740
2406,1.0,1.0,1.0,393,9624,5895,-3729
2407,0.0,0.0,0.0,393,9628,5895,-3733
2408,0.0,0.0,0.0,393,9632,5895,-3737
2409,0.0,0.0,0.0,393,9636,5895,-3741
2410,0.0,0.0,0.0,393,9640,5895,-3745
2411,0.0,0.0,0.0,393,9644,5895,-3749
2412,1.0,1.0,0.6666666666666666,394,9648,5910,-3738
2413,0.0,0.0,0.0,394,9652,5910,-3742
2414,0.0,0.0,0.0,394,9656,5910,-3746
2415,0.0,0.0,0.0,394,9660,5910,-3750
2416,0.0,0.0,0.0,394,9664,5910,-3754
2417,0.0,0.0,0.2,394,9668,5910,-3758
2418,1.0,0.0,0.4,395,9672,5925,-3747
2419,0.0,0.0,0.0,395,9676,5925,-3751
2420,0.0,0.0,0.0,395,9680,5925,-3755
2421,1.0,1.0,1.0,396,9684,5940,-3744
2422,0.0,0.0,0.0,396,9688,5940,-3748
2423,0.0,0.0,0.0,396,9692,5940,-3752
2424,0.0,0.0,0.0,396,9696,5940,-3756
2425,0.0,0.0,0.0,396,9700,5940,-3760
2426,0.0,0.0,0.0,396,9704,5940,-3764
2427,1.0,1.0,1.0,397,9708,5955,-3753
2428,0.0,0.0,0.0,397,9712,5955,-3757
2429,0.0,0.0,0.0,397,9716,5955,-3761
2430,0.0,0.0,0.0,397,9720,5955,-3765
2431,0.0,0.0,0.0,397,9724,5955,-3769
2432,0.0,0.0,0.0,397,9728,5955,-3773
2433,1.0,1.0,1.0,398,9732,5970,-3762
2434,0.0,0.0,0.0,398,9736,5970,-3766
2435,0.0,0.0,0.0,398,9740,5970,-3770
2436,0.0,0.0,0.0,398,9744,5970,-3774
2437,0.0,0.0,0.0,398,9748,5970,-3778
2438,0.0,0.0,0.0,398,9752,5970,-3782
2439,0.0,0.0,0.0,398,9756,5970,-3786
2440,0.0,0.0,0.0,398,9760,5970,-3790
2441,1.0,1.0,1.0,399,9764,5985,-3779
2442,0.0,0.0,0.0,399,9768,5985,-3783
2443,0.0,0.0,0.0,399,9772,5985,-3787
2444,1.0,1.0,1.0,400,9776,6000,-3776
2445,0.0,0.0,0.0,400,9780,6000,-3780
2446,0.0,0.0,0.0,400,9784,6000,-3784
2447,0.0,0.0,0.0,400,9788,6000,-3788
2448,0.0,0.0,0.0,400,9792,6000,-3792
2449,1.0,1.0,0.6666666666666666,401,9796,6015,-3781
2450,0.0,0.0,0.0,401,9800,6015,-3785
2451,0.0,0.0,0.3333333333333333,401,9804,6015,-3789
2452,0.0,0.0,0.0,401,9808,6015,-3793
2453,0.0,0.0,0.25,401,9812,6015,-3797
2454,0.0,0.0,0.0,401,9816,6015,-3801
2455,0.0,0.0,0.0,401,9820,6015,-3805
2456,0.0,0.0,0.0,401,9824,6015,-3809
2457,0.0,0.0,0.0,401,9828,6015,-3813
2458,0.0,0.0,0.0,401,9832,6015,-3817
2459,0.0,0.0,0.0,401,9836,6015,-3821
2460,0.0,0.0,0.0,401,9840,6015,-3825
2461,1.0,1.0,1.0,402,9844,6030,-3814
2462,0.0,0.0,0.0,402,9848,6030,-3818
2463,0.0,0.0,0.0,402,9852,6030,-3822
2464,0.0,0.0,0.0,402,9856,6030,-3826
2465,0.0,0.0,0.0,402,9860,6030,-3830
2466,0.0,0.0,0.0,402,9864,6030,-3834
2467,0.0,0.0,0.0,402,9868,6030,-3838
2468,0.0,0.0,0.0,402,9872,6030,-3842
2469,0.0,0.0,0.0,402,9876,6030,-3846
2470,0.0,0.0,0.0,402,9880,6030,-3850
2471,0.0,0.0,0.0,402,9884,6030,-3854
2472,0.0,0.0,0.0,402,9888,6030,-3858
2473,0.0,0.0,0.0,402,9892,6030,-3862
2474,0.0,0.0,0.0,402,9896,6030,-3866
2475,0.0,0.0,0.0,402,9900,6030,-3870
2476,0.0,0.0,0.0,402,9904,6030,-3874
2477,0.0,0.0,0.0,402,9908,6030,-3878
2478,1.0,1.0,1.0,403,9912,6045,-3867
2479,0.0,0.0,0.0,403,9916,6045,-3871
2480,0.0,0.0,0.0,403,9920,6045,-3875
2481,0.0,0.0,0.0,403,9924,6045,-3879
2482,0.0,0.0,0.0,403,9928,6045,-3883
2483,0.0,0.0,0.0,403,9932,6045,-3887
2484,0.0,0.0,0.0,403,9936,6045,-3891
2485,1.0,1.0,0.6,404,9940,6060,-3880
2486,0.0,0.0,0.0,404,9944,6060,-3884
2487,1.0,1.0,1.0,405,9948,6075,-3873
2488,0.0,0.0,0.0,405,9952,6075,-3877
2489,1.0,1.0,1.0,406,9956,6090,-3866
2490,0.0,0.0,0.0,406,9960,6090,-3870
2491,0.0,0.0,0.0,406,9964,6090,-3874
2492,0.0,0.0,0.0,406,9968,6090,-3878
2493,0.0,0.0,0.0,406,9972,6090,-3882
2494,1.0,1.0,1.0,407,9976,6105,-3871
2495,0.0,0.0,0.0,407,9980,6105,-3875
2496,0.0,0.0,0.0,407,9984,6105,-3879
2497,1.0,1.0,1.0,408,9988,6120,-3868
2498,0.0,0.0,0.0,408,9992,6120,-3872
2499,0.0,0.0,0.0,408,9996,6120,-3876
2500,0.0,0.0,0.0,408,10000,6120,-3880
2501,0.0,0.0,0.0,408,10004,6120,-3884
2502,1.0,1.0,0.6666666666666666,409,10008,6135,-3873
2503,0.0,0.0,0.0,409,10012,6135,-3877
2504,0.0,0.0,0.0,409,10016,6135,-3881
2505,0.0,0.0,0.0,409,10020,6135,-3885
2506,0.0,0.0,0.25,409,10024,6135,-3889
2507,0.0,0.0,0.0,409,10028,6135,-3893
2508,0.0,0.0,0.0,409,10032,6135,-3897
2509,0.0,0.0,0.0,409,10036,6135,-3901
2510,0.0,0.0,0.0,409,10040,6135,-3905
2511,1.0,0.0,0.3333333333333333,410,10044,6150,-3894
2512,0.0,0.0,0.0,410,10048,6150,-3898
2513,1.0,1.0,1.0,411,10052,6165,-3887
2514,0.0,0.0,0.0,411,10056,6165,-3891
2515,0.0,0.0,0.0,411,10060,6165,-3895
2516,1.0,1.0,1.0,412,10064,6180,-3884
2517,1.0,1.0,0.6666666666666666,413,10068,6195,-3873
2518,0.0,0.0,0.0,413,10072,6195,-3877
2519,0.0,0.0,0.0,413,10076,6195,-3881
2520,1.0,1.0,1.0,414,10080,6210,-3870
2521,0.0,0.0,0.0,414,10084,6210,-3874
2522,0.0,0.0,0.0,414,10088,6210,-3878
2523,1.0,1.0,1.0,415,10092,6225,-3867
2524,0.0,0.0,0.0,415,10096,6225,-3871
2525,0.0,0.0,0.3333333333333333,415,10100,6225,-3875
2526,0.0,0.0,0.0,415,10104,6225,-3879
2527,0.0,0.0,0.0,415,10108,6225,-3883
2528,0.0,0.0,0.2,415,10112,6225,-3887
2529,1.0,1.0,1.0,416,10116,6240,-3876
2530,1.0,1.0,1.0,417,10120,6255,-3865
2531,1.0,1.0,1.0,418,10124,6270,-3854
2532,0.0,0.0,0.0,418,10128,6270,-3858
2533,0.0,0.0,0.0,418,10132,6270,-3862
2534,0.0,0.0,0.0,418,10136,6270,-3866
2535,0.0,0.0,0.0,418,10140,6270,-3870
2536,0.0,0.0,0.0,418,10144,6270,-3874
2537,1.0,0.0,0.3333333333333333,419,10148,6285,-3863
2538,0.0,0.0,0.0,419,10152,6285,-3867
2539,0.0,0.0,0.0,419,10156,6285,-3871
2540,0.0,0.0,0.0,419,10160,6285,-3875
2541,0.0,0.0,0.0,419,10164,6285,-3879
2542,0.0,0.0,0.0,419,10168,6285,-3883
2543,1.0,1.0,1.0,420,10172,6300,-3872
2544,1.0,1.0,1.0,421,10176,6315,-3861
2545,0.0,0.0,0.0,421,10180,6315,-3865
2546,1.0,1.0,1.0,422,10184,6330,-3854
2547,1.0,0.0,0.4,423,10188,6345,-3843
2548,0.0,0.0,0.0,423,10192,6345,-3847
2549,0.0,0.0,0.0,423,10196,6345,-3851
2550,0.0,0.0,0.0,423,10200,6345,-3855
2551,0.0,0.0,0.0,423,10204,6345,-3859
2552,1.0,1.0,1.0,424,10208,6360,-3848
2553,0.0,0.0,0.0,424,10212,6360,-3852
2554,0.0,0.0,0.0,424,10216,6360,-3856
2555,0.0,0.0,0.0,424,10220,6360,-3860
2556,0.0,0.0,0.0,424,10224,6360,-3864
2557,0.0,0.0,0.0,424,10228,6360,-3868
2558,0.0,0.0,0.0,424,10232,6360,-3872
2559,0.0,0.0,0.0,424,10236,6360,-3876
2560,0.0,0.0,0.0,424,10240,6360,-3880
2561,0.0,0.0,0.0,424,10244,6360,-3884
2562,0.0,0.0,0.0,424,10248,6360,-3888
2563,0.0,0.0,0.0,424,10252,6360,-3892
2564,0.0,0.0,0.0,424,10256,6360,-3896
2565,1.0,1.0,1.0,425,10260,6375,-3885
2566,0.0,0.0,0.0,425,10264,6375,-3889
2567,0.0,0.0,0.0,425,10268,6375,-3893
2568,0.0,0.0,0.0,425,10272,6375,-3897
2569,0.0,0.0,0.0,425,10276,6375,-3901
2570,0.0,0.0,0.0,425,10280,6375,-3905
2571,0.0,0.0,0.0,425,10284,6375,-3909
2572,0.0,0.0,0.0,425,10288,6375,-3913
2573,0.0,0.0,0.0,425,10292,6375,-3917
2574,0.0,0.0,0.3333333333333333,425,10296,6375,-3921
2575,1.0,1.0,1.0,426,10300,6390,-3910
2576,0.0,0.0,0.0,426,10304,6390,-3914
2577,1.0,1.0,1.0,427,10308,6405,-3903
2578,0.0,0.0,0.0,427,10312,6405,-3907
2579,0.0,0.0,0.0,427,10316,6405,-3911
2580,0.0,1.0,0.6666666666666666,427,10320,6405,-3915
2581,0.0,0.0,0.0,427,10324,6405,-3919
2582,0.0,0.0,0.0,427,10328,6405,-3923
2583,0.0,0.0,0.0,427,10332,6405,-3927
2584,0.0,0.0,0.3333333333333333,427,10336,6405,-3931
2585,1.0,1.0,1.0,428,10340,6420,-3920
2586,0.0,0.0,0.0,428,10344,6420,-3924
2587,1.0,1.0,1.0,429,10348,6435,-3913
2588,0.0,0.0,0.0,429,10352,6435,-3917
2589,0.0,0.0,0.0,429,10356,6435,-3921
2590,0.0,0.0,0.0,429,10360,6435,-3925
2591,0.0,0.0,0.0,429,10364,6435,-3929
2592,1.0,1.0,1.0,430,10368,6450,-3918
2593,0.0,0.0,0.0,430,10372,6450,-3922
2594,0.0,0.0,0.0,430,10376,6450,-3926
2595,0.0,0.0,0.0,430,10380,6450,-3930
2596,0.0,0.0,0.0,430,10384,6450,-3934
2597,0.0,0.0,0.0,430,10388,6450,-3938
2598,0.0,0.0,0.0,430,10392,6450,-3942
2599,0.0,0.0,0.0,430,10396,6450,-3946
2600,0.0,0.0,0.0,430,10400,6450,-3950
2601,0.0,0.0,0.0,430,10404,6450,-3954
2602,0.0,0.0,0.0,430,10408,6450,-3958
2603,0.0,0.0,0.0,430,10412,6450,-3962
2604,0.0,0.0,0.0,430,10416,6450,-3966
2605,0.0,0.0,0.0,430,10420,6450,-3970
2606,0.0,0.0,0.0,430,10424,6450,-3974
2607,0.0,0.0,0.0,430,10428,6450,-3978
2608,0.0,0.0,0.0,430,10432,6450,-3982
2609,0.0,0.0,0.0,430,10436,6450,-3986
2610,0.0,0.0,0.0,430,10440,6450,-3990
2611,1.0,0.0,0.3333333333333333,431,10444,6465,-3979
2612,0.0,0.0,0.0,431,10448,6465,-3983
2613,1.0,1.0,0.8,432,10452,6480,-3972
2614,0.0,0.0,0.0,432,10456,6480,-3976
2615,0.0,0.0,0.0,432,10460,6480,-3980
2616,0.0,0.0,0.0,432,10464,6480,-3984
2617,0.0,0.0,0.0,432,10468,6480,-3988
2618,0.0,0.0,0.0,432,10472,6480,-3992
2619,0.0,0.0,0.0,432,10476,6480,-3996
2620,0.0,0.0,0.0,432,10480,6480,-4000
2621,0.0,0.0,0.0,432,10484,6480,-4004
2622,1.0,1.0,1.0,433,10488,6495,-3993
2623,0.0,0.0,0.0,433,10492,6495,-3997
2624,0.0,0.0,0.0,433,10496,6495,-4001
2625,0.0,0.0,0.0,433,10500,6495,-4005
2626,0.0,0.0,0.0,433,10504,6495,-4009
2627,0.0,0.0,0.0,433,10508,6495,-4013
2628,0.0,0.0,0.0,433,10512,6495,-4017
2629,1.0,0.0,0.3333333333333333,434,10516,6510,-4006
2630,0.0,0.0,0.3333333333333333,434,10520,6510,-4010
2631,0.0,0.0,0.0,434,10524,6510,-4014
2632,0.0,0.0,0.0,434,10528,6510,-4018
2633,0.0,0.0,0.0,434,10532,6510,-4022
2634,0.0,0.0,0.0,434,10536,6510,-4026
2635,0.0,0.0,0.0,434,10540,6510,-4030
2636,0.0,0.0,0.0,434,10544,6510,-4034
2637,0.0,0.0,0.0,434,10548,6510,-4038
2638,0.0,0.0,0.0,434,10552,6510,-4042
2639,0.0,0.0,0.0,434,10556,6510,-4046
2640,1.0,1.0,1.0,435,10560,6525,-4035
2641,0.0,0.0,0.0,435,10564,6525,-4039
2642,0.0,0.0,0.0,435,10568,6525,-4043
2643,0.0,0.0,0.0,435,10572,6525,-4047
2644,1.0,1.0,1.0,436,10576,6540,-4036
2645,0.0,0.0,0.0,436,10580,6540,-4040
2646,0.0,0.0,0.0,436,10584,6540,-4044
2647,0.0,0.0,0.0,436,10588,6540,-4048
2648,1.0,1.0,1.0,437,10592,6555,-4037
2649,0.0,0.0,0.0,437,10596,6555,-4041
2650,0.0,0.0,0.0,437,10600,6555,-4045
2651,0.0,0.0,0.0,437,10604,6555,-4049
2652,0.0,0.0,0.0,437,10608,6555,-4053
2653,0.0,0.0,0.0,437,10612,6555,-4057
2654,0.0,0.0,0.0,437,10616,6555,-4061
2655,0.0,0.0,0.0,437,10620,6555,-4065
2656,1.0,1.0,1.0,438,10624,6570,-4054
2657,1.0,1.0,1.0,439,10628,6585,-4043
2658,1.0,1.0,1.0,440,10632,6600,-4032
2659,0.0,0.0,0.4,440,10636,6600,-4036
2660,0.0,0.0,0.0,440,10640,6600,-4040
2661,0.0,0.0,0.0,440,10644,6600,-4044
2662,0.0,0.0,0.0,440,10648,6600,-4048
2663,0.0,0.0,0.0,440,10652,6600,-4052
2664,0.0,0.0,0.0,440,10656,6600,-4056
2665,0.0,0.0,0.0,440,10660,6600,-4060
2666,0.0,0.0,0.0,440,10664,6600,-4064
2667,1.0,1.0,1.0,441,10668,6615,-4053
2668,1.0,1.0,1.0,442,10672,6630,-4042
2669,0.0,0.0,0.0,442,10676,6630,-4046
2670,0.0,0.0,0.0,442,10680,6630,-4050
2671,0.0,0.0,0.0,442,10684,6630,-4054
2672,0.0,0.0,0.0,442,10688,6630,-4058
2673,0.0,0.0,0.0,442,10692,6630,-4062
2674,0.0,0.0,0.0,442,10696,6630,-4066
2675,0.0,1.0,0.75,442,10700,6630,-4070
2676,0.0,0.0,0.0,442,10704,6630,-4074
2677,0.0,0.0,0.0,442,10708,6630,-4078
2678,1.0,1.0,1.0,443,10712,6645,-4067
2679,1.0,1.0,1.0,444,10716,6660,-4056
2680,0.0,0.0,0.0,444,10720,6660,-4060
2681,0.0,0.0,0.0,444,10724,6660,-4064
2682,1.0,1.0,0.6666666666666666,445,10728,6675,-4053
2683,0.0,0.0,0.0,445,10732,6675,-4057
2684,1.0,1.0,1.0,446,10736,6690,-4046
2685,0.0,0.0,0.0,446,10740,6690,-4050
2686,1.0,1.0,1.0,447,10744,6705,-4039
2687,0.0,0.0,0.0,447,10748,6705,-4043
2688,0.0,0.0,0.0,447,10752,6705,-4047
2689,0.0,0.0,0.0,447,10756,6705,-4051
2690,0.0,0.0,0.0,447,10760,6705,-4055
2691,0.0,0.0,0.0,447,10764,6705,-4059
2692,0.0,0.0,0.0,447,10768,6705,-4063
2693,0.0,0.0,0.0,447,10772,6705,-4067
2694,0.0,0.0,0.0,447,10776,6705,-4071
2695,0.0,0.0,0.0,447,10780,6705,-4075
2696,0.0,0.0,0.0,447,10784,6705,-4079
2697,0.0,0.0,0.0,447,10788,6705,-4083
2698,0.0,0.0,0.0,447,10792,6705,-4087
2699,0.0,0.0,0.0,447,10796,6705,-4091
2700,0.0,0.0,0.0,447,10800,6705,-4095
2701,0.0,0.0,0.0,447,10804,6705,-4099
2702,0.0,0.0,0.0,447,10808,6705,-4103
2703,0.0,0.0,0.0,447,10812,6705,-4107
2704,0.0,0.0,0.0,447,10816,6705,-4111
2705,0.0,0.0,0.0,447,10820,6705,-4115
2706,0.0,0.0,0.0,447,10824,6705,-4119
2707,0.0,0.0,0.0,447,10828,6705,-4123
2708,0.0,0.0,0.0,447,10832,6705,-4127
2709,0.0,0.0,0.0,447,10836,6705,-4131
2710,0.0,0.0,0.0,447,10840,6705,-4135
2711,0.0,0.0,0.0,447,10844,6705,-4139
2712,1.0,0.0,0.3333333333333333,448,10848,6720,-4128
2713,0.0,0.0,0.0,448,10852,6720,-4132
2714,0.0,0.0,0.0,448,10856,6720,-4136
2715,0.0,0.0,0.5,448,10860,6720,-4140
2716,0.0,0.0,0.0,448,10864,6720,-4144
2717,0.0,0.0,0.0,448,10868,6720,-4148
2718,1.0,1.0,1.0,449,10872,6735,-4137
2719,0.0,0.0,0.0,449,10876,6735,-4141
2720,0.0,0.0,0.0,449,10880,6735,-4145
2721,1.0,1.0,0.6,450,10884,6750,-4134
2722,0.0,0.0,0.0,450,10888,6750,-4138
2723,0.0,0.0,0.0,450,10892,6750,-4142
2724,0.0,0.0,0.0,450,10896,6750,-4146
2725,0.0,0.0,0.0,450,10900,6750,-4150
2726,0.0,0.0,0.0,450,10904,6750,-4154
2727,0.0,0.0,0.0,450,10908,6750,-4158
2728,0.0,0.0,0.0,450,10912,6750,-4162
2729,0.0,0.0,0.0,450,10916,6750,-4166
2730,0.0,0.0,0.0,450,10920,6750,-4170
2731,0.0,0.0,0.0,450,10924,6750,-4174
2732,0.0,0.0,0.0,450,10928,6750,-4178
2733,0.0,0.0,0.0,450,10932,6750,-4182
2734,0.0,0.0,0.0,450,10936,6750,-4186
2735,0.0,0.0,0.0,450,10940,6750,-4190
2736,0.0,0.0,0.0,450,10944,6750,-4194
2737,0.0,0.0,0.0,450,10948,6750,-4198
2738,0.0,0.0,0.0,450,10952,6750,-4202
2739,0.0,0.0,0.0,450,10956,6750,-4206
2740,0.0,0.0,0.4,450,10960,6750,-4210
2741,0.0,0.0,0.0,450,10964,6750,-4214
2742,0.0,0.0,0.0,450,10968,6750,-4218
2743,0.0,0.0,0.0,450,10972,6750,-4222
2744,0.0,0.0,0.0,450,10976,6750,-4226
2745,0.0,0.0,0.0,450,10980,6750,-4230
2746,0.0,0.0,0.0,450,10984,6750,-4234
2747,0.0,0.0,0.0,450,10988,6750,-4238
2748,0.0,0.0,0.0,450,10992,6750,-4242
2749,0.0,0.0,0.0,450,10996,6750,-4246
2750,0.0,0.0,0.0,450,11000,6750,-4250
2751,1.0,1.0,0.8,451,11004,6765,-4239
2752,1.0,1.0,1.0,452,11008,6780,-4228
2753,0.0,0.0,0.0,452,11012,6780,-4232
2754,0.0,0.0,0.0,452,11016,6780,-4236
2755,0.0,0.0,0.0,452,11020,6780,-4240
2756,0.0,0.0,0.0,452,11024,6780,-4244
2757,0.0,0.0,0.0,452,11028,6780,-4248
2758,0.0,0.0,0.0,452,11032,6780,-4252
2759,0.0,0.0,0.0,452,11036,6780,-4256
2760,1.0,1.0,1.0,453,11040,6795,-4245
2761,0.0,0.0,0.3333333333333333,453,11044,6795,-4249
2762,0.0,0.0,0.0,453,11048,6795,-4253
2763,0.0,0.0,0.0,453,11052,6795,-4257
2764,0.0,0.0,0.0,453,11056,6795,-4261
2765,0.0,0.0,0.0,453,11060,6795,-4265
2766,0.0,0.0,0.0,453,11064,6795,-4269
2767,0.0,0.0,0.25,453,11068,6795,-4273
2768,0.0,0.0,0.0,453,11072,6795,-4277
2769,1.0,1.0,1.0,454,11076,6810,-4266
2770,1.0,1.0,1.0,455,11080,6825,-4255
2771,0.0,0.0,0.0,455,11084,6825,-4259
2772,0.0,0.0,0.0,455,11088,6825,-4263
2773,0.0,0.0,0.0,455,11092,6825,-4267
2774,0.0,0.0,0.0,455,11096,6825,-4271
2775,0.0,0.0,0.0,455,11100,6825,-4275
2776,0.0,0.0,0.0,455,11104,6825,-4279
2777,0.0,0.0,0.0,455,11108,6825,-4283
2778,0.0,0.0,0.0,455,11112,6825,-4287
2779,0.0,0.0,0.0,455,11116,6825,-4291
2780,0.0,0.0,0.0,455,11120,6825,-4295
2781,0.0,0.0,0.0,455,11124,6825,-4299
2782,0.0,0.0,0.0,455,11128,6825,-4303
2783,0.0,0.0,0.0,455,11132,6825,-4307
2784,0.0,0.0,0.0,455,11136,6825,-4311
2785,0.0,0.0,0.0,455,11140,6825,-4315
2786,0.0,0.0,0.0,455,11144,6825,-4319
2787,0.0,0.0,0.0,455,11148,6825,-4323
2788,0.0,0.0,0.0,455,11152,6825,-4327
2789,1.0,1.0,1.0,456,11156,6840,-4316
2790,0.0,0.0,0.0,456,11160,6840,-4320
2791,0.0,0.0,0.0,456,11164,6840,-4324
2792,0.0,0.0,0.0,456,11168,6840,-4328
2793,0.0,0.0,0.0,456,11172,6840,-4332
2794,0.0,0.0,0.0,456,11176,6840,-4336
2795,1.0,1.0,1.0,457,11180,6855,-4325
2796,0.0,0.0,0.0,457,11184,6855,-4329
2797,0.0,0.0,0.0,457,11188,6855,-4333
2798,0.0,0.0,0.0,457,11192,6855,-4337
2799,0.0,0.0,0.0,457,11196,6855,-4341
2800,1.0,1.0,0.6,458,11200,6870,-4330
2801,0.0,0.0,0.0,458,11204,6870,-4334
2802,0.0,0.0,0.0,458,11208,6870,-4338
2803,1.0,1.0,1.0,459,11212,6885,-4327
2804,0.0,0.0,0.0,459,11216,6885,-4331
2805,0.0,0.0,0.0,459,11220,6885,-4335
2806,0.0,0.0,0.0,459,11224,6885,-4339
2807,0.0,0.0,0.0,459,11228,6885,-4343
2808,0.0,0.0,0.0,459,11232,6885,-4347
2809,0.0,0.0,0.0,459,11236,6885,-4351
2810,0.0,0.0,0.0,459,11240,6885,-4355
2811,0.0,0.0,0.0,459,11244,6885,-4359
2812,0.0,1.0,0.6666666666666666,459,11248,6885,-4363
2813,1.0,1.0,1.0,460,11252,6900,-4352
2814,0.0,0.0,0.0,460,11256,6900,-4356
2815,0.0,0.0,0.0,460,11260,6900,-4360
2816,0.0,0.0,0.0,460,11264,6900,-4364
2817,0.0,0.0,0.0,460,11268,6900,-4368
2818,1.0,1.0,1.0,461,11272,6915,-4357
2819,0.0,0.0,0.0,461,11276,6915,-4361
2820,0.0,0.0,0.0,461,11280,6915,-4365
2821,0.0,0.0,0.0,461,11284,6915,-4369
2822,0.0,0.0,0.0,461,11288,6915,-4373
2823,1.0,1.0,1.0,462,11292,6930,-4362
2824,1.0,1.0,1.0,463,11296,6945,-4351
2825,1.0,1.0,1.0,464,11300,6960,-4340
2826,0.0,0.0,0.0,464,11304,6960,-4344
2827,0.0,0.0,0.0,464,11308,6960,-4348
2828,0.0,0.0,0.0,464,11312,6960,-4352
2829,0.0,0.0,0.0,464,11316,6960,-4356
2830,0.0,0.0,0.0,464,11320,6960,-4360
2831,0.0,0.0,0.0,464,11324,6960,-4364
2832,0.0,0.0,0.0,464,11328,6960,-4368
2833,0.0,0.0,0.0,464,11332,6960,-4372
2834,0.0,0.0,0.0,464,11336,6960,-4376
2835,0.0,0.0,0.0,464,11340,6960,-4380
2836,0.0,0.0,0.0,464,11344,6960,-4384
2837,1.0,1.0,1.0,465,11348,6975,-4373
2838,0.0,0.0,0.0,465,11352,6975,-4377
2839,0.0,0.0,0.0,465,11356,6975,-4381
2840,0.0,0.0,0.0,465,11360,6975,-4385
2841,0.0,0.0,0.0,465,11364,6975,-4389
2842,0.0,0.0,0.0,465,11368,6975,-4393
2843,0.0,0.0,0.0,465,11372,6975,-4397
2844,0.0,0.0,0.0,465,11376,6975,-4401
2845,0.0,0.0,0.0,465,11380,6975,-4405
2846,0.0,1.0,0.6666666666666666,465,11384,6975,-4409
2847,0.0,0.0,0.0,465,11388,6975,-4413
2848,0.0,0.0,0.0,465,11392,6975,-4417
2849,0.0,0.0,0.0,465,11396,6975,-4421
2850,0.0,0.0,0.0,465,11400,6975,-4425
2851,0.0,0.0,0.0,465,11404,6975,-4429
2852,1.0,1.0,1.0,466,11408,6990,-4418
2853,0.0,0.0,0.0,466,11412,6990,-4422
2854,1.0,1.0,1.0,467,11416,7005,-4411
2855,0.0,0.0,0.0,467,11420,7005,-4415
2856,0.0,0.0,0.0,467,11424,7005,-4419
2857,0.0,0.0,0.3333333333333333,467,11428,7005,-4423
2858,0.0,0.0,0.0,467,11432,7005,-4427
2859,1.0,1.0,1.0,468,11436,7020,-4416
2860,0.0,0.0,0.0,468,11440,7020,-4420
2861,0.0,0.0,0.0,468,11444,7020,-4424
2862,1.0,1.0,1.0,469,11448,7035,-4413
2863,0.0,0.0,0.0,469,11452,7035,-4417
2864,0.0,0.0,0.0,469,11456,7035,-4421
2865,0.0,0.0,0.0,469,11460,7035,-4425
2866,0.0,0.0,0.0,469,11464,7035,-4429
2867,0.0,0.0,0.0,469,11468,7035,-4433
2868,0.0,0.0,0.0,469,11472,7035,-4437
2869,0.0,0.0,0.0,469,11476,7035,-4441
2870,0.0,0.0,0.0,469,11480,7035,-4445
2871,0.0,0.0,0.0,469,11484,7035,-4449
2872,1.0,1.0,1.0,470,11488,7050,-4438
2873,0.0,0.0,0.3333333333333333,470,11492,7050,-4442
2874,0.0,0.0,0.0,470,11496,7050,-4446
2875,0.0,0.0,0.0,470,11500,7050,-4450
2876,0.0,0.0,0.0,470,11504,7050,-4454
2877,0.0,0.0,0.0,470,11508,7050,-4458
2878,1.0,1.0,1.0,471,11512,7065,-4447
2879,0.0,0.0,0.0,471,11516,7065,-4451
2880,0.0,0.0,0.0,471,11520,7065,-4455
2881,1.0,1.0,1.0,472,11524,7080,-4444
2882,0.0,0.0,0.0,472,11528,7080,-4448
2883,0.0,0.0,0.0,472,11532,7080,-4452
2884,0.0,0.0,0.0,472,11536,7080,-4456
2885,0.0,0.0,0.0,472,11540,7080,-4460
2886,0.0,0.0,0.0,472,11544,7080,-4464
2887,0.0,0.0,0.0,472,11548,7080,-4468
2888,0.0,0.0,0.0,472,11552,7080,-4472
2889,0.0,0.0,0.0,472,11556,7080,-4476
2890,0.0,0.0,0.0,472,11560,7080,-4480
2891,0.0,0.0,0.0,472,11564,7080,-4484
2892,0.0,0.0,0.0,472,11568,7080,-4488
2893,0.0,0.0,0.0,472,11572,7080,-4492
2894,0.0,0.0,0.0,472,11576,7080,-4496
2895,0.0,0.0,0.0,472,11580,7080,-4500
2896,0.0,0.0,0.0,472,11584,7080,-4504
2897,0.0,0.0,0.0,472,11588,7080,-4508
2898,0.0,0.0,0.0,472,11592,7080,-4512
2899,0.0,0.0,0.0,472,11596,7080,-4516
2900,1.0,1.0,1.0,473,11600,7095,-4505
2901,0.0,0.0,0.0,473,11604,7095,-4509
2902,0.0,0.0,0.0,473,11608,7095,-4513
2903,0.0,0.0,0.0,473,11612,7095,-4517
2904,0.0,0.0,0.0,473,11616,7095,-4521
2905,0.0,0.0,0.0,473,11620,7095,-4525
2906,0.0,0.0,0.0,473,11624,7095,-4529
2907,0.0,0.0,0.0,473,11628,7095,-4533
2908,0.0,0.0,0.0,473,11632,7095,-4537
2909,0.0,0.0,0.0,473,11636,7095,-4541
2910,0.0,0.0,0.0,473,11640,7095,-4545
2911,0.0,0.0,0.0,473,11644,7095,-4549
2912,0.0,0.0,0.0,473,11648,7095,-4553
2913,0.0,0.0,0.0,473,11652,7095,-4557
2914,0.0,0.0,0.0,473,11656,7095,-4561
2915,0.0,0.0,0.0,473,11660,7095,-4565
2916,0.0,0.0,0.0,473,11664,7095,-4569
2917,0.0,0.0,0.0,473,11668,7095,-4573
2918,0.0,0.0,0.0,473,11672,7095,-4577
2919,0.0,0.0,0.0,473,11676,7095,-4581
2920,0.0,0.0,0.0,473,11680,7095,-4585
2921,0.0,0.0,0.0,473,11684,7095,-4589
2922,0.0,0.0,0.0,473,11688,7095,-4593
2923,0.0,0.0,0.0,473,11692,7095,-4597
2924,0.0,0.0,0.0,473,11696,7095,-4601
2925,1.0,1.0,1.0,474,11700,7110,-4590
2926,0.0,0.0,0.3333333333333333,474,11704,7110,-4594
2927,0.0,0.0,0.0,474,11708,7110,-4598
2928,0.0,0.0,0.0,474,11712,7110,-4602
2929,0.0,0.0,0.0,474,11716,7110,-4606
2930,1.0,1.0,1.0,475,11720,7125,-4595
2931,0.0,0.0,0.0,475,11724,7125,-4599
2932,0.0,0.0,0.0,475,11728,7125,-4603
2933,0.0,0.0,0.0,475,11732,7125,-4607
2934,1.0,1.0,1.0,476,11736,7140,-4596
2935,0.0,0.0,0.0,476,11740,7140,-4600
2936,0.0,0.0,0.0,476,11744,7140,-4604
2937,0.0,0.0,0.0,476,11748,7140,-4608
2938,0.0,0.0,0.0,476,11752,7140,-4612
2939,0.0,0.0,0.0,476,11756,7140,-4616
2940,0.0,0.0,0.0,476,11760,7140,-4620
2941,1.0,1.0,1.0,477,11764,7155,-4609
2942,0.0,0.0,0.0,477,11768,7155,-4613
2943,0.0,0.0,0.0,477,11772,7155,-4617
2944,0.0,0.0,0.0,477,11776,7155,-4621
2945,0.0,0.0,0.0,477,11780,7155,-4625
2946,0.0,0.0,0.0,477,11784,7155,-4629
2947,0.0,0.0,0.0,477,11788,7155,-4633
2948,0.0,0.0,0.0,477,11792,7155,-4637
2949,1.0,1.0,0.75,478,11796,7170,-4626
2950,0.0,0.0,0.0,478,11800,7170,-4630
2951,0.0,0.0,0.0,478,11804,7170,-4634
2952,0.0,0.0,0.0,478,11808,7170,-4638
2953,1.0,1.0,1.0,479,11812,7185,-4627
2954,0.0,0.0,0.0,479,11816,7185,-4631
2955,0.0,0.0,0.0,479,11820,7185,-4635
2956,0.0,0.0,0.0,479,11824,7185,-4639
2957,0.0,0.0,0.0,479,11828,7185,-4643
2958,0.0,0.0,0.0,479,11832,7185,-4647
2959,0.0,0.0,0.0,479,11836,7185,-4651
2960,0.0,0.0,0.0,479,11840,7185,-4655
2961,0.0,0.0,0.0,479,11844,7185,-4659
2962,0.0,0.0,0.0,479,11848,7185,-4663
2963,0.0,0.0,0.0,479,11852,7185,-4667
2964,0.0,0.0,0.2,479,11856,7185,-4671
2965,0.0,0.0,0.0,479,11860,7185,-4675
2966,1.0,1.0,1.0,480,11864,7200,-4664
2967,0.0,0.0,0.0,480,11868,7200,-4668
2968,0.0,1.0,0.6,480,11872,7200,-4672
2969,0.0,0.0,0.0,480,11876,7200,-4676
2970,1.0,1.0,1.0,481,11880,7215,-4665
2971,0.0,0.0,0.0,481,11884,7215,-4669
2972,0.0,0.0,0.0,481,11888,7215,-4673
2973,0.0,0.0,0.0,481,11892,7215,-4677
2974,0.0,0.0,0.0,481,11896,7215,-4681
2975,0.0,0.0,0.0,481,11900,7215,-4685
2976,0.0,0.0,0.0,481,11904,7215,-4689
2977,1.0,1.0,0.8,482,11908,7230,-4678
2978,1.0,1.0,1.0,483,11912,7245,-4667
2979,0.0,0.0,0.0,483,11916,7245,-4671
2980,0.0,0.0,0.0,483,11920,7245,-4675
2981,0.0,0.0,0.0,483,11924,7245,-4679
2982,0.0,0.0,0.0,483,11928,7245,-4683
2983,0.0,0.0,0.0,483,11932,7245,-4687
2984,0.0,0.0,0.0,483,11936,7245,-4691
2985,0.0,0.0,0.0,483,11940,7245,-4695
2986,0.0,0.0,0.0,483,11944,7245,-4699
2987,0.0,0.0,0.3333333333333333,483,11948,7245,-4703
2988,1.0,1.0,1.0,484,11952,7260,-4692
2989,0.0,0.0,0.0,484,11956,7260,-4696
2990,0.0,0.0,0.0,484,11960,7260,-4700
2991,0.0,0.0,0.0,484,11964,7260,-4704
2992,0.0,0.0,0.0,484,11968,7260,-4708
2993,0.0,0.0,0.0,484,11972,7260,-4712
2994,0.0,0.0,0.0,484,11976,7260,-4716
2995,0.0,0.0,0.0,484,11980,7260,-4720
2996,0.0,0.0,0.0,484,11984,7260,-4724
2997,0.0,0.0,0.0,484,11988,7260,-4728
2998,0.0,0.0,0.0,484,11992,7260,-4732
2999,0.0,0.0,0.0,484,11996,7260,-4736
3000,0.0,0.0,0.0,484,12000,7260,-4740
3001,0.0,0.0,0.0,484,12004,7260,-4744
3002,0.0,0.0,0.0,484,12008,7260,-4748
3003,0.0,0.0,0.0,484,12012,7260,-4752
3004,1.0,1.0,1.0,485,12016,7275,-4741
3005,0.0,0.0,0.0,485,12020,7275,-4745
3006,0.0,0.0,0.0,485,12024,7275,-4749
3007,0.0,0.0,0.3333333333333333,485,12028,7275,-4753
3008,0.0,0.0,0.0,485,12032,7275,-4757
3009,0.0,0.0,0.0,485,12036,7275,-4761
3010,0.0,0.0,0.0,485,12040,7275,-4765
3011,0.0,0.0,0.0,485,12044,7275,-4769
3012,1.0,1.0,0.6666666666666666,486,12048,7290,-4758
3013,1.0,1.0,1.0,487,12052,7305,-4747
3014,0.0,0.0,0.0,487,12056,7305,-4751
3015,0.0,0.0,0.0,487,12060,7305,-4755
3016,0.0,0.0,0.0,487,12064,7305,-4759
3017,1.0,1.0,1.0,488,12068,7320,-4748
3018,0.0,0.0,0.0,488,12072,7320,-4752
3019,0.0,0.0,0.0,488,12076,7320,-4756
3020,0.0,0.0,0.0,488,12080,7320,-4760
3021,0.0,0.0,0.0,488,12084,7320,-4764
3022,0.0,0.0,0.0,488,12088,7320,-4768
3023,0.0,0.0,0.0,488,12092,7320,-4772
3024,1.0,1.0,1.0,489,12096,7335,-4761
3025,0.0,0.0,0.0,489,12100,7335,-4765
3026,1.0,1.0,1.0,490,12104,7350,-4754
3027,0.0,0.0,0.3333333333333333,490,12108,7350,-4758
3028,0.0,0.0,0.0,490,12112,7350,-4762
3029,1.0,1.0,1.0,491,12116,7365,-4751
3030,0.0,0.0,0.0,491,12120,7365,-4755
3031,0.0,0.0,0.3333333333333333,491,12124,7365,-4759
3032,0.0,0.0,0.0,491,12128,7365,-4763
3033,0.0,0.0,0.0,491,12132,7365,-4767
3034,0.0,0.0,0.0,491,12136,7365,-4771
3035,0.0,0.0,0.0,491,12140,7365,-4775
3036,0.0,0.0,0.0,491,12144,7365,-4779
3037,0.0,0.0,0.0,491,12148,7365,-4783
3038,1.0,0.0,0.4,492,12152,7380,-4772
3039,0.0,0.0,0.0,492,12156,7380,-4776
3040,0.0,0.0,0.0,492,12160,7380,-4780
3041,0.0,0.0,0.0,492,12164,7380,-4784
3042,0.0,0.0,0.0,492,12168,7380,-4788
3043,1.0,1.0,1.0,493,12172,7395,-4777
3044,0.0,0.0,0.0,493,12176,7395,-4781
3045,0.0,0.0,0.0,493,12180,7395,-4785
3046,0.0,0.0,0.0,493,12184,7395,-4789
3047,0.0,0.0,0.0,493,12188,7395,-4793
3048,0.0,0.0,0.0,493,12192,7395,-4797
3049,0.0,0.0,0.0,493,12196,7395,-4801
3050,0.0,0.0,0.0,493,12200,7395,-4805
3051,0.0,0.0,0.0,493,12204,7395,-4809
3052,0.0,0.0,0.0,493,12208,7395,-4813
3053,0.0,0.0,0.0,493,12212,7395,-4817
3054,1.0,1.0,1.0,494,12216,7410,-4806
3055,1.0,1.0,1.0,495,12220,7425,-4795
3056,0.0,0.0,0.0,495,12224,7425,-4799
3057,0.0,0.0,0.0,495,12228,7425,-4803
3058,0.0,0.0,0.0,495,12232,7425,-4807
3059,0.0,0.0,0.0,495,12236,7425,-4811
3060,0.0,0.0,0.0,495,12240,7425,-4815
3061,0.0,0.0,0.0,495,12244,7425,-4819
3062,0.0,0.0,0.0,495,12248,7425,-4823
3063,1.0,0.0,0.3333333333333333,496,12252,7440,-4812
3064,0.0,0.0,0.0,496,12256,7440,-4816
3065,1.0,1.0,1.0,497,12260,7455,-4805
3066,0.0,0.0,0.0,497,12264,7455,-4809
3067,0.0,0.0,0.0,497,12268,7455,-4813
3068,0.0,0.0,0.0,497,12272,7455,-4817
3069,0.0,0.0,0.0,497,12276,7455,-4821
3070,0.0,0.0,0.0,497,12280,7455,-4825
3071,0.0,0.0,0.0,497,12284,7455,-4829
3072,0.0,0.0,0.0,497,12288,7455,-4833
3073,0.0,0.0,0.0,497,12292,7455,-4837
3074,0.0,0.0,0.0,497,12296,7455,-4841
3075,0.0,0.0,0.0,497,12300,7455,-4845
3076,0.0,0.0,0.0,497,12304,7455,-4849
3077,0.0,0.0,0.0,497,12308,7455,-4853
3078,0.0,0.0,0.0,497,12312,7455,-4857
3079,0.0,0.0,0.2,497,12316,7455,-4861
3080,0.0,0.0,0.0,497,12320,7455,-4865
3081,0.0,0.0,0.0,497,12324,7455,-4869
3082,0.0,0.0,0.0,497,12328,7455,-4873
3083,0.0,0.0,0.0,497,12332,7455,-4877
3084,0.0,0.0,0.0,497,12336,7455,-4881
3085,0.0,0.0,0.0,497,12340,7455,-4885
3086,0.0,0.0,0.0,497,12344,7455,-4889
3087,0.0,0.0,0.0,497,12348,7455,-4893
3088,0.0,0.0,0.25,497,12352,7455,-4897
3089,0.0,0.0,0.0,497,12356,7455,-4901
3090,0.0,0.0,0.0,497,12360,7455,-4905
3091,0.0,0.0,0.0,497,12364,7455,-4909
3092,0.0,0.0,0.0,497,12368,7455,-4913
3093,0.0,0.0,0.0,497,12372,7455,-4917
3094,0.0,0.0,0.0,497,12376,7455,-4921
3095,0.0,0.0,0.0,497,12380,7455,-4925
3096,0.0,0.0,0.0,497,12384,7455,-4929
3097,0.0,0.0,0.0,497,12388,7455,-4933
3098,0.0,0.0,0.0,497,12392,7455,-4937
3099,0.0,0.0,0.4,497,12396,7455,-4941
3100,0.0,0.0,0.0,497,12400,7455,-4945
3101,0.0,0.0,0.0,497,12404,7455,-4949
3102,0.0,0.0,0.0,497,12408,7455,-4953
3103,0.0,0.0,0.0,497,12412,7455,-4957
3104,0.0,0.0,0.0,497,12416,7455,-4961
3105,0.0,0.0,0.0,497,12420,7455,-4965
3106,0.0,0.0,0.0,497,12424,7455,-4969
3107,0.0,0.0,0.0,497,12428,7455,-4973
3108,0.0,0.0,0.0,497,12432,7455,-4977
3109,0.0,0.0,0.0,497,12436,7455,-4981
3110,0.0,0.0,0.0,497,12440,7455,-4985
3111,0.0,0.0,0.0,497,12444,7455,-4989
3112,0.0,0.0,0.0,497,12448,7455,-4993
3113,0.0,0.0,0.0,497,12452,7455,-4997
3114,0.0,0.0,0.0,497,12456,7455,-5001
3115,0.0,0.0,0.0,497,12460,7455,-5005
3116,0.0,0.0,0.0,497,12464,7455,-5009
3117,0.0,0.0,0.0,497,12468,7455,-5013
3118,0.0,0.0,0.0,497,12472,7455,-5017
3119,0.0,0.0,0.0,497,12476,7455,-5021
3120,0.0,0.0,0.0,497,12480,7455,-5025
3121,0.0,0.0,0.0,497,12484,7455,-5029
3122,0.0,0.0,0.0,497,12488,7455,-5033
3123,0.0,0.0,0.0,497,12492,7455,-5037
3124,0.0,0.0,0.0,497,12496,7455,-5041
3125,1.0,1.0,1.0,498,12500,7470,-5030
3126,0.0,0.0,0.0,498,12504,7470,-5034
3127,0.0,0.0,0.0,498,12508,7470,-5038
3128,0.0,0.0,0.0,498,12512,7470,-5042
3129,0.0,0.0,0.0,498,12516,7470,-5046
3130,0.0,0.0,0.0,498,12520,7470,-5050
3131,0.0,0.0,0.0,498,12524,7470,-5054
3132,0.0,0.0,0.0,498,12528,7470,-5058
3133,0.0,0.0,0.0,498,12532,7470,-5062
3134,0.0,0.0,0.0,498,12536,7470,-5066
3135,0.0,0.0,0.0,498,12540,7470,-5070
3136,0.0,0.0,0.0,498,12544,7470,-5074
3137,0.0,0.0,0.0,498,12548,7470,-5078
3138,0.0,0.0,0.0,498,12552,7470,-5082
3139,0.0,1.0,0.6666666666666666,498,12556,7470,-5086
3140,0.0,0.0,0.0,498,12560,7470,-5090
3141,0.0,0.0,0.0,498,12564,7470,-5094
3142,0.0,0.0,0.0,498,12568,7470,-5098
3143,0.0,0.0,0.0,498,12572,7470,-5102
3144,0.0,0.0,0.0,498,12576,7470,-5106
3145,0.0,0.0,0.0,498,12580,7470,-5110
3146,0.0,0.0,0.0,498,12584,7470,-5114
3147,0.0,0.0,0.0,498,12588,7470,-5118
3148,0.0,0.0,0.0,498,12592,7470,-5122
3149,0.0,0.0,0.0,498,12596,7470,-5126
3150,0.0,0.0,0.0,498,12600,7470,-5130
3151,0.0,0.0,0.0,498,12604,7470,-5134
3152,0.0,0.0,0.0,498,12608,7470,-5138
3153,0.0,0.0,0.0,498,12612,7470,-5142
3154,1.0,0.0,0.4,499,12616,7485,-5131
3155,0.0,0.0,0.0,499,12620,7485,-5135
3156,0.0,0.0,0.0,499,12624,7485,-5139
3157,1.0,1.0,1.0,500,12628,7500,-5128
3158,0.0,0.0,0.0,500,12632,7500,-5132
3159,1.0,1.0,1.0,501,12636,7515,-5121
3160,0.0,0.0,0.0,501,12640,7515,-5125
3161,0.0,0.0,0.0,501,12644,7515,-5129
3162,0.0,0.0,0.0,501,12648,7515,-5133
3163,1.0,1.0,1.0,502,12652,7530,-5122
3164,0.0,0.0,0.0,502,12656,7530,-5126
3165,1.0,1.0,1.0,503,12660,7545,-5115
3166,0.0,0.0,0.0,503,12664,7545,-5119
3167,0.0,0.0,0.0,503,12668,7545,-5123
3168,0.0,0.0,0.0,503,12672,7545,-5127
3169,0.0,0.0,0.0,503,12676,7545,-5131
3170,0.0,0.0,0.0,503,12680,7545,-5135
3171,0.0,0.0,0.0,503,12684,7545,-5139
3172,0.0,0.0,0.0,503,12688,7545,-5143
3173,0.0,0.0,0.0,503,12692,7545,-5147
3174,0.0,0.0,0.0,503,12696,7545,-5151
3175,0.0,0.0,0.0,503,12700,7545,-5155
3176,0.0,0.0,0.3333333333333333,503,12704,7545,-5159
3177,0.0,0.0,0.25,503,12708,7545,-5163
3178,0.0,1.0,0.6666666666666666,503,12712,7545,-5167
3179,0.0,0.0,0.0,503,12716,7545,-5171
3180,0.0,0.0,0.0,503,12720,7545,-5175
3181,0.0,0.0,0.0,503,12724,7545,-5179
3182,0.0,0.0,0.0,503,12728,7545,-5183
3183,0.0,0.0,0.0,503,12732,7545,-5187
3184,0.0,0.0,0.0,503,12736,7545,-5191
3185,0.0,0.0,0.0,503,12740,7545,-5195
3186,1.0,1.0,1.0,504,12744,7560,-5184
3187,0.0,0.0,0.3333333333333333,504,12748,7560,-5188
3188,0.0,0.0,0.0,504,12752,7560,-5192
3189,1.0,1.0,1.0,505,12756,7575,-5181
3190,0.0,0.0,0.0,505,12760,7575,-5185
3191,0.0,0.0,0.0,505,12764,7575,-5189
3192,0.0,0.0,0.0,505,12768,7575,-5193
3193,0.0,0.0,0.0,505,12772,7575,-5197
3194,1.0,1.0,0.75,506,12776,7590,-5186
3195,0.0,0.0,0.0,506,12780,7590,-5190
3196,0.0,0.0,0.0,506,12784,7590,-5194
3197,1.0,1.0,0.8,507,12788,7605,-5183
3198,0.0,0.0,0.0,507,12792,7605,-5187
3199,1.0,1.0,1.0,508,12796,7620,-5176
3200,0.0,0.0,0.0,508,12800,7620,-5180
3201,0.0,0.0,0.4,508,12804,7620,-5184
3202,0.0,0.0,0.0,508,12808,7620,-5188
3203,0.0,0.0,0.0,508,12812,7620,-5192
3204,0.0,0.0,0.0,508,12816,7620,-5196
3205,0.0,0.0,0.0,508,12820,7620,-5200
3206,0.0,0.0,0.0,508,12824,7620,-5204
3207,0.0,0.0,0.0,508,12828,7620,-5208
3208,1.0,1.0,1.0,509,12832,7635,-5197
3209,0.0,0.0,0.0,509,12836,7635,-5201
3210,0.0,0.0,0.0,509,12840,7635,-5205
3211,0.0,0.0,0.0,509,12844,7635,-5209
3212,0.0,0.0,0.0,509,12848,7635,-5213
3213,0.0,0.0,0.0,509,12852,7635,-5217
3214,0.0,0.0,0.0,509,12856,7635,-5221
3215,0.0,0.0,0.0,509,12860,7635,-5225
3216,0.0,0.0,0.0,509,12864,7635,-5229
3217,0.0,0.0,0.0,509,12868,7635,-5233
3218,0.0,0.0,0.0,509,12872,7635,-5237
3219,1.0,1.0,0.75,510,12876,7650,-5226
3220,0.0,0.0,0.0,510,12880,7650,-5230
3221,0.0,0.0,0.0,510,12884,7650,-5234
3222,0.0,0.0,0.0,510,12888,7650,-5238
3223,0.0,0.0,0.0,510,12892,7650,-5242
3224,0.0,0.0,0.0,510,12896,7650,-5246
3225,0.0,0.0,0.0,510,12900,7650,-5250
3226,0.0,0.0,0.0,510,12904,7650,-5254
3227,1.0,1.0,1.0,511,12908,7665,-5243
3228,0.0,0.0,0.0,511,12912,7665,-5247
3229,0.0,0.0,0.0,511,12916,7665,-5251
3230,0.0,0.0,0.0,511,12920,7665,-5255
3231,1.0,1.0,0.6,512,12924,7680,-5244
3232,0.0,0.0,0.0,512,12928,7680,-5248
3233,0.0,0.0,0.0,512,12932,7680,-5252
3234,0.0,0.0,0.0,512,12936,7680,-5256
3235,0.0,0.0,0.0,512,12940,7680,-5260
3236,0.0,0.0,0.0,512,12944,7680,-5264
3237,0.0,0.0,0.0,512,12948,7680,-5268
3238,0.0,0.0,0.0,512,12952,7680,-5272
3239,0.0,0.0,0.0,512,12956,7680,-5276
3240,0.0,0.0,0.0,512,12960,7680,-5280
3241,1.0,0.0,0.3333333333333333,513,12964,7695,-5269
3242,0.0,0.0,0.0,513,12968,7695,-5273
3243,1.0,1.0,0.75,514,12972,7710,-5262
3244,0.0,0.0,0.0,514,12976,7710,-5266
3245,0.0,0.0,0.0,514,12980,7710,-5270
3246,1.0,1.0,1.0,515,12984,7725,-5259
3247,0.0,0.0,0.0,515,12988,7725,-5263
3248,1.0,0.0,0.3333333333333333,516,12992,7740,-5252
3249,0.0,0.0,0.0,516,12996,7740,-5256
3250,0.0,0.0,0.0,516,13000,7740,-5260
3251,1.0,1.0,0.6666666666666666,517,13004,7755,-5249
3252,0.0,0.0,0.0,517,13008,7755,-5253
3253,0.0,0.0,0.0,517,13012,7755,-5257
3254,0.0,0.0,0.0,517,13016,7755,-5261
3255,0.0,0.0,0.0,517,13020,7755,-5265
3256,0.0,0.0,0.0,517,13024,7755,-5269
3257,0.0,0.0,0.0,517,13028,7755,-5273
3258,0.0,0.0,0.0,517,13032,7755,-5277
3259,0.0,0.0,0.0,517,13036,7755,-5281
3260,1.0,0.0,0.3333333333333333,518,13040,7770,-5270
3261,0.0,0.0,0.0,518,13044,7770,-5274
3262,0.0,0.0,0.0,518,13048,7770,-5278
3263,0.0,0.0,0.0,518,13052,7770,-5282
3264,0.0,0.0,0.0,518,13056,7770,-5286
3265,0.0,0.0,0.0,518,13060,7770,-5290
3266,0.0,0.0,0.0,518,13064,7770,-5294
3267,0.0,0.0,0.0,518,13068,7770,-5298
3268,0.0,0.0,0.0,518,13072,7770,-5302
3269,0.0,0.0,0.0,518,13076,7770,-5306
3270,0.0,0.0,0.0,518,13080,7770,-5310
3271,0.0,0.0,0.0,518,13084,7770,-5314
3272,1.0,1.0,1.0,519,13088,7785,-5303
3273,0.0,0.0,0.0,519,13092,7785,-5307
3274,0.0,0.0,0.0,519,13096,7785,-5311
3275,0.0,0.0,0.0,519,13100,7785,-5315
3276,0.0,0.0,0.0,519,13104,7785,-5319
3277,0.0,0.0,0.0,519,13108,7785,-5323
3278,0.0,0.0,0.0,519,13112,7785,-5327
3279,0.0,0.0,0.0,519,13116,7785,-5331
3280,0.0,0.0,0.0,519,13120,7785,-5335
3281,0.0,0.0,0.0,519,13124,7785,-5339
3282,0.0,0.0,0.0,519,13128,7785,-5343
3283,0.0,0.0,0.0,519,13132,7785,-5347
3284,1.0,1.0,1.0,520,13136,7800,-5336
3285,0.0,0.0,0.0,520,13140,7800,-5340
3286,0.0,0.0,0.0,520,13144,7800,-5344
3287,1.0,1.0,0.6666666666666666,521,13148,7815,-5333
3288,0.0,0.0,0.0,521,13152,7815,-5337
3289,0.0,0.0,0.0,521,13156,7815,-5341
3290,0.0,0.0,0.0,521,13160,7815,-5345
3291,0.0,0.0,0.0,521,13164,7815,-5349
3292,0.0,0.0,0.0,521,13168,7815,-5353
3293,1.0,1.0,1.0,522,13172,7830,-5342
3294,0.0,0.0,0.0,522,13176,7830,-5346
3295,0.0,0.0,0.0,522,13180,7830,-5350
3296,1.0,1.0,1.0,523,13184,7845,-5339
3297,1.0,1.0,1.0,524,13188,7860,-5328
3298,0.0,0.0,0.0,524,13192,7860,-5332
3299,0.0,0.0,0.0,524,13196,7860,-5336
3300,0.0,0.0,0.0,524,13200,7860,-5340
3301,0.0,0.0,0.0,524,13204,7860,-5344
3302,0.0,0.0,0.0,524,13208,7860,-5348
3303,1.0,1.0,1.0,525,13212,7875,-5337
3304,1.0,1.0,1.0,526,13216,7890,-5326
3305,0.0,0.0,0.0,526,13220,7890,-5330
3306,0.0,0.0,0.0,526,13224,7890,-5334
3307,0.0,0.0,0.0,526,13228,7890,-5338
3308,0.0,0.0,0.0,526,13232,7890,-5342
3309,1.0,0.0,0.3333333333333333,527,13236,7905,-5331
3310,1.0,1.0,0.75,528,13240,7920,-5320
3311,0.0,0.0,0.0,528,13244,7920,-5324
3312,0.0,0.0,0.0,528,13248,7920,-5328
3313,1.0,1.0,1.0,529,13252,7935,-5317
3314,0.0,0.0,0.0,529,13256,7935,-5321
3315,0.0,0.0,0.0,529,13260,7935,-5325
3316,0.0,0.0,0.0,529,13264,7935,-5329
3317,0.0,0.0,0.0,529,13268,7935,-5333
3318,0.0,0.0,0.0,529,13272,7935,-5337
3319,1.0,1.0,0.6666666666666666,530,13276,7950,-5326
3320,1.0,1.0,1.0,531,13280,7965,-5315
3321,0.0,0.0,0.0,531,13284,7965,-5319
3322,1.0,0.0,0.3333333333333333,532,13288,7980,-5308
3323,1.0,1.0,1.0,533,13292,7995,-5297
3324,0.0,0.0,0.0,533,13296,7995,-5301
3325,0.0,0.0,0.0,533,13300,7995,-5305
3326,0.0,0.0,0.0,533,13304,7995,-5309
3327,0.0,0.0,0.0,533,13308,7995,-5313
3328,0.0,0.0,0.0,533,13312,7995,-5317
3329,0.0,0.0,0.0,533,13316,7995,-5321
3330,0.0,0.0,0.0,533,13320,7995,-5325
3331,0.0,0.0,0.0,533,13324,7995,-5329
3332,0.0,0.0,0.0,533,13328,7995,-5333
3333,0.0,0.0,0.0,533,13332,7995,-5337
3334,1.0,1.0,1.0,534,13336,8010,-5326
3335,0.0,0.0,0.0,534,13340,8010,-5330
3336,0.0,0.0,0.0,534,13344,8010,-5334
3337,0.0,0.0,0.0,534,13348,8010,-5338
3338,0.0,0.0,0.0,534,13352,8010,-5342
3339,0.0,0.0,0.0,534,13356,8010,-5346
3340,0.0,0.0,0.0,534,13360,8010,-5350
3341,0.0,0.0,0.0,534,13364,8010,-5354
3342,0.0,0.0,0.0,534,13368,8010,-5358
3343,1.0,1.0,1.0,535,13372,8025,-5347
3344,0.0,0.0,0.0,535,13376,8025,-5351
3345,0.0,0.0,0.0,535,13380,8025,-5355
3346,1.0,1.0,1.0,536,13384,8040,-5344
3347,0.0,0.0,0.0,536,13388,8040,-5348
3348,0.0,0.0,0.0,536,13392,8040,-5352
3349,0.0,0.0,0.0,536,13396,8040,-5356
3350,1.0,1.0,1.0,537,13400,8055,-5345
3351,1.0,1.0,1.0,538,13404,8070,-5334
3352,0.0,0.0,0.0,538,13408,8070,-5338
3353,0.0,0.0,0.0,538,13412,8070,-5342
3354,0.0,0.0,0.0,538,13416,8070,-5346
3355,0.0,0.0,0.0,538,13420,8070,-5350
3356,1.0,1.0,0.6666666666666666,539,13424,8085,-5339
3357,0.0,0.0,0.0,539,13428,8085,-5343
3358,0.0,0.0,0.0,539,13432,8085,-5347
3359,0.0,0.0,0.0,539,13436,8085,-5351
3360,0.0,0.0,0.0,539,13440,8085,-5355
3361,0.0,0.0,0.0,539,13444,8085,-5359
3362,1.0,1.0,1.0,540,13448,8100,-5348
3363,1.0,1.0,1.0,541,13452,8115,-5337
3364,0.0,0.0,0.0,541,13456,8115,-5341
3365,0.0,0.0,0.0,541,13460,8115,-5345
3366,0.0,0.0,0.0,541,13464,8115,-5349
3367,1.0,1.0,1.0,542,13468,8130,-5338
3368,0.0,0.0,0.0,542,13472,8130,-5342
3369,0.0,0.0,0.0,542,13476,8130,-5346
3370,0.0,0.0,0.0,542,13480,8130,-5350
3371,0.0,0.0,0.0,542,13484,8130,-5354
3372,0.0,0.0,0.0,542,13488,8130,-5358
3373,0.0,0.0,0.0,542,13492,8130,-5362
3374,0.0,0.0,0.0,542,13496,8130,-5366
3375,0.0,0.0,0.0,542,13500,8130,-5370
3376,0.0,0.0,0.0,542,13504,8130,-5374
3377,0.0,0.0,0.0,542,13508,8130,-5378
3378,0.0,0.0,0.0,542,13512,8130,-5382
3379,1.0,1.0,0.6666666666666666,543,13516,8145,-5371
3380,0.0,0.0,0.0,543,13520,8145,-5375
3381,0.0,0.0,0.0,543,13524,8145,-5379
3382,0.0,0.0,0.0,543,13528,8145,-5383
3383,0.0,0.0,0.0,543,13532,8145,-5387
3384,0.0,0.0,0.0,543,13536,8145,-5391
3385,0.0,0.0,0.0,543,13540,8145,-5395
3386,0.0,0.0,0.0,543,13544,8145,-5399
3387,0.0,0.0,0.0,543,13548,8145,-5403
3388,0.0,0.0,0.0,543,13552,8145,-5407
3389,0.0,0.0,0.0,543,13556,8145,-5411
3390,0.0,0.0,0.0,543,13560,8145,-5415
3391,0.0,0.0,0.3333333333333333,543,13564,8145,-5419
3392,0.0,0.0,0.0,543,13568,8145,-5423
3393,0.0,0.0,0.0,543,13572,8145,-5427
3394,0.0,0.0,0.0,543,13576,8145,-5431
3395,1.0,1.0,0.8,544,13580,8160,-5420
3396,0.0,0.0,0.0,544,13584,8160,-5424
3397,0.0,0.0,0.0,544,13588,8160,-5428
3398,0.0,0.0,0.0,544,13592,8160,-5432
3399,0.0,0.0,0.0,544,13596,8160,-5436
3400,0.0,0.0,0.0,544,13600,8160,-5440
3401,0.0,0.0,0.0,544,13604,8160,-5444
3402,0.0,0.0,0.0,544,13608,8160,-5448
3403,0.0,0.0,0.0,544,13612,8160,-5452
3404,0.0,0.0,0.0,544,13616,8160,-5456
3405,0.0,0.0,0.0,544,13620,8160,-5460
3406,0.0,0.0,0.0,544,13624,8160,-5464
3407,0.0,0.0,0.0,544,13628,8160,-5468
3408,0.0,0.0,0.0,544,13632,8160,-5472
3409,0.0,0.0,0.0,544,13636,8160,-5476
3410,0.0,0.0,0.0,544,13640,8160,-5480
3411,1.0,0.0,0.3333333333333333,545,13644,8175,-5469
3412,0.0,0.0,0.0,545,13648,8175,-5473
3413,0.0,0.0,0.0,545,13652,8175,-5477
3414,0.0,0.0,0.0,545,13656,8175,-5481
3415,1.0,1.0,1.0,546,13660,8190,-5470
3416,0.0,0.0,0.0,546,13664,8190,-5474
3417,0.0,0.0,0.0,546,13668,8190,-5478
3418,1.0,1.0,1.0,547,13672,8205,-5467
3419,0.0,0.0,0.0,547,13676,8205,-5471
3420,0.0,0.0,0.0,547,13680,8205,-5475
3421,0.0,0.0,0.0,547,13684,8205,-5479
3422,0.0,0.0,0.0,547,13688,8205,-5483
3423,1.0,0.0,0.3333333333333333,548,13692,8220,-5472
3424,0.0,0.0,0.0,548,13696,8220,-5476
3425,0.0,0.0,0.0,548,13700,8220,-5480
3426,0.0,0.0,0.0,548,13704,8220,-5484
3427,0.0,0.0,0.0,548,13708,8220,-5488
3428,0.0,0.0,0.0,548,13712,8220,-5492
3429,0.0,0.0,0.0,548,13716,8220,-5496
3430,0.0,0.0,0.0,548,13720,8220,-5500
3431,0.0,0.0,0.0,548,13724,8220,-5504
3432,0.0,0.0,0.0,548,13728,8220,-5508
3433,0.0,0.0,0.0,548,13732,8220,-5512
3434,0.0,0.0,0.0,548,13736,8220,-5516
3435,0.0,0.0,0.0,548,13740,8220,-5520
3436,0.0,0.0,0.0,548,13744,8220,-5524
3437,0.0,1.0,0.6666666666666666,548,13748,8220,-5528
3438,0.0,0.0,0.0,548,13752,8220,-5532
3439,0.0,0.0,0.0,548,13756,8220,-5536
3440,0.0,0.0,0.0,548,13760,8220,-5540
3441,1.0,0.0,0.3333333333333333,549,13764,8235,-5529
3442,0.0,0.0,0.0,549,13768,8235,-5533
3443,0.0,0.0,0.0,549,13772,8235,-5537
3444,0.0,0.0,0.0,549,13776,8235,-5541
3445,0.0,0.0,0.3333333333333333,549,13780,8235,-5545
3446,0.0,0.0,0.0,549,13784,8235,-5549
3447,0.0,0.0,0.0,549,13788,8235,-5553
3448,0.0,0.0,0.0,549,13792,8235,-5557
3449,0.0,0.0,0.0,549,13796,8235,-5561
3450,0.0,0.0,0.0,549,13800,8235,-5565
3451,0.0,0.0,0.0,549,13804,8235,-5569
3452,0.0,0.0,0.0,549,13808,8235,-5573
3453,1.0,1.0,1.0,550,13812,8250,-5562
3454,0.0,0.0,0.0,550,13816,8250,-5566
3455,0.0,0.0,0.0,550,13820,8250,-5570
3456,0.0,0.0,0.0,550,13824,8250,-5574
3457,0.0,0.0,0.0,550,13828,8250,-5578
3458,0.0,0.0,0.0,550,13832,8250,-5582
3459,0.0,0.0,0.0,550,13836,8250,-5586
3460,0.0,0.0,0.0,550,13840,8250,-5590
3461,1.0,1.0,1.0,551,13844,8265,-5579
3462,0.0,0.0,0.0,551,13848,8265,-5583
3463,0.0,0.0,0.0,551,13852,8265,-5587
3464,0.0,0.0,0.0,551,13856,8265,-5591
3465,0.0,0.0,0.0,551,13860,8265,-5595
3466,0.0,0.0,0.0,551,13864,8265,-5599
3467,0.0,0.0,0.0,551,13868,8265,-5603
3468,0.0,0.0,0.0,551,13872,8265,-5607
3469,0.0,1.0,0.6666666666666666,551,13876,8265,-5611
3470,0.0,0.0,0.0,551,13880,8265,-5615
3471,0.0,0.0,0.0,551,13884,8265,-5619
3472,0.0,0.0,0.0,551,13888,8265,-5623
3473,0.0,0.0,0.0,551,13892,8265,-5627
3474,1.0,1.0,0.6666666666666666,552,13896,8280,-5616
3475,1.0,1.0,1.0,553,13900,8295,-5605
3476,0.0,0.0,0.0,553,13904,8295,-5609
3477,0.0,0.0,0.0,553,13908,8295,-5613
3478,1.0,1.0,1.0,554,13912,8310,-5602
3479,1.0,1.0,1.0,555,13916,8325,-5591
3480,0.0,0.0,0.0,555,13920,8325,-5595
3481,1.0,1.0,0.6666666666666666,556,13924,8340,-5584
3482,1.0,0.0,0.3333333333333333,557,13928,8355,-5573
3483,0.0,0.0,0.0,557,13932,8355,-5577
3484,0.0,0.0,0.0,557,13936,8355,-5581
3485,1.0,1.0,1.0,558,13940,8370,-5570
3486,1.0,1.0,1.0,559,13944,8385,-5559
3487,1.0,1.0,0.6,560,13948,8400,-5548
3488,0.0,0.0,0.2,560,13952,8400,-5552
3489,0.0,0.0,0.0,560,13956,8400,-5556
3490,0.0,0.0,0.0,560,13960,8400,-5560
3491,0.0,0.0,0.0,560,13964,8400,-5564
3492,0.0,0.0,0.0,560,13968,8400,-5568
3493,0.0,0.0,0.0,560,13972,8400,-5572
3494,0.0,0.0,0.0,560,13976,8400,-5576
3495,0.0,0.0,0.0,560,13980,8400,-5580
3496,0.0,0.0,0.0,560,13984,8400,-5584
3497,0.0,0.0,0.0,560,13988,8400,-5588
3498,0.0,0.0,0.0,560,13992,8400,-5592
3499,0.0,0.0,0.0,560,13996,8400,-5596
3500,0.0,0.0,0.2,560,14000,8400,-5600
3501,0.0,0.0,0.0,560,14004,8400,-5604
3502,0.0,0.0,0.0,560,14008,8400,-5608
3503,0.0,0.0,0.0,560,14012,8400,-5612
3504,0.0,0.0,0.0,560,14016,8400,-5616
3505,0.0,0.0,0.0,560,14020,8400,-5620
3506,0.0,0.0,0.0,560,14024,8400,-5624
3507,0.0,0.0,0.0,560,14028,8400,-5628
3508,0.0,0.0,0.0,560,14032,8400,-5632
3509,0.0,0.0,0.0,560,14036,8400,-5636
3510,0.0,0.0,0.0,560,14040,8400,-5640
3511,0.0,0.0,0.0,560,14044,8400,-5644
3512,1.0,1.0,1.0,561,14048,8415,-5633
3513,0.0,0.0,0.0,561,14052,8415,-5637
3514,1.0,1.0,1.0,562,14056,8430,-5626
3515,0.0,0.0,0.0,562,14060,8430,-5630
3516,0.0,0.0,0.2,562,14064,8430,-5634
3517,0.0,0.0,0.0,562,14068,8430,-5638
3518,1.0,0.0,0.5,563,14072,8445,-5627
3519,0.0,0.0,0.0,563,14076,8445,-5631
3520,0.0,0.0,0.0,563,14080,8445,-5635
3521,0.0,0.0,0.0,563,14084,8445,-5639
3522,0.0,0.0,0.0,563,14088,8445,-5643
3523,0.0,0.0,0.0,563,14092,8445,-5647
3524,0.0,0.0,0.0,563,14096,8445,-5651
3525,0.0,0.0,0.0,563,14100,8445,-5655
3526,0.0,0.0,0.0,563,14104,8445,-5659
3527,1.0,1.0,1.0,564,14108,8460,-5648
3528,0.0,0.0,0.0,564,14112,8460,-5652
3529,0.0,0.0,0.0,564,14116,8460,-5656
3530,0.0,0.0,0.0,564,14120,8460,-5660
3531,0.0,0.0,0.3333333333333333,564,14124,8460,-5664
3532,0.0,0.0,0.0,564,14128,8460,-5668
3533,0.0,0.0,0.0,564,14132,8460,-5672
3534,0.0,0.0,0.0,564,14136,8460,-5676
3535,0.0,0.0,0.0,564,14140,8460,-5680
3536,0.0,0.0,0.0,564,14144,8460,-5684
3537,0.0,0.0,0.0,564,14148,8460,-5688
3538,0.0,0.0,0.0,564,14152,8460,-5692
3539,0.0,0.0,0.0,564,14156,8460,-5696
3540,0.0,0.0,0.0,564,14160,8460,-5700
3541,1.0,1.0,1.0,565,14164,8475,-5689
3542,0.0,0.0,0.0,565,14168,8475,-5693
3543,0.0,0.0,0.0,565,14172,8475,-5697
3544,0.0,0.0,0.0,565,14176,8475,-5701
3545,0.0,0.0,0.0,565,14180,8475,-5705
3546,0.0,0.0,0.0,565,14184,8475,-5709
3547,0.0,0.0,0.0,565,14188,8475,-5713
3548,0.0,0.0,0.0,565,14192,8475,-5717
3549,0.0,0.0,0.0,565,14196,8475,-5721
3550,0.0,0.0,0.0,565,14200,8475,-5725
3551,0.0,0.0,0.0,565,14204,8475,-5729
3552,1.0,1.0,1.0,566,14208,8490,-5718
3553,0.0,0.0,0.0,566,14212,8490,-5722
3554,0.0,0.0,0.0,566,14216,8490,-5726
3555,0.0,0.0,0.0,566,14220,8490,-5730
3556,1.0,1.0,1.0,567,14224,8505,-5719
3557,0.0,0.0,0.0,567,14228,8505,-5723
3558,0.0,0.0,0.0,567,14232,8505,-5727
3559,0.0,0.0,0.0,567,14236,8505,-5731
3560,0.0,0.0,0.25,567,14240,8505,-5735
3561,0.0,0.0,0.0,567,14244,8505,-5739
3562,0.0,0.0,0.0,567,14248,8505,-5743
3563,0.0,0.0,0.0,567,14252,8505,-5747
3564,0.0,0.0,0.0,567,14256,8505,-5751
3565,1.0,1.0,0.6666666666666666,568,14260,8520,-5740
3566,0.0,1.0,0.6,568,14264,8520,-5744
3567,0.0,0.0,0.0,568,14268,8520,-5748
3568,0.0,0.0,0.0,568,14272,8520,-5752
3569,0.0,0.0,0.0,568,14276,8520,-5756
3570,0.0,0.0,0.0,568,14280,8520,-5760
3571,0.0,0.0,0.0,568,14284,8520,-5764
3572,0.0,0.0,0.0,568,14288,8520,-5768
3573,0.0,0.0,0.0,568,14292,8520,-5772
3574,0.0,0.0,0.0,568,14296,8520,-5776
3575,0.0,0.0,0.0,568,14300,8520,-5780
3576,0.0,0.0,0.0,568,14304,8520,-5784
3577,0.0,0.0,0.0,568,14308,8520,-5788
3578,0.0,0.0,0.0,568,14312,8520,-5792
3579,0.0,0.0,0.0,568,14316,8520,-5796
3580,0.0,0.0,0.0,568,14320,8520,-5800
3581,0.0,0.0,0.0,568,14324,8520,-5804
3582,0.0,0.0,0.0,568,14328,8520,-5808
3583,1.0,0.0,0.3333333333333333,569,14332,8535,-5797
3584,0.0,0.0,0.0,569,14336,8535,-5801
3585,0.0,0.0,0.0,569,14340,8535,-5805
3586,1.0,1.0,1.0,570,14344,8550,-5794
3587,1.0,1.0,1.0,571,14348,8565,-5783
3588,1.0,1.0,0.6666666666666666,572,14352,8580,-5772
3589,0.0,0.0,0.0,572,14356,8580,-5776
3590,0.0,0.0,0.0,572,14360,8580,-5780
3591,0.0,0.0,0.0,572,14364,8580,-5784
3592,0.0,0.0,0.5,572,14368,8580,-5788
3593,1.0,1.0,1.0,573,14372,8595,-5777
3594,0.0,0.0,0.0,573,14376,8595,-5781
3595,0.0,0.0,0.0,573,14380,8595,-5785
3596,0.0,0.0,0.0,573,14384,8595,-5789
3597,0.0,0.0,0.0,573,14388,8595,-5793
3598,0.0,0.0,0.0,573,14392,8595,-5797
3599,0.0,0.0,0.0,573,14396,8595,-5801
3600,1.0,1.0,1.0,574,14400,8610,-5790
3601,0.0,0.0,0.0,574,14404,8610,-5794
3602,0.0,0.0,0.0,574,14408,8610,-5798
3603,0.0,0.0,0.0,574,14412,8610,-5802
3604,0.0,0.0,0.0,574,14416,8610,-5806
3605,0.0,0.0,0.0,574,14420,8610,-5810
3606,1.0,1.0,1.0,575,14424,8625,-5799
3607,0.0,0.0,0.0,575,14428,8625,-5803
3608,0.0,0.0,0.0,575,14432,8625,-5807
3609,0.0,0.0,0.0,575,14436,8625,-5811
3610,0.0,0.0,0.0,575,14440,8625,-5815
3611,0.0,0.0,0.0,575,14444,8625,-5819
3612,0.0,0.0,0.0,575,14448,8625,-5823
3613,0.0,0.0,0.0,575,14452,8625,-5827
3614,0.0,0.0,0.0,575,14456,8625,-5831
3615,0.0,0.0,0.0,575,14460,8625,-5835
3616,1.0,1.0,1.0,576,14464,8640,-5824
3617,0.0,0.0,0.2,576,14468,8640,-5828
3618,0.0,0.0,0.0,576,14472,8640,-5832
3619,0.0,0.0,0.0,576,14476,8640,-5836
3620,0.0,0.0,0.0,576,14480,8640,-5840
3621,0.0,1.0,0.6666666666666666,576,14484,8640,-5844
3622,0.0,0.0,0.0,576,14488,8640,-5848
3623,0.0,0.0,0.0,576,14492,8640,-5852
3624,1.0,1.0,1.0,577,14496,8655,-5841
3625,0.0,0.0,0.0,577,14500,8655,-5845
3626,0.0,0.0,0.0,577,14504,8655,-5849
3627,1.0,1.0,1.0,578,14508,8670,-5838
3628,1.0,0.0,0.3333333333333333,579,14512,8685,-5827
3629,0.0,0.0,0.0,579,14516,8685,-5831
3630,1.0,1.0,1.0,580,14520,8700,-5820
3631,0.0,0.0,0.0,580,14524,8700,-5824
3632,0.0,0.0,0.0,580,14528,8700,-5828
3633,0.0,0.0,0.0,580,14532,8700,-5832
3634,0.0,0.0,0.0,580,14536,8700,-5836
3635,0.0,0.0,0.0,580,14540,8700,-5840
3636,0.0,0.0,0.0,580,14544,8700,-5844
3637,0.0,0.0,0.0,580,14548,8700,-5848
3638,0.0,0.0,0.0,580,14552,8700,-5852
3639,0.0,0.0,0.0,580,14556,8700,-5856
3640,0.0,0.0,0.0,580,14560,8700,-5860
3641,0.0,0.0,0.0,580,14564,8700,-5864
3642,0.0,0.0,0.0,580,14568,8700,-5868
3643,0.0,0.0,0.0,580,14572,8700,-5872
3644,1.0,1.0,1.0,581,14576,8715,-5861
3645,1.0,1.0,1.0,582,14580,8730,-5850
3646,0.0,0.0,0.0,582,14584,8730,-5854
3647,0.0,0.0,0.0,582,14588,8730,-5858
3648,0.0,0.0,0.0,582,14592,8730,-5862
3649,0.0,0.0,0.3333333333333333,582,14596,8730,-5866
3650,1.0,1.0,1.0,583,14600,8745,-5855
3651,0.0,0.0,0.0,583,14604,8745,-5859
3652,0.0,0.0,0.0,583,14608,8745,-5863
3653,0.0,0.0,0.0,583,14612,8745,-5867
3654,0.0,0.0,0.0,583,14616,8745,-5871
3655,0.0,0.0,0.0,583,14620,8745,-5875
3656,0.0,0.0,0.0,583,14624,8745,-5879
3657,0.0,0.0,0.0,583,14628,8745,-5883
3658,0.0,0.0,0.0,583,14632,8745,-5887
3659,0.0,0.0,0.0,583,14636,8745,-5891
3660,0.0,0.0,0.0,583,14640,8745,-5895
3661,0.0,0.0,0.0,583,14644,8745,-5899
3662,0.0,0.0,0.0,583,14648,8745,-5903
3663,0.0,0.0,0.0,583,14652,8745,-5907
3664,0.0,0.0,0.0,583,14656,8745,-5911
3665,1.0,1.0,1.0,584,14660,8760,-5900
3666,0.0,0.0,0.0,584,14664,8760,-5904
3667,0.0,0.0,0.0,584,14668,8760,-5908
3668,0.0,0.0,0.0,584,14672,8760,-5912
3669,0.0,0.0,0.0,584,14676,8760,-5916
3670,0.0,0.0,0.0,584,14680,8760,-5920
3671,0.0,0.0,0.0,584,14684,8760,-5924
3672,1.0,1.0,1.0,585,14688,8775,-5913
3673,1.0,1.0,1.0,586,14692,8790,-5902
3674,0.0,1.0,0.75,586,14696,8790,-5906
3675,0.0,0.0,0.0,586,14700,8790,-5910
3676,0.0,0.0,0.0,586,14704,8790,-5914
3677,0.0,0.0,0.0,586,14708,8790,-5918
3678,0.0,0.0,0.0,586,14712,8790,-5922
3679,0.0,0.0,0.0,586,14716,8790,-5926
3680,0.0,0.0,0.0,586,14720,8790,-5930
3681,0.0,0.0,0.0,586,14724,8790,-5934
3682,0.0,0.0,0.0,586,14728,8790,-5938
3683,0.0,0.0,0.0,586,14732,8790,-5942
3684,0.0,0.0,0.0,586,14736,8790,-5946
3685,1.0,1.0,0.6666666666666666,587,14740,8805,-5935
3686,0.0,0.0,0.0,587,14744,8805,-5939
3687,0.0,0.0,0.0,587,14748,8805,-5943
3688,0.0,0.0,0.0,587,14752,8805,-5947
3689,0.0,0.0,0.0,587,14756,8805,-5951
3690,0.0,0.0,0.0,587,14760,8805,-5955
3691,0.0,0.0,0.0,587,14764,8805,-5959
3692,0.0,0.0,0.0,587,14768,8805,-5963
3693,0.0,0.0,0.0,587,14772,8805,-5967
3694,0.0,0.0,0.3333333333333333,587,14776,8805,-5971
3695,0.0,0.0,0.0,587,14780,8805,-5975
3696,0.0,0.0,0.0,587,14784,8805,-5979
3697,0.0,0.0,0.0,587,14788,8805,-5983
3698,0.0,0.0,0.0,587,14792,8805,-5987
3699,0.0,0.0,0.25,587,14796,8805,-5991
3700,1.0,1.0,1.0,588,14800,8820,-5980
3701,0.0,0.0,0.0,588,14804,8820,-5984
3702,1.0,0.0,0.4,589,14808,8835,-5973
3703,0.0,0.0,0.0,589,14812,8835,-5977
3704,0.0,0.0,0.0,589,14816,8835,-5981
3705,0.0,0.0,0.0,589,14820,8835,-5985
3706,1.0,1.0,1.0,590,14824,8850,-5974
3707,0.0,0.0,0.0,590,14828,8850,-5978
3708,0.0,0.0,0.0,590,14832,8850,-5982
3709,0.0,0.0,0.0,590,14836,8850,-5986
3710,0.0,0.0,0.0,590,14840,8850,-5990
3711,0.0,0.0,0.0,590,14844,8850,-5994
3712,0.0,0.0,0.0,590,14848,8850,-5998
3713,1.0,1.0,1.0,591,14852,8865,-5987
3714,0.0,0.0,0.3333333333333333,591,14856,8865,-5991
3715,0.0,0.0,0.0,591,14860,8865,-5995
3716,1.0,1.0,1.0,592,14864,8880,-5984
3717,0.0,0.0,0.0,592,14868,8880,-5988
3718,1.0,1.0,1.0,593,14872,8895,-5977
3719,0.0,0.0,0.0,593,14876,8895,-5981
3720,1.0,1.0,1.0,594,14880,8910,-5970
3721,0.0,0.0,0.0,594,14884,8910,-5974
3722,0.0,0.0,0.0,594,14888,8910,-5978
3723,0.0,0.0,0.0,594,14892,8910,-5982
3724,0.0,0.0,0.0,594,14896,8910,-5986
3725,0.0,0.0,0.0,594,14900,8910,-5990
3726,0.0,0.0,0.0,594,14904,8910,-5994
3727,1.0,1.0,0.6,595,14908,8925,-5983
3728,0.0,0.0,0.0,595,14912,8925,-5987
3729,0.0,0.0,0.0,595,14916,8925,-5991
3730,0.0,0.0,0.0,595,14920,8925,-5995
3731,0.0,0.0,0.0,595,14924,8925,-5999
3732,0.0,0.0,0.0,595,14928,8925,-6003
3733,1.0,1.0,1.0,596,14932,8940,-5992
3734,1.0,1.0,1.0,597,14936,8955,-5981
3735,1.0,0.0,0.3333333333333333,598,14940,8970,-5970
3736,0.0,0.0,0.0,598,14944,8970,-5974
3737,1.0,1.0,1.0,599,14948,8985,-5963
3738,0.0,0.0,0.0,599,14952,8985,-5967
3739,1.0,1.0,1.0,600,14956,9000,-5956
3740,1.0,0.0,0.3333333333333333,601,14960,9015,-5945
3741,0.0,0.0,0.0,601,14964,9015,-5949
3742,0.0,0.0,0.0,601,14968,9015,-5953
3743,0.0,0.0,0.0,601,14972,9015,-5957
3744,0.0,0.0,0.0,601,14976,9015,-5961
3745,1.0,1.0,1.0,602,14980,9030,-5950
3746,0.0,0.0,0.0,602,14984,9030,-5954
3747,0.0,0.0,0.0,602,14988,9030,-5958
3748,0.0,0.0,0.0,602,14992,9030,-5962
3749,0.0,0.0,0.0,602,14996,9030,-5966
3750,0.0,0.0,0.0,602,15000,9030,-5970
3751,0.0,0.0,0.0,602,15004,9030,-5974
3752,0.0,0.0,0.0,602,15008,9030,-5978
3753,0.0,0.0,0.0,602,15012,9030,-5982
3754,0.0,0.0,0.0,602,15016,9030,-5986
3755,1.0,1.0,1.0,603,15020,9045,-5975
3756,0.0,0.0,0.0,603,15024,9045,-5979
3757,0.0,0.0,0.0,603,15028,9045,-5983
3758,0.0,0.0,0.0,603,15032,9045,-5987
3759,0.0,0.0,0.0,603,15036,9045,-5991
3760,0.0,0.0,0.0,603,15040,9045,-5995
3761,0.0,0.0,0.0,603,15044,9045,-5999
3762,0.0,0.0,0.0,603,15048,9045,-6003
3763,0.0,0.0,0.0,603,15052,9045,-6007
3764,0.0,0.0,0.0,603,15056,9045,-6011
3765,0.0,0.0,0.0,603,15060,9045,-6015
3766,0.0,0.0,0.0,603,15064,9045,-6019
3767,0.0,0.0,0.0,603,15068,9045,-6023
3768,0.0,0.0,0.0,603,15072,9045,-6027
3769,0.0,0.0,0.0,603,15076,9045,-6031
3770,0.0,0.0,0.0,603,15080,9045,-6035
3771,0.0,0.0,0.0,603,15084,9045,-6039
3772,0.0,0.0,0.0,603,15088,9045,-6043
3773,0.0,0.0,0.0,603,15092,9045,-6047
3774,0.0,0.0,0.0,603,15096,9045,-6051
3775,0.0,0.0,0.0,603,15100,9045,-6055
3776,0.0,0.0,0.0,603,15104,9045,-6059
3777,0.0,0.0,0.0,603,15108,9045,-6063
3778,0.0,0.0,0.0,603,15112,9045,-6067
3779,0.0,0.0,0.0,603,15116,9045,-6071
3780,0.0,0.0,0.0,603,15120,9045,-6075
3781,0.0,0.0,0.0,603,15124,9045,-6079
3782,0.0,0.0,0.0,603,15128,9045,-6083
3783,0.0,0.0,0.0,603,15132,9045,-6087
3784,0.0,0.0,0.0,603,15136,9045,-6091
3785,0.0,0.0,0.0,603,15140,9045,-6095
3786,0.0,0.0,0.0,603,15144,9045,-6099
3787,1.0,1.0,1.0,604,15148,9060,-6088
3788,0.0,0.0,0.0,604,15152,9060,-6092
3789,0.0,0.0,0.0,604,15156,9060,-6096
3790,0.0,0.0,0.0,604,15160,9060,-6100
3791,0.0,0.0,0.0,604,15164,9060,-6104
3792,0.0,0.0,0.0,604,15168,9060,-6108
3793,0.0,0.0,0.0,604,15172,9060,-6112
3794,0.0,0.0,0.0,604,15176,9060,-6116
3795,0.0,1.0,0.6666666666666666,604,15180,9060,-6120
3796,0.0,0.0,0.0,604,15184,9060,-6124
3797,0.0,1.0,0.6666666666666666,604,15188,9060,-6128
3798,1.0,1.0,1.0,605,15192,9075,-6117
3799,1.0,1.0,1.0,606,15196,9090,-6106
3800,0.0,0.0,0.0,606,15200,9090,-6110
3801,0.0,0.0,0.0,606,15204,9090,-6114
3802,0.0,0.0,0.0,606,15208,9090,-6118
3803,0.0,0.0,0.0,606,15212,9090,-6122
3804,1.0,1.0,1.0,607,15216,9105,-6111
3805,0.0,0.0,0.0,607,15220,9105,-6115
3806,0.0,0.0,0.0,607,15224,9105,-6119
3807,0.0,0.0,0.0,607,15228,9105,-6123
3808,1.0,1.0,1.0,608,15232,9120,-6112
3809,0.0,0.0,0.0,608,15236,9120,-6116
3810,0.0,0.0,0.0,608,15240,9120,-6120
3811,0.0,0.0,0.0,608,15244,9120,-6124
3812,0.0,0.0,0.0,608,15248,9120,-6128
3813,0.0,0.0,0.0,608,15252,9120,-6132
3814,0.0,0.0,0.0,608,15256,9120,-6136
3815,0.0,0.0,0.0,608,15260,9120,-6140
3816,0.0,0.0,0.0,608,15264,9120,-6144
3817,0.0,0.0,0.0,608,15268,9120,-6148
3818,1.0,0.0,0.4,609,15272,9135,-6137
3819,0.0,0.0,0.0,609,15276,9135,-6141
3820,0.0,0.0,0.0,609,15280,9135,-6145
3821,0.0,0.0,0.0,609,15284,9135,-6149
3822,0.0,0.0,0.0,609,15288,9135,-6153
3823,0.0,0.0,0.0,609,15292,9135,-6157
3824,1.0,1.0,1.0,610,15296,9150,-6146
3825,1.0,1.0,1.0,611,15300,9165,-6135
3826,0.0,0.0,0.0,611,15304,9165,-6139
3827,0.0,0.0,0.0,611,15308,9165,-6143
3828,0.0,0.0,0.0,611,15312,9165,-6147
3829,0.0,0.0,0.0,611,15316,9165,-6151
3830,0.0,0.0,0.3333333333333333,611,15320,9165,-6155
3831,0.0,0.0,0.0,611,15324,9165,-6159
3832,0.0,0.0,0.0,611,15328,9165,-6163
3833,1.0,1.0,1.0,612,15332,9180,-6152
3834,0.0,0.0,0.0,612,15336,9180,-6156
3835,1.0,1.0,1.0,613,15340,9195,-6145
3836,1.0,1.0,0.6666666666666666,614,15344,9210,-6134
3837,1.0,1.0,1.0,615,15348,9225,-6123
3838,0.0,0.0,0.0,615,15352,9225,-6127
3839,0.0,0.0,0.0,615,15356,9225,-6131
3840,0.0,0.0,0.0,615,15360,9225,-6135
3841,0.0,0.0,0.0,615,15364,9225,-6139
3842,0.0,0.0,0.0,615,15368,9225,-6143
3843,1.0,1.0,1.0,616,15372,9240,-6132
3844,0.0,0.0,0.25,616,15376,9240,-6136
3845,0.0,0.0,0.0,616,15380,9240,-6140
3846,1.0,1.0,1.0,617,15384,9255,-6129
3847,0.0,0.0,0.0,617,15388,9255,-6133
3848,1.0,1.0,0.6666666666666666,618,15392,9270,-6122
3849,0.0,0.0,0.0,618,15396,9270,-6126
3850,1.0,1.0,1.0,619,15400,9285,-6115
3851,0.0,0.0,0.3333333333333333,619,15404,9285,-6119
3852,0.0,0.0,0.0,619,15408,9285,-6123
3853,0.0,0.0,0.0,619,15412,9285,-6127
3854,0.0,0.0,0.0,619,15416,9285,-6131
3855,0.0,0.0,0.0,619,15420,9285,-6135
3856,1.0,1.0,1.0,620,15424,9300,-6124
3857,0.0,0.0,0.3333333333333333,620,15428,9300,-6128
3858,0.0,0.0,0.0,620,15432,9300,-6132
3859,0.0,0.0,0.0,620,15436,9300,-6136
3860,0.0,0.0,0.0,620,15440,9300,-6140
3861,0.0,0.0,0.0,620,15444,9300,-6144
3862,0.0,0.0,0.0,620,15448,9300,-6148
3863,0.0,0.0,0.0,620,15452,9300,-6152
3864,0.0,0.0,0.0,620,15456,9300,-6156
3865,0.0,0.0,0.0,620,15460,9300,-6160
3866,1.0,1.0,1.0,621,15464,9315,-6149
3867,0.0,0.0,0.0,621,15468,9315,-6153
3868,0.0,0.0,0.0,621,15472,9315,-6157
3869,1.0,1.0,1.0,622,15476,9330,-6146
3870,0.0,0.0,0.0,622,15480,9330,-6150
3871,0.0,0.0,0.0,622,15484,9330,-6154
3872,0.0,0.0,0.0,622,15488,9330,-6158
3873,0.0,0.0,0.0,622,15492,9330,-6162
3874,0.0,0.0,0.0,622,15496,9330,-6166
3875,0.0,0.0,0.0,622,15500,9330,-6170
3876,0.0,0.0,0.0,622,15504,9330,-6174
3877,0.0,0.0,0.0,622,15508,9330,-6178
3878,0.0,0.0,0.0,622,15512,9330,-6182
3879,0.0,0.0,0.0,622,15516,9330,-6186
3880,0.0,0.0,0.0,622,15520,9330,-6190
3881,0.0,0.0,0.0,622,15524,9330,-6194
3882,0.0,0.0,0.0,622,15528,9330,-6198
3883,0.0,0.0,0.0,622,15532,9330,-6202
3884,0.0,0.0,0.0,622,15536,9330,-6206
3885,0.0,0.0,0.0,622,15540,9330,-6210
3886,0.0,0.0,0.0,622,15544,9330,-6214
3887,0.0,0.0,0.0,622,15548,9330,-6218
3888,1.0,1.0,1.0,623,15552,9345,-6207
3889,0.0,0.0,0.0,623,15556,9345,-6211
3890,0.0,0.0,0.0,623,15560,9345,-6215
3891,0.0,0.0,0.0,623,15564,9345,-6219
3892,0.0,0.0,0.0,623,15568,9345,-6223
3893,0.0,0.0,0.0,623,15572,9345,-6227
3894,0.0,0.0,0.0,623,15576,9345,-6231
3895,0.0,0.0,0.0,623,15580,9345,-6235
3896,0.0,0.0,0.0,623,15584,9345,-6239
3897,0.0,0.0,0.0,623,15588,9345,-6243
3898,1.0,1.0,1.0,624,15592,9360,-6232
3899,0.0,0.0,0.0,624,15596,9360,-6236
3900,0.0,0.0,0.0,624,15600,9360,-6240
3901,0.0,0.0,0.0,624,15604,9360,-6244
3902,0.0,0.0,0.0,624,15608,9360,-6248
3903,0.0,0.0,0.0,624,15612,9360,-6252
3904,0.0,0.0,0.0,624,15616,9360,-6256
3905,0.0,0.0,0.0,624,15620,9360,-6260
3906,0.0,0.0,0.0,624,15624,9360,-6264
3907,0.0,0.0,0.0,624,15628,9360,-6268
3908,0.0,0.0,0.0,624,15632,9360,-6272
3909,0.0,0.0,0.0,624,15636,9360,-6276
3910,0.0,0.0,0.0,624,15640,9360,-6280
3911,0.0,0.0,0.0,624,15644,9360,-6284
3912,0.0,0.0,0.0,624,15648,9360,-6288
3913,0.0,0.0,0.0,624,15652,9360,-6292
3914,0.0,0.0,0.0,624,15656,9360,-6296
3915,0.0,0.0,0.0,624,15660,9360,-6300
3916,0.0,0.0,0.0,624,15664,9360,-6304
3917,0.0,0.0,0.0,624,15668,9360,-6308
3918,1.0,1.0,1.0,625,15672,9375,-6297
3919,0.0,0.0,0.0,625,15676,9375,-6301
3920,0.0,0.0,0.0,625,15680,9375,-6305
3921,0.0,0.0,0.0,625,15684,9375,-6309
3922,0.0,0.0,0.0,625,15688,9375,-6313
3923,0.0,0.0,0.0,625,15692,9375,-6317
3924,0.0,0.0,0.0,625,15696,9375,-6321
3925,1.0,1.0,1.0,626,15700,9390,-6310
3926,0.0,0.0,0.0,626,15704,9390,-6314
3927,1.0,1.0,1.0,627,15708,9405,-6303
3928,1.0,1.0,1.0,628,15712,9420,-6292
3929,0.0,0.0,0.0,628,15716,9420,-6296
3930,0.0,0.0,0.0,628,15720,9420,-6300
3931,1.0,1.0,1.0,629,15724,9435,-6289
3932,0.0,0.0,0.0,629,15728,9435,-6293
3933,0.0,0.0,0.0,629,15732,9435,-6297
3934,1.0,1.0,1.0,630,15736,9450,-6286
3935,1.0,0.0,0.3333333333333333,631,15740,9465,-6275
3936,0.0,0.0,0.0,631,15744,9465,-6279
3937,1.0,1.0,0.6666666666666666,632,15748,9480,-6268
3938,0.0,0.0,0.0,632,15752,9480,-6272
3939,0.0,0.0,0.0,632,15756,9480,-6276
3940,0.0,0.0,0.25,632,15760,9480,-6280
3941,1.0,1.0,1.0,633,15764,9495,-6269
3942,0.0,0.0,0.0,633,15768,9495,-6273
3943,0.0,0.0,0.0,633,15772,9495,-6277
3944,0.0,0.0,0.0,633,15776,9495,-6281
3945,0.0,0.0,0.0,633,15780,9495,-6285
3946,0.0,0.0,0.0,633,15784,9495,-6289
3947,0.0,0.0,0.0,633,15788,9495,-6293
3948,0.0,0.0,0.0,633,15792,9495,-6297
3949,1.0,1.0,1.0,634,15796,9510,-6286
3950,0.0,0.0,0.0,634,15800,9510,-6290
3951,0.0,0.0,0.0,634,15804,9510,-6294
3952,0.0,1.0,0.6666666666666666,634,15808,9510,-6298
3953,0.0,0.0,0.0,634,15812,9510,-6302
3954,0.0,0.0,0.0,634,15816,9510,-6306
3955,0.0,0.0,0.0,634,15820,9510,-6310
3956,0.0,0.0,0.0,634,15824,9510,-6314
3957,0.0,0.0,0.0,634,15828,9510,-6318
3958,0.0,0.0,0.0,634,15832,9510,-6322
3959,0.0,0.0,0.0,634,15836,9510,-6326
3960,0.0,0.0,0.0,634,15840,9510,-6330
3961,0.0,0.0,0.0,634,15844,9510,-6334
3962,0.0,0.0,0.0,634,15848,9510,-6338
3963,0.0,0.0,0.0,634,15852,9510,-6342
3964,0.0,0.0,0.0,634,15856,9510,-6346
3965,0.0,0.0,0.0,634,15860,9510,-6350
3966,0.0,0.0,0.0,634,15864,9510,-6354
3967,0.0,0.0,0.0,634,15868,9510,-6358
3968,0.0,0.0,0.25,634,15872,9510,-6362
3969,1.0,1.0,1.0,635,15876,9525,-6351
3970,0.0,0.0,0.0,635,15880,9525,-6355
3971,0.0,0.0,0.0,635,15884,9525,-6359
3972,0.0,0.0,0.0,635,15888,9525,-6363
3973,1.0,1.0,1.0,636,15892,9540,-6352
3974,0.0,0.0,0.25,636,15896,9540,-6356
3975,0.0,0.0,0.0,636,15900,9540,-6360
3976,0.0,0.0,0.0,636,15904,9540,-6364
3977,1.0,1.0,1.0,637,15908,9555,-6353
3978,0.0,0.0,0.0,637,15912,9555,-6357
3979,0.0,0.0,0.0,637,15916,9555,-6361
3980,0.0,0.0,0.0,637,15920,9555,-6365
3981,0.0,0.0,0.0,637,15924,9555,-6369
3982,0.0,0.0,0.0,637,15928,9555,-6373
3983,0.0,0.0,0.0,637,15932,9555,-6377
3984,0.0,0.0,0.0,637,15936,9555,-6381
3985,0.0,0.0,0.0,637,15940,9555,-6385
3986,0.0,0.0,0.0,637,15944,9555,-6389
3987,0.0,0.0,0.0,637,15948,9555,-6393
3988,0.0,0.0,0.0,637,15952,9555,-6397
3989,0.0,0.0,0.0,637,15956,9555,-6401
3990,0.0,0.0,0.0,637,15960,9555,-6405
3991,0.0,0.0,0.0,637,15964,9555,-6409
3992,0.0,0.0,0.0,637,15968,9555,-6413
3993,0.0,0.0,0.0,637,15972,9555,-6417
3994,1.0,1.0,1.0,638,15976,9570,-6406
3995,0.0,0.0,0.0,638,15980,9570,-6410
3996,0.0,0.0,0.0,638,15984,9570,-6414
3997,0.0,0.0,0.0,638,15988,9570,-6418
3998,0.0,0.0,0.0,638,15992,9570,-6422
3999,1.0,1.0,1.0,639,15996,9585,-6411
4000,0.0,0.0,0.0,639,16000,9585,-6415
4001,0.0,0.0,0.0,639,16004,9585,-6419
4002,0.0,0.0,0.3333333333333333,639,16008,9585,-6423
4003,1.0,0.0,0.4,640,16012,9600,-6412
4004,0.0,0.0,0.0,640,16016,9600,-6416
4005,0.0,0.0,0.0,640,16020,9600,-6420
4006,0.0,0.0,0.0,640,16024,9600,-6424
4007,1.0,1.0,1.0,641,16028,9615,-6413
4008,0.0,0.0,0.0,641,16032,9615,-6417
4009,0.0,0.0,0.3333333333333333,641,16036,9615,-6421
4010,0.0,0.0,0.0,641,16040,9615,-6425
4011,0.0,0.0,0.0,641,16044,9615,-6429
4012,0.0,0.0,0.0,641,16048,9615,-6433
4013,0.0,0.0,0.0,641,16052,9615,-6437
4014,0.0,1.0,0.6666666666666666,641,16056,9615,-6441
4015,0.0,0.0,0.0,641,16060,9615,-6445
4016,1.0,1.0,1.0,642,16064,9630,-6434
4017,0.0,0.0,0.0,642,16068,9630,-6438
4018,0.0,0.0,0.0,642,16072,9630,-6442
4019,0.0,0.0,0.0,642,16076,9630,-6446
4020,0.0,0.0,0.0,642,16080,9630,-6450
4021,1.0,1.0,1.0,643,16084,9645,-6439
4022,0.0,0.0,0.0,643,16088,9645,-6443
4023,0.0,0.0,0.0,643,16092,9645,-6447
4024,0.0,0.0,0.0,643,16096,9645,-6451
4025,0.0,0.0,0.0,643,16100,9645,-6455
4026,0.0,0.0,0.0,643,16104,9645,-6459
4027,1.0,1.0,1.0,644,16108,9660,-6448
4028,0.0,0.0,0.0,644,16112,9660,-6452
4029,0.0,1.0,0.75,644,16116,9660,-6456
4030,0.0,0.0,0.0,644,16120,9660,-6460
4031,0.0,0.0,0.0,644,16124,9660,-6464
4032,0.0,0.0,0.0,644,16128,9660,-6468
4033,0.0,0.0,0.0,644,16132,9660,-6472
4034,0.0,0.0,0.0,644,16136,9660,-6476
4035,0.0,0.0,0.0,644,16140,9660,-6480
4036,0.0,0.0,0.0,644,16144,9660,-6484
4037,0.0,0.0,0.0,644,16148,9660,-6488
4038,0.0,0.0,0.0,644,16152,9660,-6492
4039,1.0,0.0,0.4,645,16156,9675,-6481
4040,0.0,0.0,0.0,645,16160,9675,-6485
4041,1.0,1.0,1.0,646,16164,9690,-6474
4042,0.0,0.0,0.0,646,16168,9690,-6478
4043,0.0,0.0,0.0,646,16172,9690,-6482
4044,0.0,0.0,0.0,646,16176,9690,-6486
4045,0.0,0.0,0.0,646,16180,9690,-6490
4046,1.0,1.0,1.0,647,16184,9705,-6479
4047,0.0,0.0,0.0,647,16188,9705,-6483
4048,0.0,0.0,0.0,647,16192,9705,-6487
4049,0.0,0.0,0.0,647,16196,9705,-6491
4050,0.0,0.0,0.3333333333333333,647,16200,9705,-6495
4051,1.0,1.0,1.0,648,16204,9720,-6484
4052,0.0,0.0,0.0,648,16208,9720,-6488
4053,0.0,0.0,0.0,648,16212,9720,-6492
4054,0.0,0.0,0.3333333333333333,648,16216,9720,-6496
4055,1.0,1.0,1.0,649,16220,9735,-6485
4056,1.0,1.0,1.0,650,16224,9750,-6474
4057,0.0,0.0,0.0,650,16228,9750,-6478
4058,0.0,0.0,0.0,650,16232,9750,-6482
4059,1.0,1.0,0.6,651,16236,9765,-6471
4060,0.0,0.0,0.0,651,16240,9765,-6475
4061,0.0,0.0,0.0,651,16244,9765,-6479
4062,0.0,0.0,0.0,651,16248,9765,-6483
4063,0.0,0.0,0.0,651,16252,9765,-6487
4064,1.0,1.0,1.0,652,16256,9780,-6476
4065,0.0,0.0,0.0,652,16260,9780,-6480
4066,0.0,0.0,0.0,652,16264,9780,-6484
4067,1.0,1.0,1.0,653,16268,9795,-6473
4068,0.0,0.0,0.0,653,16272,9795,-6477
4069,0.0,0.0,0.0,653,16276,9795,-6481
4070,0.0,0.0,0.0,653,16280,9795,-6485
4071,0.0,0.0,0.0,653,16284,9795,-6489
4072,0.0,0.0,0.0,653,16288,9795,-6493
4073,0.0,0.0,0.0,653,16292,9795,-6497
4074,0.0,0.0,0.0,653,16296,9795,-6501
4075,0.0,0.0,0.0,653,16300,9795,-6505
4076,0.0,0.0,0.0,653,16304,9795,-6509
4077,0.0,0.0,0.0,653,16308,9795,-6513
4078,0.0,0.0,0.0,653,16312,9795,-6517
4079,1.0,1.0,1.0,654,16316,9810,-6506
4080,0.0,0.0,0.0,654,16320,9810,-6510
4081,0.0,0.0,0.0,654,16324,9810,-6514
4082,0.0,0.0,0.0,654,16328,9810,-6518
4083,0.0,0.0,0.0,654,16332,9810,-6522
4084,0.0,0.0,0.0,654,16336,9810,-6526
4085,0.0,0.0,0.3333333333333333,654,16340,9810,-6530
4086,0.0,0.0,0.0,654,16344,9810,-6534
4087,0.0,0.0,0.0,654,16348,9810,-6538
4088,0.0,0.0,0.0,654,16352,9810,-6542
4089,0.0,0.0,0.0,654,16356,9810,-6546
4090,0.0,0.0,0.0,654,16360,9810,-6550
4091,0.0,0.0,0.0,654,16364,9810,-6554
4092,1.0,1.0,1.0,655,16368,9825,-6543
4093,0.0,0.0,0.0,655,16372,9825,-6547
4094,0.0,0.0,0.0,655,16376,9825,-6551
4095,0.0,0.0,0.0,655,16380,9825,-6555
4096,0.0,0.0,0.0,655,16384,9825,-6559
4097,0.0,0.0,0.0,655,16388,9825,-6563
4098,0.0,0.0,0.0,655,16392,9825,-6567
4099,1.0,1.0,1.0,656,16396,9840,-6556
4100,1.0,1.0,1.0,657,16400,9855,-6545
4101,0.0,0.0,0.0,657,16404,9855,-6549
4102,0.0,0.0,0.0,657,16408,9855,-6553
4103,0.0,0.0,0.0,657,16412,9855,-6557
4104,0.0,0.0,0.0,657,16416,9855,-6561
4105,0.0,0.0,0.0,657,16420,9855,-6565
4106,1.0,1.0,0.6666666666666666,658,16424,9870,-6554
4107,0.0,0.0,0.0,658,16428,9870,-6558
4108,0.0,0.0,0.0,658,16432,9870,-6562
4109,0.0,0.0,0.0,658,16436,9870,-6566
4110,0.0,0.0,0.0,658,16440,9870,-6570
4111,0.0,0.0,0.0,658,16444,9870,-6574
4112,0.0,0.0,0.0,658,16448,9870,-6578
4113,0.0,0.0,0.0,658,16452,9870,-6582
4114,0.0,0.0,0.0,658,16456,9870,-6586
4115,0.0,0.0,0.0,658,16460,9870,-6590
4116,0.0,0.0,0.0,658,16464,9870,-6594
4117,0.0,0.0,0.0,658,16468,9870,-6598
4118,0.0,0.0,0.0,658,16472,9870,-6602
4119,0.0,0.0,0.0,658,16476,9870,-6606
4120,0.0,0.0,0.0,658,16480,9870,-6610
4121,1.0,1.0,1.0,659,16484,9885,-6599
4122,0.0,0.0,0.0,659,16488,9885,-6603
4123,0.0,0.0,0.0,659,16492,9885,-6607
4124,0.0,0.0,0.0,659,16496,9885,-6611
4125,0.0,0.0,0.0,659,16500,9885,-6615
4126,0.0,0.0,0.0,659,16504,9885,-6619
4127,0.0,0.0,0.0,659,16508,9885,-6623
4128,0.0,0.0,0.0,659,16512,9885,-6627
4129,0.0,0.0,0.0,659,16516,9885,-6631
4130,0.0,0.0,0.0,659,16520,9885,-6635
4131,0.0,0.0,0.0,659,16524,9885,-6639
4132,0.0,0.0,0.0,659,16528,9885,-6643
4133,0.0,1.0,0.6666666666666666,659,16532,9885,-6647
4134,0.0,0.0,0.0,659,16536,9885,-6651
4135,0.0,0.0,0.0,659,16540,9885,-6655
4136,0.0,0.0,0.0,659,16544,9885,-6659
4137,0.0,0.0,0.0,659,16548,9885,-6663
4138,1.0,1.0,1.0,660,16552,9900,-6652
4139,0.0,0.0,0.0,660,16556,9900,-6656
4140,0.0,0.0,0.0,660,16560,9900,-6660
4141,1.0,1.0,1.0,661,16564,9915,-6649
4142,0.0,0.0,0.0,661,16568,9915,-6653
4143,1.0,1.0,1.0,662,16572,9930,-6642
4144,0.0,0.0,0.0,662,16576,9930,-6646
4145,0.0,0.0,0.0,662,16580,9930,-6650
4146,0.0,0.0,0.0,662,16584,9930,-6654
4147,1.0,1.0,1.0,663,16588,9945,-6643
4148,0.0,0.0,0.0,663,16592,9945,-6647
4149,0.0,0.0,0.25,663,16596,9945,-6651
4150,0.0,0.0,0.0,663,16600,9945,-6655
4151,0.0,0.0,0.0,663,16604,9945,-6659
4152,1.0,1.0,1.0,664,16608,9960,-6648
4153,0.0,0.0,0.0,664,16612,9960,-6652
4154,0.0,0.0,0.0,664,16616,9960,-6656
4155,0.0,0.0,0.0,664,16620,9960,-6660
4156,0.0,0.0,0.0,664,16624,9960,-6664
4157,0.0,0.0,0.0,664,16628,9960,-6668
4158,1.0,1.0,1.0,665,16632,9975,-6657
4159,0.0,0.0,0.0,665,16636,9975,-6661
4160,0.0,0.0,0.0,665,16640,9975,-6665
4161,1.0,1.0,1.0,666,16644,9990,-6654
4162,0.0,0.0,0.0,666,16648,9990,-6658
4163,0.0,0.0,0.0,666,16652,9990,-6662
4164,0.0,0.0,0.0,666,16656,9990,-6666
4165,0.0,0.0,0.3333333333333333,666,16660,9990,-6670
4166,1.0,1.0,0.6666666666666666,667,16664,10005,-6659
4167,0.0,0.0,0.0,667,16668,10005,-6663
4168,0.0,0.0,0.0,667,16672,10005,-6667
4169,0.0,0.0,0.0,667,16676,10005,-6671
4170,0.0,0.0,0.0,667,16680,10005,-6675
4171,1.0,1.0,1.0,668,16684,10020,-6664
4172,1.0,1.0,0.6666666666666666,669,16688,10035,-6653
4173,0.0,0.0,0.0,669,16692,10035,-6657
4174,0.0,0.0,0.0,669,16696,10035,-6661
4175,0.0,0.0,0.0,669,16700,10035,-6665
4176,0.0,0.0,0.0,669,16704,10035,-6669
4177,0.0,0.0,0.0,669,16708,10035,-6673
4178,0.0,0.0,0.0,669,16712,10035,-6677
4179,0.0,0.0,0.0,669,16716,10035,-6681
4180,0.0,0.0,0.0,669,16720,10035,-6685
4181,0.0,0.0,0.0,669,16724,10035,-6689
4182,0.0,0.0,0.0,669,16728,10035,-6693
4183,0.0,0.0,0.0,669,16732,10035,-6697
4184,0.0,0.0,0.0,669,16736,10035,-6701
4185,0.0,0.0,0.0,669,16740,10035,-6705
4186,0.0,0.0,0.0,669,16744,10035,-6709
4187,0.0,0.0,0.0,669,16748,10035,-6713
4188,0.0,0.0,0.0,669,16752,10035,-6717
4189,0.0,0.0,0.0,669,16756,10035,-6721
4190,0.0,0.0,0.0,669,16760,10035,-6725
4191,0.0,0.0,0.0,669,16764,10035,-6729
4192,0.0,0.0,0.0,669,16768,10035,-6733
4193,0.0,0.0,0.0,669,16772,10035,-6737
4194,0.0,0.0,0.0,669,16776,10035,-6741
4195,0.0,0.0,0.0,669,16780,10035,-6745
4196,0.0,0.0,0.0,669,16784,10035,-6749
4197,1.0,1.0,1.0,670,16788,10050,-6738
4198,0.0,0.0,0.0,670,16792,10050,-6742
4199,0.0,0.0,0.0,670,16796,10050,-6746
4200,1.0,1.0,0.6666666666666666,671,16800,10065,-6735
4201,0.0,0.0,0.0,671,16804,10065,-6739
4202,0.0,0.0,0.0,671,16808,10065,-6743
4203,0.0,0.0,0.0,671,16812,10065,-6747
4204,0.0,0.0,0.0,671,16816,10065,-6751
4205,0.0,0.0,0.0,671,16820,10065,-6755
4206,0.0,0.0,0.0,671,16824,10065,-6759
4207,0.0,0.0,0.0,671,16828,10065,-6763
4208,0.0,0.0,0.0,671,16832,10065,-6767
4209,0.0,0.0,0.0,671,16836,10065,-6771
4210,1.0,1.0,0.75,672,16840,10080,-6760
4211,0.0,0.0,0.0,672,16844,10080,-6764
4212,1.0,1.0,1.0,673,16848,10095,-6753
4213,0.0,0.0,0.0,673,16852,10095,-6757
4214,0.0,0.0,0.0,673,16856,10095,-6761
4215,0.0,0.0,0.0,673,16860,10095,-6765
4216,1.0,1.0,1.0,674,16864,10110,-6754
4217,0.0,0.0,0.0,674,16868,10110,-6758
4218,1.0,1.0,1.0,675,16872,10125,-6747
4219,0.0,0.0,0.3333333333333333,675,16876,10125,-6751
4220,0.0,0.0,0.0,675,16880,10125,-6755
4221,1.0,1.0,1.0,676,16884,10140,-6744
4222,0.0,0.0,0.0,676,16888,10140,-6748
4223,0.0,0.0,0.0,676,16892,10140,-6752
4224,0.0,0.0,0.0,676,16896,10140,-6756
4225,0.0,0.0,0.0,676,16900,10140,-6760
4226,0.0,0.0,0.0,676,16904,10140,-6764
4227,0.0,0.0,0.0,676,16908,10140,-6768
4228,0.0,0.0,0.0,676,16912,10140,-6772
4229,0.0,0.0,0.0,676,16916,10140,-6776
4230,0.0,0.0,0.0,676,16920,10140,-6780
4231,0.0,0.0,0.0,676,16924,10140,-6784
4232,0.0,0.0,0.0,676,16928,10140,-6788
4233,0.0,0.0,0.0,676,16932,10140,-6792
4234,0.0,0.0,0.0,676,16936,10140,-6796
4235,0.0,0.0,0.0,676,16940,10140,-6800
4236,0.0,0.0,0.0,676,16944,10140,-6804
4237,1.0,0.0,0.3333333333333333,677,16948,10155,-6793
4238,0.0,0.0,0.0,677,16952,10155,-6797
4239,1.0,0.0,0.3333333333333333,678,16956,10170,-6786
4240,0.0,0.0,0.0,678,16960,10170,-6790
4241,0.0,0.0,0.0,678,16964,10170,-6794
4242,0.0,0.0,0.0,678,16968,10170,-6798
4243,0.0,0.0,0.0,678,16972,10170,-6802
4244,1.0,1.0,1.0,679,16976,10185,-6791
4245,1.0,1.0,0.6,680,16980,10200,-6780
4246,0.0,0.0,0.0,680,16984,10200,-6784
4247,0.0,0.0,0.0,680,16988,10200,-6788
4248,0.0,0.0,0.0,680,16992,10200,-6792
4249,0.0,0.0,0.0,680,16996,10200,-6796
4250,0.0,0.0,0.0,680,17000,10200,-6800
4251,0.0,0.0,0.0,680,17004,10200,-6804
4252,0.0,0.0,0.0,680,17008,10200,-6808
4253,0.0,0.0,0.0,680,17012,10200,-6812
4254,0.0,0.0,0.0,680,17016,10200,-6816
4255,0.0,0.0,0.0,680,17020,10200,-6820
4256,0.0,0.0,0.0,680,17024,10200,-6824
4257,0.0,0.0,0.0,680,17028,10200,-6828
4258,0.0,0.0,0.0,680,17032,10200,-6832
4259,1.0,1.0,1.0,681,17036,10215,-6821
4260,0.0,0.0,0.0,681,17040,10215,-6825
4261,0.0,0.0,0.0,681,17044,10215,-6829
4262,1.0,1.0,0.75,682,17048,10230,-6818
4263,0.0,0.0,0.0,682,17052,10230,-6822
4264,0.0,0.0,0.0,682,17056,10230,-6826
4265,0.0,0.0,0.0,682,17060,10230,-6830
4266,0.0,0.0,0.0,682,17064,10230,-6834
4267,1.0,1.0,1.0,683,17068,10245,-6823
4268,0.0,0.0,0.0,683,17072,10245,-6827
4269,0.0,0.0,0.0,683,17076,10245,-6831
4270,0.0,0.0,0.0,683,17080,10245,-6835
4271,0.0,0.0,0.0,683,17084,10245,-6839
4272,0.0,0.0,0.0,683,17088,10245,-6843
4273,0.0,0.0,0.0,683,17092,10245,-6847
4274,0.0,0.0,0.0,683,17096,10245,-6851
4275,0.0,0.0,0.0,683,17100,10245,-6855
4276,0.0,0.0,0.0,683,17104,10245,-6859
4277,0.0,0.0,0.0,683,17108,10245,-6863
4278,0.0,0.0,0.0,683,17112,10245,-6867
4279,1.0,1.0,1.0,684,17116,10260,-6856
4280,1.0,1.0,1.0,685,17120,10275,-6845
4281,1.0,1.0,1.0,686,17124,10290,-6834
4282,0.0,0.0,0.0,686,17128,10290,-6838
4283,0.0,0.0,0.0,686,17132,10290,-6842
4284,0.0,0.0,0.0,686,17136,10290,-6846
4285,1.0,1.0,1.0,687,17140,10305,-6835
4286,0.0,0.0,0.0,687,17144,10305,-6839
4287,0.0,0.0,0.0,687,17148,10305,-6843
4288,1.0,1.0,0.75,688,17152,10320,-6832
4289,0.0,0.0,0.0,688,17156,10320,-6836
4290,0.0,0.0,0.0,688,17160,10320,-6840
4291,1.0,1.0,1.0,689,17164,10335,-6829
4292,1.0,1.0,1.0,690,17168,10350,-6818
4293,0.0,0.0,0.0,690,17172,10350,-6822
4294,1.0,1.0,1.0,691,17176,10365,-6811
4295,0.0,0.0,0.0,691,17180,10365,-6815
4296,0.0,0.0,0.0,691,17184,10365,-6819
4297,0.0,0.0,0.0,691,17188,10365,-6823
4298,0.0,0.0,0.0,691,17192,10365,-6827
4299,0.0,0.0,0.0,691,17196,10365,-6831
4300,0.0,0.0,0.0,691,17200,10365,-6835
4301,0.0,0.0,0.0,691,17204,10365,-6839
4302,0.0,0.0,0.0,691,17208,10365,-6843
4303,0.0,0.0,0.0,691,17212,10365,-6847
4304,0.0,0.0,0.0,691,17216,10365,-6851
4305,1.0,1.0,1.0,692,17220,10380,-6840
4306,0.0,0.0,0.0,692,17224,10380,-6844
4307,0.0,0.0,0.0,692,17228,10380,-6848
4308,1.0,0.0,0.5,693,17232,10395,-6837
4309,0.0,0.0,0.0,693,17236,10395,-6841
4310,0.0,0.0,0.0,693,17240,10395,-6845
4311,0.0,0.0,0.0,693,17244,10395,-6849
4312,0.0,0.0,0.0,693,17248,10395,-6853
4313,0.0,0.0,0.0,693,17252,10395,-6857
4314,1.0,1.0,1.0,694,17256,10410,-6846
4315,0.0,0.0,0.0,694,17260,10410,-6850
4316,0.0,0.0,0.0,694,17264,10410,-6854
4317,0.0,0.0,0.0,694,17268,10410,-6858
4318,0.0,0.0,0.0,694,17272,10410,-6862
4319,0.0,0.0,0.0,694,17276,10410,-6866
4320,0.0,0.0,0.0,694,17280,10410,-6870
4321,0.0,0.0,0.0,694,17284,10410,-6874
4322,0.0,0.0,0.0,694,17288,10410,-6878
4323,0.0,0.0,0.0,694,17292,10410,-6882
4324,0.0,0.0,0.0,694,17296,10410,-6886
4325,0.0,0.0,0.0,694,17300,10410,-6890
4326,0.0,0.0,0.0,694,17304,10410,-6894
4327,0.0,0.0,0.0,694,17308,10410,-6898
4328,0.0,0.0,0.0,694,17312,10410,-6902
4329,0.0,0.0,0.0,694,17316,10410,-6906
4330,1.0,1.0,1.0,695,17320,10425,-6895
4331,0.0,0.0,0.0,695,17324,10425,-6899
4332,0.0,0.0,0.0,695,17328,10425,-6903
4333,0.0,0.0,0.0,695,17332,10425,-6907
4334,0.0,0.0,0.0,695,17336,10425,-6911
4335,0.0,0.0,0.0,695,17340,10425,-6915
4336,0.0,0.0,0.0,695,17344,10425,-6919
4337,0.0,0.0,0.0,695,17348,10425,-6923
4338,0.0,0.0,0.0,695,17352,10425,-6927
4339,0.0,0.0,0.0,695,17356,10425,-6931
4340,0.0,0.0,0.0,695,17360,10425,-6935
4341,0.0,0.0,0.0,695,17364,10425,-6939
4342,0.0,0.0,0.0,695,17368,10425,-6943
4343,1.0,1.0,0.8,696,17372,10440,-6932
4344,0.0,0.0,0.0,696,17376,10440,-6936
4345,0.0,0.0,0.0,696,17380,10440,-6940
4346,0.0,0.0,0.0,696,17384,10440,-6944
4347,0.0,0.0,0.0,696,17388,10440,-6948
4348,0.0,0.0,0.0,696,17392,10440,-6952
4349,0.0,0.0,0.0,696,17396,10440,-6956
4350,0.0,1.0,0.6666666666666666,696,17400,10440,-6960
4351,1.0,1.0,1.0,697,17404,10455,-6949
4352,1.0,1.0,1.0,698,17408,10470,-6938
4353,0.0,0.0,0.0,698,17412,10470,-6942
4354,0.0,0.0,0.0,698,17416,10470,-6946
4355,0.0,0.0,0.0,698,17420,10470,-6950
4356,0.0,0.0,0.25,698,17424,10470,-6954
4357,0.0,0.0,0.0,698,17428,10470,-6958
4358,0.0,0.0,0.0,698,17432,10470,-6962
4359,1.0,1.0,1.0,699,17436,10485,-6951
4360,0.0,0.0,0.0,699,17440,10485,-6955
4361,0.0,0.0,0.5,699,17444,10485,-6959
4362,0.0,0.0,0.0,699,17448,10485,-6963
4363,0.0,0.0,0.0,699,17452,10485,-6967
4364,0.0,0.0,0.0,699,17456,10485,-6971
4365,0.0,0.0,0.0,699,17460,10485,-6975
4366,0.0,0.0,0.0,699,17464,10485,-6979
4367,0.0,0.0,0.0,699,17468,10485,-6983
4368,0.0,0.0,0.0,699,17472,10485,-6987
4369,0.0,0.0,0.0,699,17476,10485,-6991
4370,0.0,0.0,0.0,699,17480,10485,-6995
4371,1.0,1.0,1.0,700,17484,10500,-6984
4372,0.0,0.0,0.0,700,17488,10500,-6988
4373,0.0,0.0,0.0,700,17492,10500,-6992
4374,0.0,0.0,0.0,700,17496,10500,-6996
4375,1.0,1.0,1.0,701,17500,10515,-6985
4376,0.0,0.0,0.0,701,17504,10515,-6989
4377,0.0,0.0,0.0,701,17508,10515,-6993
4378,0.0,0.0,0.0,701,17512,10515,-6997
4379,0.0,0.0,0.0,701,17516,10515,-7001
4380,0.0,0.0,0.0,701,17520,10515,-7005
4381,0.0,0.0,0.0,701,17524,10515,-7009
4382,0.0,0.0,0.0,701,17528,10515,-7013
4383,0.0,1.0,0.6666666666666666,701,17532,10515,-7017
4384,0.0,0.0,0.0,701,17536,10515,-7021
4385,1.0,1.0,0.6666666666666666,702,17540,10530,-7010
4386,0.0,0.0,0.0,702,17544,10530,-7014
4387,0.0,0.0,0.0,702,17548,10530,-7018
4388,1.0,1.0,1.0,703,17552,10545,-7007
4389,1.0,1.0,1.0,704,17556,10560,-6996
4390,0.0,0.0,0.0,704,17560,10560,-7000
4391,0.0,0.0,0.0,704,17564,10560,-7004
4392,0.0,0.0,0.0,704,17568,10560,-7008
4393,1.0,1.0,1.0,705,17572,10575,-6997
4394,0.0,0.0,0.0,705,17576,10575,-7001
4395,1.0,1.0,0.6666666666666666,706,17580,10590,-6990
4396,0.0,0.0,0.0,706,17584,10590,-6994
4397,0.0,0.0,0.0,706,17588,10590,-6998
4398,0.0,0.0,0.0,706,17592,10590,-7002
4399,1.0,0.0,0.3333333333333333,707,17596,10605,-6991
4400,0.0,0.0,0.0,707,17600,10605,-6995
4401,0.0,0.0,0.0,707,17604,10605,-6999
4402,0.0,0.0,0.0,707,17608,10605,-7003
4403,0.0,0.0,0.0,707,17612,10605,-7007
4404,0.0,0.0,0.0,707,17616,10605,-7011
4405,0.0,0.0,0.0,707,17620,10605,-7015
4406,0.0,0.0,0.0,707,17624,10605,-7019
4407,0.0,0.0,0.0,707,17628,10605,-7023
4408,0.0,0.0,0.0,707,17632,10605,-7027
4409,1.0,1.0,1.0,708,17636,10620,-7016
4410,0.0,0.0,0.0,708,17640,10620,-7020
4411,0.0,0.0,0.0,708,17644,10620,-7024
4412,0.0,0.0,0.0,708,17648,10620,-7028
4413,1.0,1.0,0.8,709,17652,10635,-7017
4414,0.0,0.0,0.0,709,17656,10635,-7021
4415,0.0,0.0,0.25,709,17660,10635,-7025
4416,0.0,0.0,0.25,709,17664,10635,-7029
4417,1.0,1.0,1.0,710,17668,10650,-7018
4418,1.0,1.0,1.0,711,17672,10665,-7007
4419,0.0,0.0,0.0,711,17676,10665,-7011
4420,0.0,0.0,0.0,711,17680,10665,-7015
4421,0.0,0.0,0.0,711,17684,10665,-7019
4422,0.0,0.0,0.0,711,17688,10665,-7023
4423,0.0,0.0,0.0,711,17692,10665,-7027
4424,0.0,0.0,0.0,711,17696,10665,-7031
4425,0.0,0.0,0.0,711,17700,10665,-7035
4426,0.0,0.0,0.0,711,17704,10665,-7039
4427,0.0,0.0,0.0,711,17708,10665,-7043
4428,1.0,1.0,1.0,712,17712,10680,-7032
4429,1.0,1.0,1.0,713,17716,10695,-7021
4430,1.0,0.0,0.4,714,17720,10710,-7010
4431,0.0,0.0,0.0,714,17724,10710,-7014
4432,0.0,0.0,0.0,714,17728,10710,-7018
4433,0.0,0.0,0.0,714,17732,10710,-7022
4434,1.0,1.0,1.0,715,17736,10725,-7011
4435,0.0,0.0,0.2,715,17740,10725,-7015
4436,0.0,0.0,0.0,715,17744,10725,-7019
4437,0.0,0.0,0.0,715,17748,10725,-7023
4438,0.0,0.0,0.5,715,17752,10725,-7027
4439,0.0,0.0,0.0,715,17756,10725,-7031
4440,1.0,1.0,0.8,716,17760,10740,-7020
4441,0.0,0.0,0.0,716,17764,10740,-7024
4442,0.0,0.0,0.0,716,17768,10740,-7028
4443,0.0,0.0,0.0,716,17772,10740,-7032
4444,0.0,0.0,0.0,716,17776,10740,-7036
4445,0.0,0.0,0.0,716,17780,10740,-7040
4446,0.0,0.0,0.0,716,17784,10740,-7044
4447,1.0,1.0,1.0,717,17788,10755,-7033
4448,0.0,0.0,0.0,717,17792,10755,-7037
4449,0.0,0.0,0.0,717,17796,10755,-7041
4450,0.0,0.0,0.0,717,17800,10755,-7045
4451,0.0,1.0,0.6666666666666666,717,17804,10755,-7049
4452,1.0,1.0,1.0,718,17808,10770,-7038
4453,0.0,0.0,0.0,718,17812,10770,-7042
4454,0.0,0.0,0.0,718,17816,10770,-7046
4455,0.0,0.0,0.0,718,17820,10770,-7050
4456,0.0,0.0,0.0,718,17824,10770,-7054
4457,1.0,1.0,1.0,719,17828,10785,-7043
4458,0.0,0.0,0.0,719,17832,10785,-7047
4459,1.0,1.0,1.0,720,17836,10800,-7036
4460,0.0,0.0,0.0,720,17840,10800,-7040
4461,0.0,0.0,0.0,720,17844,10800,-7044
4462,0.0,0.0,0.0,720,17848,10800,-7048
4463,1.0,1.0,1.0,721,17852,10815,-7037
4464,0.0,0.0,0.0,721,17856,10815,-7041
4465,0.0,0.0,0.0,721,17860,10815,-7045
4466,0.0,0.0,0.0,721,17864,10815,-7049
4467,0.0,0.0,0.0,721,17868,10815,-7053
4468,0.0,0.0,0.0,721,17872,10815,-7057
4469,0.0,0.0,0.0,721,17876,10815,-7061
4470,1.0,1.0,0.6666666666666666,722,17880,10830,-7050
4471,0.0,0.0,0.0,722,17884,10830,-7054
4472,0.0,0.0,0.0,722,17888,10830,-7058
4473,0.0,0.0,0.0,722,17892,10830,-7062
4474,0.0,0.0,0.0,722,17896,10830,-7066
4475,0.0,0.0,0.0,722,17900,10830,-7070
4476,0.0,0.0,0.0,722,17904,10830,-7074
4477,0.0,0.0,0.0,722,17908,10830,-7078
4478,0.0,0.0,0.0,722,17912,10830,-7082
4479,0.0,0.0,0.0,722,17916,10830,-7086
4480,0.0,0.0,0.0,722,17920,10830,-7090
4481,0.0,0.0,0.0,722,17924,10830,-7094
4482,0.0,0.0,0.0,722,17928,10830,-7098
4483,0.0,0.0,0.0,722,17932,10830,-7102
4484,0.0,0.0,0.0,722,17936,10830,-7106
4485,0.0,0.0,0.0,722,17940,10830,-7110
4486,0.0,0.0,0.0,722,17944,10830,-7114
4487,0.0,0.0,0.0,722,17948,10830,-7118
4488,0.0,0.0,0.0,722,17952,10830,-7122
4489,0.0,0.0,0.0,722,17956,10830,-7126
4490,1.0,1.0,1.0,723,17960,10845,-7115
4491,0.0,0.0,0.0,723,17964,10845,-7119
4492,0.0,0.0,0.0,723,17968,10845,-7123
4493,0.0,0.0,0.0,723,17972,10845,-7127
4494,0.0,0.0,0.0,723,17976,10845,-7131
4495,1.0,1.0,1.0,724,17980,10860,-7120
4496,0.0,0.0,0.0,724,17984,10860,-7124
4497,1.0,0.0,0.3333333333333333,725,17988,10875,-7113
4498,0.0,0.0,0.0,725,17992,10875,-7117
4499,0.0,0.0,0.0,725,17996,10875,-7121
4500,1.0,1.0,1.0,726,18000,10890,-7110
4501,0.0,0.0,0.0,726,18004,10890,-7114
4502,0.0,0.0,0.0,726,18008,10890,-7118
4503,0.0,0.0,0.0,726,18012,10890,-7122
4504,0.0,0.0,0.0,726,18016,10890,-7126
4505,0.0,0.0,0.0,726,18020,10890,-7130
4506,0.0,0.0,0.0,726,18024,10890,-7134
4507,0.0,0.0,0.0,726,18028,10890,-7138
4508,0.0,0.0,0.0,726,18032,10890,-7142
4509,0.0,0.0,0.0,726,18036,10890,-7146
4510,1.0,1.0,1.0,727,18040,10905,-7135
4511,0.0,0.0,0.0,727,18044,10905,-7139
4512,0.0,0.0,0.0,727,18048,10905,-7143
4513,0.0,0.0,0.0,727,18052,10905,-7147
4514,0.0,0.0,0.0,727,18056,10905,-7151
4515,0.0,0.0,0.0,727,18060,10905,-7155
4516,0.0,0.0,0.0,727,18064,10905,-7159
4517,0.0,0.0,0.0,727,18068,10905,-7163
4518,0.0,0.0,0.0,727,18072,10905,-7167
4519,0.0,0.0,0.0,727,18076,10905,-7171
4520,1.0,1.0,1.0,728,18080,10920,-7160
4521,0.0,0.0,0.0,728,18084,10920,-7164
4522,0.0,0.0,0.0,728,18088,10920,-7168
4523,0.0,0.0,0.0,728,18092,10920,-7172
4524,0.0,0.0,0.0,728,18096,10920,-7176
4525,0.0,0.0,0.0,728,18100,10920,-7180
4526,0.0,0.0,0.0,728,18104,10920,-7184
4527,0.0,0.0,0.0,728,18108,10920,-7188
4528,0.0,0.0,0.0,728,18112,10920,-7192
4529,0.0,0.0,0.0,728,18116,10920,-7196
4530,0.0,0.0,0.0,728,18120,10920,-7200
4531,0.0,0.0,0.0,728,18124,10920,-7204
4532,0.0,0.0,0.0,728,18128,10920,-7208
4533,0.0,0.0,0.0,728,18132,10920,-7212
4534,0.0,0.0,0.0,728,18136,10920,-7216
4535,1.0,1.0,1.0,729,18140,10935,-7205
4536,0.0,0.0,0.0,729,18144,10935,-7209
4537,0.0,0.0,0.0,729,18148,10935,-7213
4538,0.0,0.0,0.0,729,18152,10935,-7217
4539,0.0,0.0,0.0,729,18156,10935,-7221
4540,0.0,1.0,0.6666666666666666,729,18160,10935,-7225
4541,0.0,0.0,0.0,729,18164,10935,-7229
4542,0.0,0.0,0.0,729,18168,10935,-7233
4543,0.0,0.0,0.0,729,18172,10935,-7237
4544,0.0,0.0,0.0,729,18176,10935,-7241
4545,0.0,0.0,0.0,729,18180,10935,-7245
4546,0.0,0.0,0.0,729,18184,10935,-7249
4547,0.0,0.0,0.0,729,18188,10935,-7253
4548,0.0,0.0,0.0,729,18192,10935,-7257
4549,0.0,0.0,0.0,729,18196,10935,-7261
4550,0.0,0.0,0.4,729,18200,10935,-7265
4551,0.0,0.0,0.0,729,18204,10935,-7269
4552,0.0,0.0,0.0,729,18208,10935,-7273
4553,0.0,0.0,0.0,729,18212,10935,-7277
4554,0.0,0.0,0.0,729,18216,10935,-7281
4555,1.0,0.0,0.3333333333333333,730,18220,10950,-7270
4556,0.0,0.0,0.0,730,18224,10950,-7274
4557,0.0,0.0,0.0,730,18228,10950,-7278
4558,0.0,0.0,0.0,730,18232,10950,-7282
4559,0.0,0.0,0.0,730,18236,10950,-7286
4560,0.0,0.0,0.0,730,18240,10950,-7290
4561,0.0,0.0,0.0,730,18244,10950,-7294
4562,0.0,0.0,0.0,730,18248,10950,-7298
4563,0.0,0.0,0.0,730,18252,10950,-7302
4564,0.0,0.0,0.0,730,18256,10950,-7306
4565,0.0,0.0,0.0,730,18260,10950,-7310
4566,0.0,0.0,0.0,730,18264,10950,-7314
4567,0.0,0.0,0.0,730,18268,10950,-7318
4568,0.0,0.0,0.0,730,18272,10950,-7322
4569,0.0,0.0,0.0,730,18276,10950,-7326
4570,0.0,0.0,0.0,730,18280,10950,-7330
4571,0.0,0.0,0.0,730,18284,10950,-7334
4572,0.0,0.0,0.0,730,18288,10950,-7338
4573,0.0,0.0,0.0,730,18292,10950,-7342
4574,1.0,0.0,0.3333333333333333,731,18296,10965,-7331
4575,0.0,0.0,0.0,731,18300,10965,-7335
4576,1.0,1.0,1.0,732,18304,10980,-7324
4577,0.0,0.0,0.0,732,18308,10980,-7328
4578,0.0,0.0,0.0,732,18312,10980,-7332
4579,0.0,0.0,0.0,732,18316,10980,-7336
4580,0.0,0.0,0.0,732,18320,10980,-7340
4581,0.0,0.0,0.0,732,18324,10980,-7344
4582,0.0,0.0,0.3333333333333333,732,18328,10980,-7348
4583,0.0,0.0,0.0,732,18332,10980,-7352
4584,0.0,0.0,0.0,732,18336,10980,-7356
4585,1.0,1.0,1.0,733,18340,10995,-7345
4586,0.0,0.0,0.0,733,18344,10995,-7349
4587,0.0,0.0,0.0,733,18348,10995,-7353
4588,0.0,0.0,0.0,733,18352,10995,-7357
4589,0.0,0.0,0.0,733,18356,10995,-7361
4590,0.0,0.0,0.0,733,18360,10995,-7365
4591,1.0,1.0,1.0,734,18364,11010,-7354
4592,0.0,0.0,0.0,734,18368,11010,-7358
4593,0.0,0.0,0.0,734,18372,11010,-7362
4594,1.0,1.0,1.0,735,18376,11025,-7351
4595,0.0,0.0,0.0,735,18380,11025,-7355
4596,1.0,1.0,1.0,736,18384,11040,-7344
4597,0.0,0.0,0.0,736,18388,11040,-7348
4598,0.0,0.0,0.0,736,18392,11040,-7352
4599,1.0,1.0,1.0,737,18396,11055,-7341
4600,0.0,0.0,0.0,737,18400,11055,-7345
4601,1.0,0.0,0.3333333333333333,738,18404,11070,-7334
4602,0.0,0.0,0.0,738,18408,11070,-7338
4603,0.0,0.0,0.0,738,18412,11070,-7342
4604,0.0,0.0,0.0,738,18416,11070,-7346
4605,0.0,0.0,0.0,738,18420,11070,-7350
4606,0.0,0.0,0.0,738,18424,11070,-7354
4607,1.0,1.0,1.0,739,18428,11085,-7343
4608,0.0,0.0,0.0,739,18432,11085,-7347
4609,0.0,0.0,0.0,739,18436,11085,-7351
4610,0.0,0.0,0.0,739,18440,11085,-7355
4611,0.0,0.0,0.0,739,18444,11085,-7359
4612,1.0,1.0,1.0,740,18448,11100,-7348
4613,1.0,1.0,1.0,741,18452,11115,-7337
4614,0.0,0.0,0.0,741,18456,11115,-7341
4615,0.0,0.0,0.0,741,18460,11115,-7345
4616,0.0,0.0,0.0,741,18464,11115,-7349
4617,0.0,0.0,0.0,741,18468,11115,-7353
4618,0.0,0.0,0.0,741,18472,11115,-7357
4619,0.0,0.0,0.0,741,18476,11115,-7361
4620,0.0,0.0,0.0,741,18480,11115,-7365
4621,0.0,0.0,0.0,741,18484,11115,-7369
4622,0.0,0.0,0.0,741,18488,11115,-7373
4623,1.0,1.0,1.0,742,18492,11130,-7362
4624,0.0,0.0,0.0,742,18496,11130,-7366
4625,0.0,0.0,0.0,742,18500,11130,-7370
4626,0.0,0.0,0.0,742,18504,11130,-7374
4627,0.0,0.0,0.0,742,18508,11130,-7378
4628,0.0,0.0,0.0,742,18512,11130,-7382
4629,0.0,0.0,0.0,742,18516,11130,-7386
4630,0.0,0.0,0.0,742,18520,11130,-7390
4631,1.0,1.0,1.0,743,18524,11145,-7379
4632,1.0,1.0,1.0,744,18528,11160,-7368
4633,0.0,0.0,0.0,744,18532,11160,-7372
4634,0.0,0.0,0.0,744,18536,11160,-7376
4635,0.0,0.0,0.0,744,18540,11160,-7380
4636,0.0,0.0,0.0,744,18544,11160,-7384
4637,0.0,0.0,0.0,744,18548,11160,-7388
4638,0.0,0.0,0.0,744,18552,11160,-7392
4639,1.0,1.0,1.0,745,18556,11175,-7381
4640,0.0,0.0,0.0,745,18560,11175,-7385
4641,0.0,0.0,0.0,745,18564,11175,-7389
4642,0.0,0.0,0.0,745,18568,11175,-7393
4643,0.0,0.0,0.0,745,18572,11175,-7397
4644,0.0,0.0,0.0,745,18576,11175,-7401
4645,0.0,0.0,0.0,745,18580,11175,-7405
4646,0.0,0.0,0.0,745,18584,11175,-7409
4647,0.0,0.0,0.0,745,18588,11175,-7413
4648,1.0,0.0,0.25,746,18592,11190,-7402
4649,0.0,0.0,0.0,746,18596,11190,-7406
4650,0.0,0.0,0.0,746,18600,11190,-7410
4651,0.0,0.0,0.0,746,18604,11190,-7414
4652,0.0,0.0,0.0,746,18608,11190,-7418
4653,1.0,1.0,1.0,747,18612,11205,-7407
4654,0.0,0.0,0.0,747,18616,11205,-7411
4655,0.0,1.0,0.6,747,18620,11205,-7415
4656,0.0,0.0,0.0,747,18624,11205,-7419
4657,1.0,1.0,1.0,748,18628,11220,-7408
4658,0.0,0.0,0.0,748,18632,11220,-7412
4659,0.0,0.0,0.0,748,18636,11220,-7416
4660,0.0,0.0,0.0,748,18640,11220,-7420
4661,0.0,0.0,0.0,748,18644,11220,-7424
4662,0.0,0.0,0.0,748,18648,11220,-7428
4663,1.0,1.0,1.0,749,18652,11235,-7417
4664,0.0,0.0,0.0,749,18656,11235,-7421
4665,0.0,0.0,0.0,749,18660,11235,-7425
4666,0.0,0.0,0.0,749,18664,11235,-7429
4667,0.0,0.0,0.0,749,18668,11235,-7433
4668,0.0,0.0,0.0,749,18672,11235,-7437
4669,0.0,0.0,0.0,749,18676,11235,-7441
4670,0.0,0.0,0.0,749,18680,11235,-7445
4671,0.0,0.0,0.0,749,18684,11235,-7449
4672,0.0,0.0,0.0,749,18688,11235,-7453
4673,0.0,0.0,0.0,749,18692,11235,-7457
4674,1.0,1.0,0.75,750,18696,11250,-7446
4675,0.0,0.0,0.0,750,18700,11250,-7450
4676,0.0,0.0,0.0,750,18704,11250,-7454
4677,0.0,0.0,0.0,750,18708,11250,-7458
4678,0.0,0.0,0.0,750,18712,11250,-7462
4679,0.0,0.0,0.0,750,18716,11250,-7466
4680,1.0,1.0,1.0,751,18720,11265,-7455
4681,0.0,0.0,0.0,751,18724,11265,-7459
4682,0.0,0.0,0.0,751,18728,11265,-7463
4683,1.0,1.0,1.0,752,18732,11280,-7452
4684,0.0,0.0,0.0,752,18736,11280,-7456
4685,1.0,1.0,1.0,753,18740,11295,-7445
4686,0.0,0.0,0.0,753,18744,11295,-7449
4687,0.0,0.0,0.0,753,18748,11295,-7453
4688,0.0,0.0,0.0,753,18752,11295,-7457
4689,0.0,0.0,0.3333333333333333,753,18756,11295,-7461
4690,0.0,0.0,0.0,753,18760,11295,-7465
4691,0.0,0.0,0.0,753,18764,11295,-7469
4692,0.0,0.0,0.0,753,18768,11295,-7473
4693,0.0,0.0,0.0,753,18772,11295,-7477
4694,0.0,0.0,0.0,753,18776,11295,-7481
4695,0.0,0.0,0.0,753,18780,11295,-7485
4696,0.0,0.0,0.0,753,18784,11295,-7489
4697,0.0,0.0,0.0,753,18788,11295,-7493
4698,0.0,0.0,0.0,753,18792,11295,-7497
4699,0.0,0.0,0.0,753,18796,11295,-7501
4700,0.0,0.0,0.4,753,18800,11295,-7505
4701,1.0,1.0,1.0,754,18804,11310,-7494
4702,0.0,0.0,0.0,754,18808,11310,-7498
4703,0.0,0.0,0.0,754,18812,11310,-7502
4704,0.0,1.0,0.6666666666666666,754,18816,11310,-7506
4705,1.0,1.0,1.0,755,18820,11325,-7495
4706,0.0,0.0,0.0,755,18824,11325,-7499
4707,1.0,1.0,1.0,756,18828,11340,-7488
4708,0.0,0.0,0.0,756,18832,11340,-7492
4709,0.0,0.0,0.0,756,18836,11340,-7496
4710,0.0,0.0,0.0,756,18840,11340,-7500
4711,0.0,0.0,0.0,756,18844,11340,-7504
4712,0.0,0.0,0.0,756,18848,11340,-7508
4713,1.0,0.0,0.3333333333333333,757,18852,11355,-7497
4714,0.0,0.0,0.0,757,18856,11355,-7501
4715,0.0,0.0,0.0,757,18860,11355,-7505
4716,0.0,0.0,0.2,757,18864,11355,-7509
4717,0.0,0.0,0.0,757,18868,11355,-7513
4718,0.0,0.0,0.0,757,18872,11355,-7517
4719,0.0,0.0,0.0,757,18876,11355,-7521
4720,0.0,0.0,0.0,757,18880,11355,-7525
4721,0.0,0.0,0.0,757,18884,11355,-7529
4722,1.0,1.0,1.0,758,18888,11370,-7518
4723,0.0,0.0,0.0,758,18892,11370,-7522
4724,1.0,1.0,1.0,759,18896,11385,-7511
4725,0.0,0.0,0.0,759,18900,11385,-7515
4726,0.0,0.0,0.0,759,18904,11385,-7519
4727,1.0,0.0,0.3333333333333333,760,18908,11400,-7508
4728,0.0,0.0,0.0,760,18912,11400,-7512
4729,0.0,0.0,0.0,760,18916,11400,-7516
4730,1.0,1.0,1.0,761,18920,11415,-7505
4731,0.0,0.0,0.0,761,18924,11415,-7509
4732,0.0,0.0,0.0,761,18928,11415,-7513
4733,0.0,0.0,0.0,761,18932,11415,-7517
4734,0.0,0.0,0.0,761,18936,11415,-7521
4735,0.0,0.0,0.0,761,18940,11415,-7525
4736,0.0,0.0,0.0,761,18944,11415,-7529
4737,0.0,0.0,0.0,761,18948,11415,-7533
4738,1.0,0.0,0.5,762,18952,11430,-7522
4739,0.0,0.0,0.0,762,18956,11430,-7526
4740,0.0,0.0,0.0,762,18960,11430,-7530
4741,0.0,0.0,0.0,762,18964,11430,-7534
4742,1.0,1.0,1.0,763,18968,11445,-7523
4743,0.0,0.0,0.0,763,18972,11445,-7527
4744,0.0,0.0,0.0,763,18976,11445,-7531
4745,0.0,0.0,0.0,763,18980,11445,-7535
4746,0.0,0.0,0.0,763,18984,11445,-7539
4747,0.0,0.0,0.0,763,18988,11445,-7543
4748,0.0,0.0,0.0,763,18992,11445,-7547
4749,1.0,1.0,0.6,764,18996,11460,-7536
4750,0.0,0.0,0.0,764,19000,11460,-7540
4751,0.0,0.0,0.0,764,19004,11460,-7544
4752,1.0,1.0,0.6666666666666666,765,19008,11475,-7533
4753,0.0,0.0,0.0,765,19012,11475,-7537
4754,0.0,0.0,0.0,765,19016,11475,-7541
4755,0.0,0.0,0.0,765,19020,11475,-7545
4756,0.0,0.0,0.0,765,19024,11475,-7549
4757,0.0,0.0,0.0,765,19028,11475,-7553
4758,0.0,0.0,0.0,765,19032,11475,-7557
4759,0.0,0.0,0.0,765,19036,11475,-7561
4760,0.0,0.0,0.0,765,19040,11475,-7565
4761,0.0,0.0,0.0,765,19044,11475,-7569
4762,0.0,0.0,0.0,765,19048,11475,-7573
4763,0.0,0.0,0.0,765,19052,11475,-7577
4764,0.0,0.0,0.0,765,19056,11475,-7581
4765,0.0,0.0,0.0,765,19060,11475,-7585
4766,0.0,0.0,0.0,765,19064,11475,-7589
4767,0.0,0.0,0.0,765,19068,11475,-7593
4768,1.0,1.0,1.0,766,19072,11490,-7582
4769,0.0,0.0,0.0,766,19076,11490,-7586
4770,0.0,0.0,0.0,766,19080,11490,-7590
4771,1.0,1.0,1.0,767,19084,11505,-7579
4772,0.0,0.0,0.0,767,19088,11505,-7583
4773,0.0,0.0,0.0,767,19092,11505,-7587
4774,0.0,0.0,0.0,767,19096,11505,-7591
4775,0.0,0.0,0.0,767,19100,11505,-7595
4776,0.0,0.0,0.0,767,19104,11505,-7599
4777,1.0,1.0,1.0,768,19108,11520,-7588
4778,0.0,0.0,0.0,768,19112,11520,-7592
4779,0.0,0.0,0.0,768,19116,11520,-7596
4780,0.0,0.0,0.0,768,19120,11520,-7600
4781,0.0,0.0,0.0,768,19124,11520,-7604
4782,1.0,1.0,1.0,769,19128,11535,-7593
4783,0.0,0.0,0.0,769,19132,11535,-7597
4784,0.0,0.0,0.0,769,19136,11535,-7601
4785,0.0,0.0,0.0,769,19140,11535,-7605
4786,0.0,0.0,0.0,769,19144,11535,-7609
4787,0.0,0.0,0.0,769,19148,11535,-7613
4788,0.0,0.0,0.0,769,19152,11535,-7617
4789,0.0,1.0,0.75,769,19156,11535,-7621
4790,0.0,0.0,0.0,769,19160,11535,-7625
4791,0.0,0.0,0.0,769,19164,11535,-7629
4792,1.0,1.0,1.0,770,19168,11550,-7618
4793,0.0,0.0,0.0,770,19172,11550,-7622
4794,0.0,0.0,0.0,770,19176,11550,-7626
4795,0.0,0.0,0.0,770,19180,11550,-7630
4796,1.0,1.0,1.0,771,19184,11565,-7619
4797,0.0,0.0,0.0,771,19188,11565,-7623
4798,0.0,0.0,0.0,771,19192,11565,-7627
4799,0.0,0.0,0.0,771,19196,11565,-7631
4800,0.0,0.0,0.0,771,19200,11565,-7635
4801,0.0,0.0,0.0,771,19204,11565,-7639
4802,0.0,0.0,0.0,771,19208,11565,-7643
4803,0.0,1.0,0.6,771,19212,11565,-7647
4804,0.0,0.0,0.0,771,19216,11565,-7651
4805,0.0,0.0,0.0,771,19220,11565,-7655
4806,1.0,1.0,1.0,772,19224,11580,-7644
4807,1.0,1.0,1.0,773,19228,11595,-7633
4808,0.0,0.0,0.0,773,19232,11595,-7637
4809,0.0,0.0,0.0,773,19236,11595,-7641
4810,0.0,0.0,0.0,773,19240,11595,-7645
4811,0.0,0.0,0.0,773,19244,11595,-7649
4812,0.0,0.0,0.0,773,19248,11595,-7653
4813,0.0,0.0,0.0,773,19252,11595,-7657
4814,1.0,1.0,1.0,774,19256,11610,-7646
4815,0.0,0.0,0.0,774,19260,11610,-7650
4816,0.0,0.0,0.0,774,19264,11610,-7654
4817,0.0,0.0,0.0,774,19268,11610,-7658
4818,0.0,0.0,0.0,774,19272,11610,-7662
4819,0.0,0.0,0.0,774,19276,11610,-7666
4820,0.0,0.0,0.0,774,19280,11610,-7670
4821,0.0,0.0,0.0,774,19284,11610,-7674
4822,0.0,0.0,0.0,774,19288,11610,-7678
4823,0.0,0.0,0.0,774,19292,11610,-7682
4824,0.0,0.0,0.0,774,19296,11610,-7686
4825,0.0,0.0,0.0,774,19300,11610,-7690
4826,0.0,0.0,0.0,774,19304,11610,-7694
4827,0.0,0.0,0.4,774,19308,11610,-7698
4828,0.0,1.0,0.6666666666666666,774,19312,11610,-7702
4829,0.0,0.0,0.0,774,19316,11610,-7706
4830,0.0,0.0,0.0,774,19320,11610,-7710
4831,0.0,0.0,0.0,774,19324,11610,-7714
4832,0.0,0.0,0.0,774,19328,11610,-7718
4833,0.0,0.0,0.0,774,19332,11610,-7722
4834,0.0,0.0,0.0,774,19336,11610,-7726
4835,0.0,0.0,0.0,774,19340,11610,-7730
4836,0.0,0.0,0.0,774,19344,11610,-7734
4837,0.0,0.0,0.0,774,19348,11610,-7738
4838,0.0,0.0,0.0,774,19352,11610,-7742
4839,0.0,0.0,0.0,774,19356,11610,-7746
4840,0.0,0.0,0.0,774,19360,11610,-7750
4841,0.0,0.0,0.0,774,19364,11610,-7754
4842,0.0,0.0,0.0,774,19368,11610,-7758
4843,0.0,0.0,0.0,774,19372,11610,-7762
4844,0.0,0.0,0.0,774,19376,11610,-7766
4845,0.0,0.0,0.0,774,19380,11610,-7770
4846,0.0,0.0,0.3333333333333333,774,19384,11610,-7774
4847,0.0,0.0,0.0,774,19388,11610,-7778
4848,0.0,0.0,0.0,774,19392,11610,-7782
4849,0.0,0.0,0.0,774,19396,11610,-7786
4850,0.0,0.0,0.0,774,19400,11610,-7790
4851,0.0,0.0,0.0,774,19404,11610,-7794
4852,0.0,0.0,0.0,774,19408,11610,-7798
4853,0.0,0.0,0.0,774,19412,11610,-7802
4854,0.0,0.0,0.0,774,19416,11610,-7806
4855,0.0,0.0,0.0,774,19420,11610,-7810
4856,0.0,0.0,0.0,774,19424,11610,-7814
4857,0.0,0.0,0.0,774,19428,11610,-7818
4858,0.0,0.0,0.0,774,19432,11610,-7822
4859,1.0,1.0,1.0,775,19436,11625,-7811
4860,0.0,0.0,0.0,775,19440,11625,-7815
4861,0.0,0.0,0.0,775,19444,11625,-7819
4862,0.0,0.0,0.0,775,19448,11625,-7823
4863,0.0,0.0,0.0,775,19452,11625,-7827
4864,0.0,0.0,0.0,775,19456,11625,-7831
4865,0.0,0.0,0.0,775,19460,11625,-7835
4866,0.0,0.0,0.0,775,19464,11625,-7839
4867,0.0,0.0,0.0,775,19468,11625,-7843
4868,0.0,0.0,0.3333333333333333,775,19472,11625,-7847
4869,0.0,0.0,0.0,775,19476,11625,-7851
4870,1.0,1.0,1.0,776,19480,11640,-7840
4871,0.0,0.0,0.0,776,19484,11640,-7844
4872,0.0,0.0,0.0,776,19488,11640,-7848
4873,1.0,1.0,1.0,777,19492,11655,-7837
4874,0.0,0.0,0.0,777,19496,11655,-7841
4875,0.0,0.0,0.0,777,19500,11655,-7845
4876,0.0,0.0,0.0,777,19504,11655,-7849
4877,0.0,0.0,0.0,777,19508,11655,-7853
4878,0.0,0.0,0.0,777,19512,11655,-7857
4879,0.0,0.0,0.0,777,19516,11655,-7861
4880,0.0,0.0,0.0,777,19520,11655,-7865
4881,0.0,0.0,0.0,777,19524,11655,-7869
4882,0.0,0.0,0.0,777,19528,11655,-7873
4883,0.0,0.0,0.0,777,19532,11655,-7877
4884,0.0,1.0,0.6,777,19536,11655,-7881
4885,1.0,1.0,1.0,778,19540,11670,-7870
4886,0.0,0.0,0.0,778,19544,11670,-7874
4887,1.0,1.0,1.0,779,19548,11685,-7863
4888,0.0,0.0,0.0,779,19552,11685,-7867
4889,0.0,0.0,0.0,779,19556,11685,-7871
4890,0.0,0.0,0.0,779,19560,11685,-7875
4891,0.0,0.0,0.0,779,19564,11685,-7879
4892,1.0,1.0,1.0,780,19568,11700,-7868
4893,0.0,0.0,0.0,780,19572,11700,-7872
4894,0.0,0.0,0.0,780,19576,11700,-7876
4895,0.0,0.0,0.0,780,19580,11700,-7880
4896,0.0,0.0,0.0,780,19584,11700,-7884
4897,1.0,1.0,1.0,781,19588,11715,-7873
4898,0.0,0.0,0.0,781,19592,11715,-7877
4899,1.0,1.0,0.6666666666666666,782,19596,11730,-7866
4900,0.0,0.0,0.0,782,19600,11730,-7870
4901,1.0,1.0,1.0,783,19604,11745,-7859
4902,0.0,0.0,0.3333333333333333,783,19608,11745,-7863
4903,0.0,0.0,0.0,783,19612,11745,-7867
4904,0.0,0.0,0.0,783,19616,11745,-7871
4905,0.0,0.0,0.0,783,19620,11745,-7875
4906,0.0,0.0,0.0,783,19624,11745,-7879
4907,0.0,0.0,0.0,783,19628,11745,-7883
4908,0.0,0.0,0.0,783,19632,11745,-7887
4909,0.0,0.0,0.0,783,19636,11745,-7891
4910,1.0,1.0,0.75,784,19640,11760,-7880
4911,0.0,0.0,0.0,784,19644,11760,-7884
4912,0.0,0.0,0.0,784,19648,11760,-7888
4913,0.0,0.0,0.0,784,19652,11760,-7892
4914,1.0,0.0,0.4,785,19656,11775,-7881
4915,0.0,0.0,0.0,785,19660,11775,-7885
4916,0.0,0.0,0.0,785,19664,11775,-7889
4917,0.0,0.0,0.0,785,19668,11775,-7893
4918,0.0,0.0,0.0,785,19672,11775,-7897
4919,0.0,0.0,0.0,785,19676,11775,-7901
4920,0.0,0.0,0.0,785,19680,11775,-7905
4921,0.0,0.0,0.0,785,19684,11775,-7909
4922,0.0,0.0,0.0,785,19688,11775,-7913
4923,0.0,0.0,0.0,785,19692,11775,-7917
4924,0.0,0.0,0.0,785,19696,11775,-7921
4925,0.0,0.0,0.0,785,19700,11775,-7925
4926,0.0,0.0,0.0,785,19704,11775,-7929
4927,0.0,0.0,0.0,785,19708,11775,-7933
4928,0.0,0.0,0.0,785,19712,11775,-7937
4929,0.0,0.0,0.0,785,19716,11775,-7941
4930,0.0,0.0,0.0,785,19720,11775,-7945
4931,0.0,0.0,0.0,785,19724,11775,-7949
4932,0.0,0.0,0.0,785,19728,11775,-7953
4933,0.0,0.0,0.0,785,19732,11775,-7957
4934,0.0,0.0,0.25,785,19736,11775,-7961
4935,0.0,0.0,0.0,785,19740,11775,-7965
4936,0.0,0.0,0.0,785,19744,11775,-7969
4937,0.0,0.0,0.0,785,19748,11775,-7973
4938,0.0,0.0,0.0,785,19752,11775,-7977
4939,1.0,1.0,1.0,786,19756,11790,-7966
4940,0.0,0.0,0.0,786,19760,11790,-7970
4941,0.0,0.0,0.0,786,19764,11790,-7974
4942,0.0,0.0,0.0,786,19768,11790,-7978
4943,0.0,0.0,0.0,786,19772,11790,-7982
4944,0.0,0.0,0.0,786,19776,11790,-7986
4945,1.0,1.0,1.0,787,19780,11805,-7975
4946,1.0,1.0,1.0,788,19784,11820,-7964
4947,0.0,0.0,0.0,788,19788,11820,-7968
4948,0.0,0.0,0.0,788,19792,11820,-7972
4949,0.0,0.0,0.0,788,19796,11820,-7976
4950,0.0,0.0,0.0,788,19800,11820,-7980
4951,0.0,0.0,0.0,788,19804,11820,-7984
4952,0.0,0.0,0.0,788,19808,11820,-7988
4953,0.0,0.0,0.0,788,19812,11820,-7992
4954,0.0,0.0,0.0,788,19816,11820,-7996
4955,0.0,0.0,0.0,788,19820,11820,-8000
4956,0.0,0.0,0.0,788,19824,11820,-8004
4957,0.0,0.0,0.0,788,19828,11820,-8008
4958,0.0,0.0,0.0,788,19832,11820,-8012
4959,0.0,0.0,0.0,788,19836,11820,-8016
4960,0.0,0.0,0.0,788,19840,11820,-8020
4961,0.0,0.0,0.0,788,19844,11820,-8024
4962,0.0,0.0,0.0,788,19848,11820,-8028
4963,0.0,0.0,0.0,788,19852,11820,-8032
4964,0.0,0.0,0.0,788,19856,11820,-8036
4965,0.0,0.0,0.0,788,19860,11820,-8040
4966,0.0,0.0,0.0,788,19864,11820,-8044
4967,0.0,0.0,0.0,788,19868,11820,-8048
4968,0.0,0.0,0.0,788,19872,11820,-8052
4969,0.0,0.0,0.4,788,19876,11820,-8056
4970,1.0,1.0,0.6666666666666666,789,19880,11835,-8045
4971,0.0,0.0,0.0,789,19884,11835,-8049
4972,0.0,0.0,0.0,789,19888,11835,-8053
4973,0.0,0.0,0.0,789,19892,11835,-8057
4974,1.0,1.0,1.0,790,19896,11850,-8046
4975,0.0,0.0,0.0,790,19900,11850,-8050
4976,0.0,0.0,0.0,790,19904,11850,-8054
4977,0.0,0.0,0.0,790,19908,11850,-8058
4978,0.0,0.0,0.0,790,19912,11850,-8062
4979,1.0,1.0,1.0,791,19916,11865,-8051
4980,0.0,0.0,0.0,791,19920,11865,-8055
4981,0.0,0.0,0.0,791,19924,11865,-8059
4982,0.0,0.0,0.3333333333333333,791,19928,11865,-8063
4983,1.0,1.0,0.8,792,19932,11880,-8052
4984,0.0,0.0,0.0,792,19936,11880,-8056
4985,0.0,0.0,0.0,792,19940,11880,-8060
4986,0.0,0.0,0.0,792,19944,11880,-8064
4987,0.0,0.0,0.0,792,19948,11880,-8068
4988,0.0,0.0,0.0,792,19952,11880,-8072
4989,0.0,0.0,0.0,792,19956,11880,-8076
4990,1.0,1.0,1.0,793,19960,11895,-8065
4991,0.0,0.0,0.0,793,19964,11895,-8069
4992,0.0,0.0,0.0,793,19968,11895,-8073
4993,0.0,0.0,0.0,793,19972,11895,-8077
4994,0.0,0.0,0.0,793,19976,11895,-8081
4995,0.0,0.0,0.0,793,19980,11895,-8085
4996,0.0,0.0,0.0,793,19984,11895,-8089
4997,0.0,0.0,0.0,793,19988,11895,-8093
4998,0.0,1.0,0.6666666666666666,793,19992,11895,-8097
4999,0.0,0.0,0.0,793,19996,11895,-8101
5000,1.0,1.0,1.0,794,20000,11910,-8090
5001,0.0,0.0,0.0,794,20004,11910,-8094
5002,1.0,1.0,1.0,795,20008,11925,-8083
5003,1.0,0.0,0.4,796,20012,11940,-8072
5004,0.0,0.0,0.0,796,20016,11940,-8076
5005,0.0,0.0,0.0,796,20020,11940,-8080
5006,0.0,0.0,0.0,796,20024,11940,-8084
5007,0.0,0.0,0.0,796,20028,11940,-8088
5008,0.0,0.0,0.0,796,20032,11940,-8092
5009,0.0,0.0,0.0,796,20036,11940,-8096
5010,0.0,0.0,0.0,796,20040,11940,-8100
5011,0.0,0.0,0.0,796,20044,11940,-8104
5012,1.0,1.0,0.6666666666666666,797,20048,11955,-8093
5013,0.0,0.0,0.0,797,20052,11955,-8097
5014,0.0,0.0,0.0,797,20056,11955,-8101
5015,1.0,1.0,1.0,798,20060,11970,-8090
5016,0.0,0.0,0.0,798,20064,11970,-8094
5017,0.0,0.0,0.0,798,20068,11970,-8098
5018,0.0,0.0,0.0,798,20072,11970,-8102
5019,1.0,1.0,1.0,799,20076,11985,-8091
5020,0.0,0.0,0.0,799,20080,11985,-8095
5021,0.0,0.0,0.3333333333333333,799,20084,11985,-8099
5022,0.0,0.0,0.0,799,20088,11985,-8103
5023,0.0,0.0,0.0,799,20092,11985,-8107
5024,0.0,0.0,0.0,799,20096,11985,-8111
5025,1.0,1.0,1.0,800,20100,12000,-8100
5026,0.0,0.0,0.0,800,20104,12000,-8104
5027,0.0,0.0,0.0,800,20108,12000,-8108
5028,0.0,0.0,0.3333333333333333,800,20112,12000,-8112
5029,0.0,0.0,0.0,800,20116,12000,-8116
5030,0.0,0.0,0.0,800,20120,12000,-8120
5031,0.0,0.0,0.0,800,20124,12000,-8124
5032,0.0,0.0,0.0,800,20128,12000,-8128
5033,0.0,0.0,0.0,800,20132,12000,-8132
5034,0.0,0.0,0.0,800,20136,12000,-8136
5035,0.0,0.0,0.0,800,20140,12000,-8140
5036,0.0,0.0,0.0,800,20144,12000,-8144
5037,0.0,0.0,0.0,800,20148,12000,-8148
5038,0.0,0.0,0.0,800,20152,12000,-8152
5039,0.0,0.0,0.0,800,20156,12000,-8156
5040,0.0,0.0,0.0,800,20160,12000,-8160
5041,0.0,0.0,0.0,800,20164,12000,-8164
5042,0.0,0.0,0.0,800,20168,12000,-8168
5043,0.0,0.0,0.0,800,20172,12000,-8172
5044,0.0,0.0,0.0,800,20176,12000,-8176
5045,0.0,0.0,0.0,800,20180,12000,-8180
5046,0.0,0.0,0.0,800,20184,12000,-8184
5047,0.0,0.0,0.0,800,20188,12000,-8188
5048,0.0,0.0,0.0,800,20192,12000,-8192
5049,1.0,1.0,0.6666666666666666,801,20196,12015,-8181
5050,0.0,0.0,0.0,801,20200,12015,-8185
5051,0.0,0.0,0.0,801,20204,12015,-8189
5052,1.0,0.0,0.5,802,20208,12030,-8178
5053,0.0,0.0,0.0,802,20212,12030,-8182
5054,0.0,0.0,0.0,802,20216,12030,-8186
5055,0.0,0.0,0.0,802,20220,12030,-8190
5056,0.0,0.0,0.0,802,20224,12030,-8194
5057,0.0,0.0,0.0,802,20228,12030,-8198
5058,0.0,0.0,0.0,802,20232,12030,-8202
5059,0.0,0.0,0.0,802,20236,12030,-8206
5060,1.0,1.0,1.0,803,20240,12045,-8195
5061,0.0,0.0,0.0,803,20244,12045,-8199
5062,0.0,0.0,0.0,803,20248,12045,-8203
5063,1.0,1.0,1.0,804,20252,12060,-8192
5064,0.0,0.0,0.0,804,20256,12060,-8196
5065,0.0,0.0,0.0,804,20260,12060,-8200
5066,0.0,0.0,0.0,804,20264,12060,-8204
5067,1.0,1.0,1.0,805,20268,12075,-8193
5068,0.0,0.0,0.0,805,20272,12075,-8197
5069,0.0,0.0,0.0,805,20276,12075,-8201
5070,1.0,1.0,1.0,806,20280,12090,-8190
5071,0.0,0.0,0.25,806,20284,12090,-8194
5072,0.0,0.0,0.4,806,20288,12090,-8198
5073,0.0,0.0,0.0,806,20292,12090,-8202
5074,0.0,0.0,0.0,806,20296,12090,-8206
5075,1.0,1.0,0.6666666666666666,807,20300,12105,-8195
5076,0.0,0.0,0.0,807,20304,12105,-8199
5077,0.0,0.0,0.0,807,20308,12105,-8203
5078,1.0,1.0,1.0,808,20312,12120,-8192
5079,0.0,0.0,0.0,808,20316,12120,-8196
5080,0.0,0.0,0.0,808,20320,12120,-8200
5081,1.0,1.0,1.0,809,20324,12135,-8189
5082,0.0,0.0,0.0,809,20328,12135,-8193
5083,0.0,0.0,0.0,809,20332,12135,-8197
5084,0.0,0.0,0.0,809,20336,12135,-8201
5085,0.0,0.0,0.0,809,20340,12135,-8205
5086,1.0,1.0,1.0,810,20344,12150,-8194
5087,0.0,0.0,0.0,810,20348,12150,-8198
5088,0.0,0.0,0.0,810,20352,12150,-8202
5089,0.0,0.0,0.0,810,20356,12150,-8206
5090,0.0,0.0,0.0,810,20360,12150,-8210
5091,0.0,0.0,0.0,810,20364,12150,-8214
5092,0.0,0.0,0.0,810,20368,12150,-8218
5093,1.0,1.0,1.0,811,20372,12165,-8207
5094,0.0,0.0,0.0,811,20376,12165,-8211
5095,0.0,0.0,0.0,811,20380,12165,-8215
5096,0.0,0.0,0.0,811,20384,12165,-8219
5097,0.0,0.0,0.0,811,20388,12165,-8223
5098,0.0,0.0,0.0,811,20392,12165,-8227
5099,0.0,0.0,0.0,811,20396,12165,-8231
5100,0.0,0.0,0.0,811,20400,12165,-8235
5101,0.0,0.0,0.0,811,20404,12165,-8239
5102,0.0,0.0,0.0,811,20408,12165,-8243
5103,0.0,0.0,0.0,811,20412,12165,-8247
5104,0.0,0.0,0.0,811,20416,12165,-8251
5105,0.0,0.0,0.0,811,20420,12165,-8255
5106,1.0,1.0,1.0,812,20424,12180,-8244
5107,0.0,0.0,0.0,812,20428,12180,-8248
5108,0.0,0.0,0.0,812,20432,12180,-8252
5109,0.0,0.0,0.0,812,20436,12180,-8256
5110,0.0,0.0,0.0,812,20440,12180,-8260
5111,0.0,1.0,0.75,812,20444,12180,-8264
5112,0.0,0.0,0.25,812,20448,12180,-8268
5113,0.0,0.0,0.0,812,20452,12180,-8272
5114,0.0,0.0,0.0,812,20456,12180,-8276
5115,0.0,0.0,0.0,812,20460,12180,-8280
5116,0.0,0.0,0.0,812,20464,12180,-8284
5117,0.0,0.0,0.0,812,20468,12180,-8288
5118,0.0,0.0,0.0,812,20472,12180,-8292
5119,0.0,0.0,0.0,812,20476,12180,-8296
5120,0.0,0.0,0.0,812,20480,12180,-8300
5121,0.0,0.0,0.0,812,20484,12180,-8304
5122,1.0,1.0,1.0,813,20488,12195,-8293
5123,0.0,0.0,0.0,813,20492,12195,-8297
5124,1.0,1.0,1.0,814,20496,12210,-8286
5125,0.0,0.0,0.3333333333333333,814,20500,12210,-8290
5126,0.0,0.0,0.0,814,20504,12210,-8294
5127,0.0,0.0,0.0,814,20508,12210,-8298
5128,0.0,0.0,0.0,814,20512,12210,-8302
5129,0.0,0.0,0.0,814,20516,12210,-8306
5130,0.0,0.0,0.0,814,20520,12210,-8310
5131,0.0,0.0,0.2,814,20524,12210,-8314
5132,0.0,0.0,0.0,814,20528,12210,-8318
5133,0.0,0.0,0.0,814,20532,12210,-8322
5134,0.0,0.0,0.0,814,20536,12210,-8326
5135,0.0,0.0,0.0,814,20540,12210,-8330
5136,0.0,0.0,0.0,814,20544,12210,-8334
5137,0.0,0.0,0.0,814,20548,12210,-8338
5138,0.0,0.0,0.0,814,20552,12210,-8342
5139,1.0,1.0,1.0,815,20556,12225,-8331
5140,0.0,0.0,0.0,815,20560,12225,-8335
5141,0.0,0.0,0.0,815,20564,12225,-8339
5142,0.0,0.0,0.0,815,20568,12225,-8343
5143,0.0,0.0,0.0,815,20572,12225,-8347
5144,0.0,0.0,0.0,815,20576,12225,-8351
5145,0.0,0.0,0.0,815,20580,12225,-8355
5146,0.0,0.0,0.0,815,20584,12225,-8359
5147,0.0,0.0,0.0,815,20588,12225,-8363
5148,0.0,0.0,0.0,815,20592,12225,-8367
5149,0.0,0.0,0.0,815,20596,12225,-8371
5150,0.0,0.0,0.0,815,20600,12225,-8375
5151,0.0,0.0,0.0,815,20604,12225,-8379
5152,0.0,0.0,0.0,815,20608,12225,-8383
5153,0.0,0.0,0.0,815,20612,12225,-8387
5154,0.0,0.0,0.0,815,20616,12225,-8391
5155,0.0,0.0,0.0,815,20620,12225,-8395
5156,0.0,0.0,0.0,815,20624,12225,-8399
5157,0.0,0.0,0.0,815,20628,12225,-8403
5158,0.0,0.0,0.0,815,20632,12225,-8407
5159,0.0,0.0,0.0,815,20636,12225,-8411
5160,0.0,0.0,0.0,815,20640,12225,-8415
5161,0.0,0.0,0.0,815,20644,12225,-8419
5162,0.0,0.0,0.0,815,20648,12225,-8423
5163,0.0,0.0,0.0,815,20652,12225,-8427
5164,0.0,0.0,0.0,815,20656,12225,-8431
5165,0.0,0.0,0.0,815,20660,12225,-8435
5166,0.0,0.0,0.0,815,20664,12225,-8439
5167,0.0,0.0,0.0,815,20668,12225,-8443
5168,0.0,0.0,0.0,815,20672,12225,-8447
5169,1.0,1.0,0.6666666666666666,816,20676,12240,-8436
5170,0.0,0.0,0.0,816,20680,12240,-8440
5171,0.0,0.0,0.0,816,20684,12240,-8444
5172,1.0,1.0,1.0,817,20688,12255,-8433
5173,0.0,0.0,0.0,817,20692,12255,-8437
5174,0.0,0.0,0.0,817,20696,12255,-8441
5175,0.0,0.0,0.0,817,20700,12255,-8445
5176,1.0,1.0,1.0,818,20704,12270,-8434
5177,0.0,0.0,0.0,818,20708,12270,-8438
5178,0.0,0.0,0.0,818,20712,12270,-8442
5179,0.0,0.0,0.0,818,20716,12270,-8446
5180,1.0,1.0,1.0,819,20720,12285,-8435
5181,0.0,0.0,0.0,819,20724,12285,-8439
5182,0.0,0.0,0.0,819,20728,12285,-8443
5183,0.0,0.0,0.0,819,20732,12285,-8447
5184,0.0,0.0,0.0,819,20736,12285,-8451
5185,1.0,1.0,1.0,820,20740,12300,-8440
5186,0.0,0.0,0.0,820,20744,12300,-8444
5187,1.0,0.0,0.25,821,20748,12315,-8433
5188,0.0,0.0,0.0,821,20752,12315,-8437
5189,1.0,1.0,1.0,822,20756,12330,-8426
5190,1.0,1.0,0.75,823,20760,12345,-8415
5191,0.0,0.0,0.0,823,20764,12345,-8419
5192,0.0,0.0,0.0,823,20768,12345,-8423
5193,0.0,0.0,0.0,823,20772,12345,-8427
5194,0.0,0.0,0.0,823,20776,12345,-8431
5195,0.0,0.0,0.0,823,20780,12345,-8435
5196,0.0,0.0,0.0,823,20784,12345,-8439
5197,0.0,0.0,0.0,823,20788,12345,-8443
5198,0.0,0.0,0.0,823,20792,12345,-8447
5199,0.0,0.0,0.0,823,20796,12345,-8451
5200,0.0,0.0,0.0,823,20800,12345,-8455
5201,0.0,0.0,0.0,823,20804,12345,-8459
5202,0.0,0.0,0.0,823,20808,12345,-8463
5203,0.0,0.0,0.0,823,20812,12345,-8467
5204,0.0,0.0,0.0,823,20816,12345,-8471
5205,0.0,0.0,0.0,823,20820,12345,-8475
5206,0.0,0.0,0.0,823,20824,12345,-8479
5207,0.0,0.0,0.0,823,20828,12345,-8483
5208,0.0,0.0,0.0,823,20832,12345,-8487
5209,0.0,0.0,0.0,823,20836,12345,-8491
5210,0.0,0.0,0.0,823,20840,12345,-8495
5211,0.0,0.0,0.0,823,20844,12345,-8499
5212,0.0,0.0,0.0,823,20848,12345,-8503
5213,1.0,1.0,1.0,824,20852,12360,-8492
5214,0.0,0.0,0.4,824,20856,12360,-8496
5215,0.0,0.0,0.0,824,20860,12360,-8500
5216,0.0,0.0,0.0,824,20864,12360,-8504
5217,0.0,0.0,0.0,824,20868,12360,-8508
5218,1.0,1.0,1.0,825,20872,12375,-8497
5219,1.0,1.0,0.6,826,20876,12390,-8486
5220,1.0,1.0,1.0,827,20880,12405,-8475
5221,0.0,0.0,0.0,827,20884,12405,-8479
5222,0.0,0.0,0.0,827,20888,12405,-8483
5223,0.0,0.0,0.0,827,20892,12405,-8487
5224,0.0,0.0,0.0,827,20896,12405,-8491
5225,0.0,0.0,0.0,827,20900,12405,-8495
5226,1.0,1.0,1.0,828,20904,12420,-8484
5227,0.0,0.0,0.0,828,20908,12420,-8488
5228,0.0,0.0,0.0,828,20912,12420,-8492
5229,0.0,0.0,0.0,828,20916,12420,-8496
5230,0.0,0.0,0.0,828,20920,12420,-8500
5231,0.0,0.0,0.0,828,20924,12420,-8504
5232,0.0,0.0,0.0,828,20928,12420,-8508
5233,0.0,0.0,0.0,828,20932,12420,-8512
5234,0.0,0.0,0.0,828,20936,12420,-8516
5235,0.0,0.0,0.0,828,20940,12420,-8520
5236,0.0,0.0,0.0,828,20944,12420,-8524
5237,0.0,0.0,0.0,828,20948,12420,-8528
5238,0.0,0.0,0.0,828,20952,12420,-8532
5239,0.0,0.0,0.0,828,20956,12420,-8536
5240,0.0,0.0,0.0,828,20960,12420,-8540
5241,0.0,0.0,0.0,828,20964,12420,-8544
5242,0.0,0.0,0.0,828,20968,12420,-8548
5243,0.0,0.0,0.0,828,20972,12420,-8552
5244,0.0,0.0,0.0,828,20976,12420,-8556
5245,0.0,0.0,0.0,828,20980,12420,-8560
5246,0.0,0.0,0.0,828,20984,12420,-8564
5247,0.0,0.0,0.0,828,20988,12420,-8568
5248,0.0,0.0,0.0,828,20992,12420,-8572
5249,0.0,0.0,0.0,828,20996,12420,-8576
5250,1.0,1.0,1.0,829,21000,12435,-8565
5251,0.0,0.0,0.0,829,21004,12435,-8569
5252,0.0,0.0,0.0,829,21008,12435,-8573
5253,0.0,0.0,0.0,829,21012,12435,-8577
5254,0.0,0.0,0.0,829,21016,12435,-8581
5255,0.0,0.0,0.0,829,21020,12435,-8585
5256,0.0,0.0,0.0,829,21024,12435,-8589
5257,1.0,1.0,1.0,830,21028,12450,-8578
5258,0.0,0.0,0.3333333333333333,830,21032,12450,-8582
5259,0.0,0.0,0.0,830,21036,12450,-8586
5260,0.0,0.0,0.0,830,21040,12450,-8590
5261,1.0,1.0,1.0,831,21044,12465,-8579
5262,0.0,0.0,0.0,831,21048,12465,-8583
5263,0.0,0.0,0.0,831,21052,12465,-8587
5264,1.0,1.0,1.0,832,21056,12480,-8576
5265,0.0,0.0,0.0,832,21060,12480,-8580
5266,0.0,0.0,0.0,832,21064,12480,-8584
5267,0.0,0.0,0.0,832,21068,12480,-8588
5268,0.0,0.0,0.3333333333333333,832,21072,12480,-8592
5269,1.0,0.0,0.3333333333333333,833,21076,12495,-8581
5270,0.0,0.0,0.0,833,21080,12495,-8585
5271,0.0,0.0,0.3333333333333333,833,21084,12495,-8589
5272,0.0,0.0,0.0,833,21088,12495,-8593
5273,1.0,1.0,1.0,834,21092,12510,-8582
5274,0.0,0.0,0.0,834,21096,12510,-8586
5275,0.0,0.0,0.0,834,21100,12510,-8590
5276,0.0,0.0,0.0,834,21104,12510,-8594
5277,0.0,0.0,0.0,834,21108,12510,-8598
5278,1.0,0.0,0.3333333333333333,835,21112,12525,-8587
5279,0.0,0.0,0.0,835,21116,12525,-8591
5280,0.0,0.0,0.0,835,21120,12525,-8595
5281,0.0,0.0,0.0,835,21124,12525,-8599
5282,1.0,1.0,1.0,836,21128,12540,-8588
5283,0.0,0.0,0.0,836,21132,12540,-8592
5284,0.0,0.0,0.0,836,21136,12540,-8596
5285,0.0,0.0,0.0,836,21140,12540,-8600
5286,0.0,0.0,0.0,836,21144,12540,-8604
5287,1.0,1.0,1.0,837,21148,12555,-8593
5288,0.0,0.0,0.0,837,21152,12555,-8597
5289,1.0,1.0,1.0,838,21156,12570,-8586
5290,0.0,0.0,0.0,838,21160,12570,-8590
5291,0.0,0.0,0.0,838,21164,12570,-8594
5292,0.0,0.0,0.0,838,21168,12570,-8598
5293,0.0,0.0,0.3333333333333333,838,21172,12570,-8602
5294,0.0,0.0,0.0,838,21176,12570,-8606
5295,0.0,0.0,0.0,838,21180,12570,-8610
5296,0.0,0.0,0.5,838,21184,12570,-8614
5297,0.0,0.0,0.0,838,21188,12570,-8618
5298,0.0,0.0,0.0,838,21192,12570,-8622
5299,0.0,0.0,0.0,838,21196,12570,-8626
5300,0.0,0.0,0.0,838,21200,12570,-8630
5301,1.0,1.0,1.0,839,21204,12585,-8619
5302,1.0,1.0,1.0,840,21208,12600,-8608
5303,0.0,0.0,0.0,840,21212,12600,-8612
5304,1.0,1.0,1.0,841,21216,12615,-8601
5305,0.0,0.0,0.0,841,21220,12615,-8605
5306,0.0,0.0,0.0,841,21224,12615,-8609
5307,0.0,0.0,0.0,841,21228,12615,-8613
5308,0.0,0.0,0.0,841,21232,12615,-8617
5309,0.0,0.0,0.0,841,21236,12615,-8621
5310,0.0,0.0,0.0,841,21240,12615,-8625
5311,0.0,0.0,0.0,841,21244,12615,-8629
5312,0.0,0.0,0.0,841,21248,12615,-8633
5313,0.0,0.0,0.0,841,21252,12615,-8637
5314,0.0,0.0,0.0,841,21256,12615,-8641
5315,0.0,0.0,0.0,841,21260,12615,-8645
5316,1.0,1.0,1.0,842,21264,12630,-8634
5317,0.0,0.0,0.0,842,21268,12630,-8638
5318,0.0,0.0,0.0,842,21272,12630,-8642
5319,0.0,0.0,0.0,842,21276,12630,-8646
5320,0.0,0.0,0.0,842,21280,12630,-8650
5321,0.0,0.0,0.0,842,21284,12630,-8654
5322,0.0,0.0,0.0,842,21288,12630,-8658
5323,0.0,0.0,0.0,842,21292,12630,-8662
5324,0.0,0.0,0.0,842,21296,12630,-8666
5325,1.0,1.0,1.0,843,21300,12645,-8655
5326,0.0,0.0,0.25,843,21304,12645,-8659
5327,0.0,0.0,0.0,843,21308,12645,-8663
5328,0.0,0.0,0.0,843,21312,12645,-8667
5329,0.0,0.0,0.0,843,21316,12645,-8671
5330,1.0,0.0,0.3333333333333333,844,21320,12660,-8660
5331,0.0,0.0,0.0,844,21324,12660,-8664
5332,0.0,0.0,0.0,844,21328,12660,-8668
5333,0.0,0.0,0.0,844,21332,12660,-8672
5334,0.0,0.0,0.0,844,21336,12660,-8676
5335,0.0,0.0,0.0,844,21340,12660,-8680
5336,0.0,0.0,0.0,844,21344,12660,-8684
5337,0.0,0.0,0.0,844,21348,12660,-8688
5338,0.0,0.0,0.0,844,21352,12660,-8692
5339,1.0,1.0,1.0,845,21356,12675,-8681
5340,0.0,0.0,0.0,845,21360,12675,-8685
5341,0.0,1.0,0.75,845,21364,12675,-8689
5342,0.0,0.0,0.0,845,21368,12675,-8693
5343,0.0,0.0,0.0,845,21372,12675,-8697
5344,0.0,0.0,0.0,845,21376,12675,-8701
5345,0.0,0.0,0.0,845,21380,12675,-8705
5346,0.0,0.0,0.0,845,21384,12675,-8709
5347,1.0,1.0,1.0,846,21388,12690,-8698
5348,0.0,0.0,0.0,846,21392,12690,-8702
5349,0.0,0.0,0.0,846,21396,12690,-8706
5350,0.0,0.0,0.0,846,21400,12690,-8710
5351,0.0,0.0,0.0,846,21404,12690,-8714
5352,0.0,0.0,0.0,846,21408,12690,-8718
5353,0.0,0.0,0.0,846,21412,12690,-8722
5354,0.0,0.0,0.0,846,21416,12690,-8726
5355,0.0,0.0,0.3333333333333333,846,21420,12690,-8730
5356,1.0,0.0,0.3333333333333333,847,21424,12705,-8719
5357,1.0,1.0,1.0,848,21428,12720,-8708
5358,0.0,0.0,0.0,848,21432,12720,-8712
5359,0.0,0.0,0.0,848,21436,12720,-8716
5360,0.0,0.0,0.0,848,21440,12720,-8720
5361,1.0,1.0,1.0,849,21444,12735,-8709
5362,0.0,0.0,0.0,849,21448,12735,-8713
5363,0.0,0.0,0.0,849,21452,12735,-8717
5364,0.0,0.0,0.0,849,21456,12735,-8721
5365,0.0,0.0,0.0,849,21460,12735,-8725
5366,0.0,0.0,0.0,849,21464,12735,-8729
5367,0.0,0.0,0.0,849,21468,12735,-8733
5368,0.0,0.0,0.0,849,21472,12735,-8737
5369,0.0,0.0,0.0,849,21476,12735,-8741
5370,0.0,0.0,0.0,849,21480,12735,-8745
5371,0.0,0.0,0.0,849,21484,12735,-8749
5372,0.0,0.0,0.0,849,21488,12735,-8753
5373,0.0,0.0,0.0,849,21492,12735,-8757
5374,0.0,0.0,0.0,849,21496,12735,-8761
5375,1.0,0.0,0.4,850,21500,12750,-8750
5376,0.0,0.0,0.0,850,21504,12750,-8754
5377,0.0,0.0,0.0,850,21508,12750,-8758
5378,0.0,0.0,0.0,850,21512,12750,-8762
5379,0.0,0.0,0.0,850,21516,12750,-8766
5380,0.0,0.0,0.0,850,21520,12750,-8770
5381,0.0,0.0,0.0,850,21524,12750,-8774
5382,0.0,0.0,0.0,850,21528,12750,-8778
5383,1.0,1.0,1.0,851,21532,12765,-8767
5384,0.0,0.0,0.0,851,21536,12765,-8771
5385,0.0,0.0,0.0,851,21540,12765,-8775
5386,0.0,0.0,0.0,851,21544,12765,-8779
5387,0.0,0.0,0.0,851,21548,12765,-8783
5388,0.0,0.0,0.0,851,21552,12765,-8787
5389,0.0,0.0,0.0,851,21556,12765,-8791
5390,0.0,0.0,0.0,851,21560,12765,-8795
5391,0.0,0.0,0.0,851,21564,12765,-8799
5392,0.0,0.0,0.0,851,21568,12765,-8803
5393,0.0,0.0,0.0,851,21572,12765,-8807
5394,0.0,0.0,0.0,851,21576,12765,-8811
5395,0.0,0.0,0.0,851,21580,12765,-8815
5396,0.0,0.0,0.0,851,21584,12765,-8819
5397,0.0,0.0,0.0,851,21588,12765,-8823
5398,0.0,0.0,0.0,851,21592,12765,-8827
5399,0.0,0.0,0.0,851,21596,12765,-8831
5400,0.0,0.0,0.0,851,21600,12765,-8835
5401,0.0,0.0,0.0,851,21604,12765,-8839
5402,0.0,0.0,0.0,851,21608,12765,-8843
5403,1.0,1.0,1.0,852,21612,12780,-8832
5404,1.0,1.0,1.0,853,21616,12795,-8821
5405,0.0,0.0,0.0,853,21620,12795,-8825
5406,0.0,1.0,0.6666666666666666,853,21624,12795,-8829
5407,0.0,0.0,0.0,853,21628,12795,-8833
5408,0.0,0.0,0.0,853,21632,12795,-8837
5409,0.0,0.0,0.0,853,21636,12795,-8841
5410,1.0,1.0,1.0,854,21640,12810,-8830
5411,0.0,0.0,0.0,854,21644,12810,-8834
5412,0.0,0.0,0.0,854,21648,12810,-8838
5413,0.0,0.0,0.0,854,21652,12810,-8842
5414,0.0,0.0,0.0,854,21656,12810,-8846
5415,1.0,1.0,1.0,855,21660,12825,-8835
5416,0.0,0.0,0.0,855,21664,12825,-8839
5417,0.0,0.0,0.0,855,21668,12825,-8843
5418,0.0,0.0,0.0,855,21672,12825,-8847
5419,0.0,0.0,0.0,855,21676,12825,-8851
5420,0.0,0.0,0.0,855,21680,12825,-8855
5421,0.0,0.0,0.0,855,21684,12825,-8859
5422,0.0,0.0,0.0,855,21688,12825,-8863
5423,0.0,0.0,0.0,855,21692,12825,-8867
5424,0.0,0.0,0.0,855,21696,12825,-8871
5425,0.0,0.0,0.0,855,21700,12825,-8875
5426,0.0,0.0,0.0,855,21704,12825,-8879
5427,1.0,1.0,1.0,856,21708,12840,-8868
5428,0.0,0.0,0.0,856,21712,12840,-8872
5429,0.0,0.0,0.0,856,21716,12840,-8876
5430,0.0,0.0,0.0,856,21720,12840,-8880
5431,0.0,0.0,0.0,856,21724,12840,-8884
5432,0.0,0.0,0.0,856,21728,12840,-8888
5433,0.0,0.0,0.0,856,21732,12840,-8892
5434,1.0,1.0,0.75,857,21736,12855,-8881
5435,0.0,0.0,0.0,857,21740,12855,-8885
5436,0.0,0.0,0.0,857,21744,12855,-8889
5437,0.0,0.0,0.0,857,21748,12855,-8893
5438,1.0,0.0,0.3333333333333333,858,21752,12870,-8882
5439,0.0,0.0,0.0,858,21756,12870,-8886
5440,0.0,0.0,0.0,858,21760,12870,-8890
5441,0.0,0.0,0.0,858,21764,12870,-8894
5442,0.0,0.0,0.0,858,21768,12870,-8898
5443,0.0,0.0,0.2,858,21772,12870,-8902
5444,0.0,0.0,0.0,858,21776,12870,-8906
5445,0.0,0.0,0.0,858,21780,12870,-8910
5446,0.0,0.0,0.0,858,21784,12870,-8914
5447,0.0,0.0,0.0,858,21788,12870,-8918
5448,0.0,0.0,0.0,858,21792,12870,-8922
5449,0.0,0.0,0.0,858,21796,12870,-8926
5450,0.0,0.0,0.0,858,21800,12870,-8930
5451,0.0,0.0,0.0,858,21804,12870,-8934
5452,0.0,0.0,0.0,858,21808,12870,-8938
5453,0.0,0.0,0.0,858,21812,12870,-8942
5454,0.0,0.0,0.0,858,21816,12870,-8946
5455,0.0,0.0,0.0,858,21820,12870,-8950
5456,1.0,1.0,1.0,859,21824,12885,-8939
5457,0.0,0.0,0.0,859,21828,12885,-8943
5458,0.0,0.0,0.0,859,21832,12885,-8947
5459,0.0,0.0,0.0,859,21836,12885,-8951
5460,0.0,0.0,0.0,859,21840,12885,-8955
5461,0.0,0.0,0.0,859,21844,12885,-8959
5462,0.0,0.0,0.0,859,21848,12885,-8963
5463,1.0,0.0,0.4,860,21852,12900,-8952
5464,0.0,0.0,0.0,860,21856,12900,-8956
5465,0.0,0.0,0.0,860,21860,12900,-8960
5466,0.0,0.0,0.0,860,21864,12900,-8964
5467,0.0,0.0,0.0,860,21868,12900,-8968
5468,1.0,0.0,0.4,861,21872,12915,-8957
5469,1.0,1.0,0.75,862,21876,12930,-8946
5470,1.0,1.0,1.0,863,21880,12945,-8935
5471,0.0,0.0,0.0,863,21884,12945,-8939
5472,0.0,0.0,0.0,863,21888,12945,-8943
5473,0.0,0.0,0.0,863,21892,12945,-8947
5474,0.0,0.0,0.0,863,21896,12945,-8951
5475,1.0,1.0,1.0,864,21900,12960,-8940
5476,0.0,0.0,0.0,864,21904,12960,-8944
5477,0.0,0.0,0.0,864,21908,12960,-8948
5478,1.0,1.0,1.0,865,21912,12975,-8937
5479,1.0,1.0,1.0,866,21916,12990,-8926
5480,0.0,0.0,0.0,866,21920,12990,-8930
5481,0.0,0.0,0.0,866,21924,12990,-8934
5482,0.0,0.0,0.4,866,21928,12990,-8938
5483,0.0,0.0,0.0,866,21932,12990,-8942
5484,1.0,1.0,1.0,867,21936,13005,-8931
5485,0.0,0.0,0.0,867,21940,13005,-8935
5486,0.0,0.0,0.0,867,21944,13005,-8939
5487,0.0,0.0,0.0,867,21948,13005,-8943
5488,0.0,0.0,0.0,867,21952,13005,-8947
5489,0.0,0.0,0.0,867,21956,13005,-8951
5490,1.0,1.0,1.0,868,21960,13020,-8940
5491,0.0,0.0,0.0,868,21964,13020,-8944
5492,0.0,0.0,0.0,868,21968,13020,-8948
5493,0.0,0.0,0.0,868,21972,13020,-8952
5494,0.0,0.0,0.0,868,21976,13020,-8956
5495,0.0,0.0,0.0,868,21980,13020,-8960
5496,0.0,0.0,0.0,868,21984,13020,-8964
5497,0.0,0.0,0.0,868,21988,13020,-8968
5498,0.0,0.0,0.0,868,21992,13020,-8972
5499,0.0,0.0,0.0,868,21996,13020,-8976
5500,1.0,1.0,1.0,869,22000,13035,-8965
5501,0.0,0.0,0.0,869,22004,13035,-8969
5502,0.0,0.0,0.0,869,22008,13035,-8973
5503,0.0,0.0,0.0,869,22012,13035,-8977
5504,0.0,0.0,0.0,869,22016,13035,-8981
5505,0.0,0.0,0.0,869,22020,13035,-8985
5506,0.0,0.0,0.0,869,22024,13035,-8989
5507,0.0,0.0,0.0,869,22028,13035,-8993
5508,0.0,0.0,0.4,869,22032,13035,-8997
5509,0.0,0.0,0.0,869,22036,13035,-9001
5510,0.0,0.0,0.0,869,22040,13035,-9005
5511,0.0,0.0,0.0,869,22044,13035,-9009
5512,0.0,0.0,0.0,869,22048,13035,-9013
5513,0.0,0.0,0.0,869,22052,13035,-9017
5514,0.0,0.0,0.0,869,22056,13035,-9021
5515,0.0,0.0,0.0,869,22060,13035,-9025
5516,0.0,0.0,0.0,869,22064,13035,-9029
5517,0.0,0.0,0.0,869,22068,13035,-9033
5518,0.0,0.0,0.0,869,22072,13035,-9037
5519,0.0,0.0,0.0,869,22076,13035,-9041
5520,0.0,0.0,0.0,869,22080,13035,-9045
5521,0.0,0.0,0.0,869,22084,13035,-9049
5522,1.0,0.0,0.3333333333333333,870,22088,13050,-9038
5523,0.0,0.0,0.0,870,22092,13050,-9042
5524,0.0,0.0,0.0,870,22096,13050,-9046
5525,1.0,1.0,1.0,871,22100,13065,-9035
5526,1.0,1.0,0.6666666666666666,872,22104,13080,-9024
5527,0.0,0.0,0.2,872,22108,13080,-9028
5528,0.0,0.0,0.0,872,22112,13080,-9032
5529,0.0,0.0,0.0,872,22116,13080,-9036
5530,0.0,0.0,0.3333333333333333,872,22120,13080,-9040
5531,1.0,1.0,0.6666666666666666,873,22124,13095,-9029
5532,0.0,0.0,0.0,873,22128,13095,-9033
5533,0.0,0.0,0.0,873,22132,13095,-9037
5534,0.0,0.0,0.0,873,22136,13095,-9041
5535,0.0,0.0,0.0,873,22140,13095,-9045
5536,0.0,0.0,0.0,873,22144,13095,-9049
5537,0.0,0.0,0.0,873,22148,13095,-9053
5538,0.0,0.0,0.0,873,22152,13095,-9057
5539,0.0,0.0,0.0,873,22156,13095,-9061
5540,0.0,0.0,0.0,873,22160,13095,-9065
5541,0.0,0.0,0.0,873,22164,13095,-9069
5542,1.0,1.0,1.0,874,22168,13110,-9058
5543,0.0,0.0,0.0,874,22172,13110,-9062
5544,0.0,0.0,0.0,874,22176,13110,-9066
5545,0.0,0.0,0.0,874,22180,13110,-9070
5546,0.0,0.0,0.0,874,22184,13110,-9074
5547,1.0,1.0,1.0,875,22188,13125,-9063
5548,0.0,0.0,0.0,875,22192,13125,-9067
5549,0.0,0.0,0.0,875,22196,13125,-9071
5550,0.0,0.0,0.0,875,22200,13125,-9075
5551,0.0,0.0,0.0,875,22204,13125,-9079
5552,0.0,0.0,0.0,875,22208,13125,-9083
5553,0.0,0.0,0.0,875,22212,13125,-9087
5554,0.0,0.0,0.0,875,22216,13125,-9091
5555,0.0,0.0,0.0,875,22220,13125,-9095
5556,0.0,0.0,0.0,875,22224,13125,-9099
5557,0.0,0.0,0.0,875,22228,13125,-9103
5558,0.0,0.0,0.0,875,22232,13125,-9107
5559,0.0,0.0,0.0,875,22236,13125,-9111
5560,0.0,0.0,0.3333333333333333,875,22240,13125,-9115
5561,1.0,1.0,0.75,876,22244,13140,-9104
5562,0.0,0.0,0.0,876,22248,13140,-9108
5563,0.0,0.0,0.0,876,22252,13140,-9112
5564,0.0,0.0,0.0,876,22256,13140,-9116
5565,0.0,0.0,0.0,876,22260,13140,-9120
5566,0.0,0.0,0.0,876,22264,13140,-9124
5567,0.0,0.0,0.0,876,22268,13140,-9128
5568,1.0,1.0,0.6666666666666666,877,22272,13155,-9117
5569,0.0,0.0,0.0,877,22276,13155,-9121
5570,1.0,1.0,1.0,878,22280,13170,-9110
5571,0.0,0.0,0.0,878,22284,13170,-9114
5572,0.0,0.0,0.0,878,22288,13170,-9118
5573,1.0,1.0,1.0,879,22292,13185,-9107
5574,0.0,0.0,0.0,879,22296,13185,-9111
5575,0.0,0.0,0.0,879,22300,13185,-9115
5576,0.0,0.0,0.0,879,22304,13185,-9119
5577,0.0,0.0,0.0,879,22308,13185,-9123
5578,0.0,0.0,0.0,879,22312,13185,-9127
5579,0.0,0.0,0.0,879,22316,13185,-9131
5580,0.0,0.0,0.0,879,22320,13185,-9135
5581,0.0,0.0,0.0,879,22324,13185,-9139
5582,0.0,0.0,0.0,879,22328,13185,-9143
5583,0.0,0.0,0.0,879,22332,13185,-9147
5584,0.0,0.0,0.0,879,22336,13185,-9151
5585,1.0,1.0,1.0,880,22340,13200,-9140
5586,0.0,0.0,0.0,880,22344,13200,-9144
5587,0.0,0.0,0.0,880,22348,13200,-9148
5588,0.0,0.0,0.0,880,22352,13200,-9152
5589,0.0,0.0,0.0,880,22356,13200,-9156
5590,0.0,0.0,0.0,880,22360,13200,-9160
5591,0.0,0.0,0.0,880,22364,13200,-9164
5592,0.0,0.0,0.3333333333333333,880,22368,13200,-9168
5593,0.0,0.0,0.0,880,22372,13200,-9172
5594,1.0,1.0,0.8,881,22376,13215,-9161
5595,0.0,0.0,0.0,881,22380,13215,-9165
5596,0.0,0.0,0.0,881,22384,13215,-9169
5597,0.0,0.0,0.0,881,22388,13215,-9173
5598,1.0,1.0,1.0,882,22392,13230,-9162
5599,0.0,0.0,0.0,882,22396,13230,-9166
5600,0.0,0.0,0.0,882,22400,13230,-9170
5601,1.0,1.0,0.6666666666666666,883,22404,13245,-9159
5602,0.0,0.0,0.25,883,22408,13245,-9163
5603,0.0,0.0,0.3333333333333333,883,22412,13245,-9167
5604,0.0,0.0,0.0,883,22416,13245,-9171
5605,1.0,1.0,1.0,884,22420,13260,-9160
5606,0.0,0.0,0.0,884,22424,13260,-9164
5607,0.0,0.0,0.0,884,22428,13260,-9168
5608,0.0,0.0,0.0,884,22432,13260,-9172
5609,0.0,0.0,0.0,884,22436,13260,-9176
5610,0.0,0.0,0.0,884,22440,13260,-9180
5611,0.0,0.0,0.0,884,22444,13260,-9184
5612,0.0,0.0,0.0,884,22448,13260,-9188
5613,0.0,0.0,0.0,884,22452,13260,-9192
5614,0.0,0.0,0.0,884,22456,13260,-9196
5615,0.0,0.0,0.0,884,22460,13260,-9200
5616,1.0,1.0,1.0,885,22464,13275,-9189
5617,0.0,0.0,0.0,885,22468,13275,-9193
5618,0.0,0.0,0.0,885,22472,13275,-9197
5619,0.0,0.0,0.0,885,22476,13275,-9201
5620,0.0,0.0,0.0,885,22480,13275,-9205
5621,0.0,0.0,0.0,885,22484,13275,-9209
5622,1.0,1.0,1.0,886,22488,13290,-9198
5623,0.0,0.0,0.0,886,22492,13290,-9202
5624,0.0,0.0,0.0,886,22496,13290,-9206
5625,0.0,0.0,0.0,886,22500,13290,-9210
5626,0.0,0.0,0.0,886,22504,13290,-9214
5627,0.0,0.0,0.2,886,22508,13290,-9218
5628,0.0,0.0,0.0,886,22512,13290,-9222
5629,0.0,0.0,0.0,886,22516,13290,-9226
5630,0.0,0.0,0.0,886,22520,13290,-9230
5631,1.0,1.0,0.6666666666666666,887,22524,13305,-9219
5632,0.0,0.0,0.0,887,22528,13305,-9223
5633,0.0,0.0,0.0,887,22532,13305,-9227
5634,0.0,0.0,0.0,887,22536,13305,-9231
5635,0.0,0.0,0.0,887,22540,13305,-9235
5636,0.0,0.0,0.0,887,22544,13305,-9239
5637,1.0,0.0,0.3333333333333333,888,22548,13320,-9228
5638,0.0,0.0,0.0,888,22552,13320,-9232
5639,0.0,0.0,0.0,888,22556,13320,-9236
5640,0.0,0.0,0.0,888,22560,13320,-9240
5641,0.0,0.0,0.0,888,22564,13320,-9244
5642,1.0,1.0,1.0,889,22568,13335,-9233
5643,1.0,1.0,1.0,890,22572,13350,-9222
5644,0.0,0.0,0.2,890,22576,13350,-9226
5645,0.0,0.0,0.0,890,22580,13350,-9230
5646,0.0,0.0,0.0,890,22584,13350,-9234
5647,0.0,0.0,0.0,890,22588,13350,-9238
5648,0.0,0.0,0.0,890,22592,13350,-9242
5649,1.0,1.0,1.0,891,22596,13365,-9231
5650,0.0,0.0,0.0,891,22600,13365,-9235
5651,0.0,0.0,0.0,891,22604,13365,-9239
5652,0.0,0.0,0.0,891,22608,13365,-9243
5653,0.0,0.0,0.0,891,22612,13365,-9247
5654,0.0,0.0,0.0,891,22616,13365,-9251
5655,0.0,0.0,0.0,891,22620,13365,-9255
5656,0.0,0.0,0.0,891,22624,13365,-9259
5657,0.0,0.0,0.0,891,22628,13365,-9263
5658,0.0,0.0,0.0,891,22632,13365,-9267
5659,0.0,0.0,0.0,891,22636,13365,-9271
5660,0.0,0.0,0.0,891,22640,13365,-9275
5661,0.0,0.0,0.0,891,22644,13365,-9279
5662,0.0,0.0,0.0,891,22648,13365,-9283
5663,0.0,0.0,0.0,891,22652,13365,-9287
5664,1.0,1.0,1.0,892,22656,13380,-9276
5665,0.0,0.0,0.0,892,22660,13380,-9280
5666,0.0,0.0,0.0,892,22664,13380,-9284
5667,0.0,0.0,0.0,892,22668,13380,-9288
5668,0.0,0.0,0.0,892,22672,13380,-9292
5669,0.0,0.0,0.0,892,22676,13380,-9296
5670,0.0,0.0,0.3333333333333333,892,22680,13380,-9300
5671,0.0,0.0,0.0,892,22684,13380,-9304
5672,0.0,0.0,0.0,892,22688,13380,-9308
5673,0.0,0.0,0.0,892,22692,13380,-9312
5674,0.0,0.0,0.0,892,22696,13380,-9316
5675,0.0,0.0,0.0,892,22700,13380,-9320
5676,0.0,0.0,0.0,892,22704,13380,-9324
5677,0.0,0.0,0.0,892,22708,13380,-9328
5678,0.0,0.0,0.0,892,22712,13380,-9332
5679,0.0,0.0,0.0,892,22716,13380,-9336
5680,0.0,0.0,0.0,892,22720,13380,-9340
5681,0.0,0.0,0.0,892,22724,13380,-9344
5682,0.0,0.0,0.0,892,22728,13380,-9348
5683,1.0,1.0,1.0,893,22732,13395,-9337
5684,0.0,0.0,0.0,893,22736,13395,-9341
5685,0.0,0.0,0.0,893,22740,13395,-9345
5686,0.0,0.0,0.0,893,22744,13395,-9349
5687,0.0,0.0,0.0,893,22748,13395,-9353
5688,0.0,0.0,0.0,893,22752,13395,-9357
5689,0.0,0.0,0.0,893,22756,13395,-9361
5690,0.0,0.0,0.0,893,22760,13395,-9365
5691,0.0,0.0,0.0,893,22764,13395,-9369
5692,1.0,1.0,1.0,894,22768,13410,-9358
5693,1.0,1.0,1.0,895,22772,13425,-9347
5694,0.0,0.0,0.0,895,22776,13425,-9351
5695,0.0,0.0,0.0,895,22780,13425,-9355
5696,0.0,0.0,0.0,895,22784,13425,-9359
5697,0.0,0.0,0.0,895,22788,13425,-9363
5698,0.0,0.0,0.0,895,22792,13425,-9367
5699,0.0,0.0,0.0,895,22796,13425,-9371
5700,0.0,0.0,0.0,895,22800,13425,-9375
5701,0.0,0.0,0.0,895,22804,13425,-9379
5702,1.0,1.0,1.0,896,22808,13440,-9368
5703,0.0,0.0,0.0,896,22812,13440,-9372
5704,0.0,0.0,0.0,896,22816,13440,-9376
5705,0.0,0.0,0.0,896,22820,13440,-9380
5706,0.0,0.0,0.0,896,22824,13440,-9384
5707,0.0,0.0,0.0,896,22828,13440,-9388
5708,0.0,0.0,0.0,896,22832,13440,-9392
5709,0.0,0.0,0.0,896,22836,13440,-9396
5710,0.0,0.0,0.0,896,22840,13440,-9400
5711,0.0,0.0,0.0,896,22844,13440,-9404
5712,0.0,0.0,0.0,896,22848,13440,-9408
5713,1.0,1.0,1.0,897,22852,13455,-9397
5714,0.0,0.0,0.0,897,22856,13455,-9401
5715,1.0,1.0,0.6666666666666666,898,22860,13470,-9390
5716,1.0,1.0,1.0,899,22864,13485,-9379
5717,0.0,0.0,0.0,899,22868,13485,-9383
5718,0.0,0.0,0.0,899,22872,13485,-9387
5719,1.0,1.0,0.6666666666666666,900,22876,13500,-9376
5720,0.0,0.0,0.0,900,22880,13500,-9380
5721,0.0,0.0,0.0,900,22884,13500,-9384
5722,0.0,0.0,0.0,900,22888,13500,-9388
5723,0.0,0.0,0.0,900,22892,13500,-9392
5724,0.0,0.0,0.0,900,22896,13500,-9396
5725,1.0,1.0,1.0,901,22900,13515,-9385
5726,1.0,1.0,1.0,902,22904,13530,-9374
5727,1.0,1.0,1.0,903,22908,13545,-9363
5728,0.0,0.0,0.0,903,22912,13545,-9367
5729,0.0,0.0,0.0,903,22916,13545,-9371
5730,0.0,0.0,0.0,903,22920,13545,-9375
5731,0.0,0.0,0.0,903,22924,13545,-9379
5732,0.0,0.0,0.25,903,22928,13545,-9383
5733,0.0,0.0,0.0,903,22932,13545,-9387
5734,0.0,0.0,0.0,903,22936,13545,-9391
5735,1.0,1.0,1.0,904,22940,13560,-9380
5736,0.0,0.0,0.0,904,22944,13560,-9384
5737,0.0,0.0,0.0,904,22948,13560,-9388
5738,0.0,0.0,0.4,904,22952,13560,-9392
5739,0.0,0.0,0.0,904,22956,13560,-9396
5740,0.0,0.0,0.0,904,22960,13560,-9400
5741,0.0,0.0,0.0,904,22964,13560,-9404
5742,0.0,0.0,0.0,904,22968,13560,-9408
5743,0.0,0.0,0.0,904,22972,13560,-9412
5744,1.0,1.0,1.0,905,22976,13575,-9401
5745,0.0,0.0,0.0,905,22980,13575,-9405
5746,0.0,0.0,0.0,905,22984,13575,-9409
5747,0.0,0.0,0.0,905,22988,13575,-9413
5748,0.0,0.0,0.0,905,22992,13575,-9417
5749,0.0,0.0,0.0,905,22996,13575,-9421
5750,0.0,0.0,0.0,905,23000,13575,-9425
5751,0.0,0.0,0.0,905,23004,13575,-9429
5752,1.0,1.0,1.0,906,23008,13590,-9418
5753,0.0,0.0,0.0,906,23012,13590,-9422
5754,0.0,0.0,0.0,906,23016,13590,-9426
5755,1.0,1.0,0.6666666666666666,907,23020,13605,-9415
5756,0.0,0.0,0.0,907,23024,13605,-9419
5757,0.0,0.0,0.0,907,23028,13605,-9423
5758,1.0,1.0,1.0,908,23032,13620,-9412
5759,1.0,1.0,1.0,909,23036,13635,-9401
5760,0.0,0.0,0.0,909,23040,13635,-9405
5761,0.0,0.0,0.0,909,23044,13635,-9409
5762,0.0,0.0,0.0,909,23048,13635,-9413
5763,0.0,0.0,0.0,909,23052,13635,-9417
5764,0.0,0.0,0.0,909,23056,13635,-9421
5765,1.0,1.0,1.0,910,23060,13650,-9410
5766,1.0,0.0,0.4,911,23064,13665,-9399
5767,0.0,0.0,0.0,911,23068,13665,-9403
5768,1.0,1.0,1.0,912,23072,13680,-9392
5769,0.0,0.0,0.0,912,23076,13680,-9396
5770,0.0,0.0,0.0,912,23080,13680,-9400
5771,1.0,1.0,1.0,913,23084,13695,-9389
5772,0.0,0.0,0.0,913,23088,13695,-9393
5773,0.0,0.0,0.0,913,23092,13695,-9397
5774,0.0,0.0,0.0,913,23096,13695,-9401
5775,0.0,1.0,0.8,913,23100,13695,-9405
5776,0.0,0.0,0.0,913,23104,13695,-9409
5777,0.0,0.0,0.0,913,23108,13695,-9413
5778,0.0,0.0,0.0,913,23112,13695,-9417
5779,0.0,0.0,0.0,913,23116,13695,-9421
5780,1.0,1.0,1.0,914,23120,13710,-9410
5781,0.0,0.0,0.0,914,23124,13710,-9414
5782,0.0,0.0,0.0,914,23128,13710,-9418
5783,0.0,0.0,0.0,914,23132,13710,-9422
5784,0.0,0.0,0.0,914,23136,13710,-9426
5785,0.0,0.0,0.0,914,23140,13710,-9430
5786,0.0,0.0,0.0,914,23144,13710,-9434
5787,0.0,0.0,0.0,914,23148,13710,-9438
5788,0.0,0.0,0.0,914,23152,13710,-9442
5789,0.0,0.0,0.0,914,23156,13710,-9446
5790,0.0,0.0,0.0,914,23160,13710,-9450
5791,0.0,0.0,0.0,914,23164,13710,-9454
5792,0.0,0.0,0.0,914,23168,13710,-9458
5793,0.0,0.0,0.0,914,23172,13710,-9462
5794,0.0,0.0,0.0,914,23176,13710,-9466
5795,0.0,0.0,0.0,914,23180,13710,-9470
5796,0.0,0.0,0.0,914,23184,13710,-9474
5797,0.0,0.0,0.0,914,23188,13710,-9478
5798,0.0,0.0,0.0,914,23192,13710,-9482
5799,1.0,1.0,1.0,915,23196,13725,-9471
5800,1.0,1.0,0.75,916,23200,13740,-9460
5801,0.0,0.0,0.0,916,23204,13740,-9464
5802,1.0,1.0,1.0,917,23208,13755,-9453
5803,0.0,0.0,0.0,917,23212,13755,-9457
5804,0.0,0.0,0.0,917,23216,13755,-9461
5805,0.0,0.0,0.0,917,23220,13755,-9465
5806,0.0,0.0,0.0,917,23224,13755,-9469
5807,0.0,0.0,0.0,917,23228,13755,-9473
5808,0.0,0.0,0.0,917,23232,13755,-9477
5809,0.0,0.0,0.0,917,23236,13755,-9481
5810,0.0,0.0,0.0,917,23240,13755,-9485
5811,0.0,0.0,0.0,917,23244,13755,-9489
5812,0.0,0.0,0.0,917,23248,13755,-9493
5813,0.0,0.0,0.0,917,23252,13755,-9497
5814,0.0,0.0,0.0,917,23256,13755,-9501
5815,0.0,0.0,0.0,917,23260,13755,-9505
5816,1.0,1.0,1.0,918,23264,13770,-9494
5817,0.0,0.0,0.0,918,23268,13770,-9498
5818,0.0,0.0,0.0,918,23272,13770,-9502
5819,0.0,0.0,0.0,918,23276,13770,-9506
5820,0.0,0.0,0.0,918,23280,13770,-9510
5821,0.0,0.0,0.0,918,23284,13770,-9514
5822,1.0,1.0,0.75,919,23288,13785,-9503
5823,0.0,0.0,0.0,919,23292,13785,-9507
5824,0.0,0.0,0.0,919,23296,13785,-9511
5825,0.0,0.0,0.0,919,23300,13785,-9515
5826,0.0,0.0,0.0,919,23304,13785,-9519
5827,0.0,0.0,0.0,919,23308,13785,-9523
5828,0.0,0.0,0.0,919,23312,13785,-9527
5829,0.0,0.0,0.0,919,23316,13785,-9531
5830,1.0,1.0,1.0,920,23320,13800,-9520
5831,0.0,0.0,0.0,920,23324,13800,-9524
5832,0.0,0.0,0.0,920,23328,13800,-9528
5833,0.0,0.0,0.0,920,23332,13800,-9532
5834,0.0,0.0,0.0,920,23336,13800,-9536
5835,0.0,0.0,0.0,920,23340,13800,-9540
5836,0.0,0.0,0.0,920,23344,13800,-9544
5837,1.0,1.0,1.0,921,23348,13815,-9533
5838,0.0,0.0,0.0,921,23352,13815,-9537
5839,0.0,0.0,0.0,921,23356,13815,-9541
5840,1.0,1.0,1.0,922,23360,13830,-9530
5841,0.0,0.0,0.0,922,23364,13830,-9534
5842,0.0,0.0,0.0,922,23368,13830,-9538
5843,0.0,0.0,0.0,922,23372,13830,-9542
5844,0.0,0.0,0.0,922,23376,13830,-9546
5845,0.0,0.0,0.0,922,23380,13830,-9550
5846,0.0,0.0,0.0,922,23384,13830,-9554
5847,0.0,0.0,0.0,922,23388,13830,-9558
5848,1.0,1.0,1.0,923,23392,13845,-9547
5849,0.0,0.0,0.0,923,23396,13845,-9551
5850,0.0,0.0,0.0,923,23400,13845,-9555
5851,0.0,0.0,0.0,923,23404,13845,-9559
5852,1.0,1.0,1.0,924,23408,13860,-9548
5853,0.0,0.0,0.0,924,23412,13860,-9552
5854,1.0,1.0,1.0,925,23416,13875,-9541
5855,0.0,0.0,0.0,925,23420,13875,-9545
5856,0.0,0.0,0.0,925,23424,13875,-9549
5857,1.0,1.0,1.0,926,23428,13890,-9538
5858,0.0,0.0,0.0,926,23432,13890,-9542
5859,0.0,0.0,0.3333333333333333,926,23436,13890,-9546
5860,0.0,0.0,0.0,926,23440,13890,-9550
5861,0.0,0.0,0.3333333333333333,926,23444,13890,-9554
5862,0.0,0.0,0.0,926,23448,13890,-9558
5863,0.0,0.0,0.0,926,23452,13890,-9562
5864,0.0,0.0,0.0,926,23456,13890,-9566
5865,1.0,1.0,1.0,927,23460,13905,-9555
5866,0.0,0.0,0.0,927,23464,13905,-9559
5867,0.0,0.0,0.0,927,23468,13905,-9563
5868,0.0,0.0,0.0,927,23472,13905,-9567
5869,0.0,0.0,0.0,927,23476,13905,-9571
5870,0.0,0.0,0.0,927,23480,13905,-9575
5871,1.0,1.0,1.0,928,23484,13920,-9564
5872,0.0,0.0,0.0,928,23488,13920,-9568
5873,0.0,0.0,0.0,928,23492,13920,-9572
5874,1.0,1.0,1.0,929,23496,13935,-9561
5875,1.0,1.0,1.0,930,23500,13950,-9550
5876,0.0,0.0,0.0,930,23504,13950,-9554
5877,1.0,1.0,1.0,931,23508,13965,-9543
5878,0.0,0.0,0.0,931,23512,13965,-9547
5879,0.0,0.0,0.0,931,23516,13965,-9551
5880,0.0,0.0,0.0,931,23520,13965,-9555
5881,0.0,0.0,0.0,931,23524,13965,-9559
5882,0.0,0.0,0.0,931,23528,13965,-9563
5883,1.0,1.0,1.0,932,23532,13980,-9552
5884,1.0,1.0,1.0,933,23536,13995,-9541
5885,1.0,1.0,1.0,934,23540,14010,-9530
5886,0.0,0.0,0.0,934,23544,14010,-9534
5887,0.0,0.0,0.0,934,23548,14010,-9538
5888,0.0,0.0,0.0,934,23552,14010,-9542
5889,1.0,1.0,0.75,935,23556,14025,-9531
5890,0.0,0.0,0.0,935,23560,14025,-9535
5891,0.0,0.0,0.0,935,23564,14025,-9539
5892,0.0,0.0,0.0,935,23568,14025,-9543
5893,0.0,0.0,0.0,935,23572,14025,-9547
5894,0.0,0.0,0.0,935,23576,14025,-9551
5895,0.0,0.0,0.0,935,23580,14025,-9555
5896,0.0,0.0,0.0,935,23584,14025,-9559
5897,0.0,0.0,0.0,935,23588,14025,-9563
5898,0.0,0.0,0.0,935,23592,14025,-9567
5899,0.0,0.0,0.0,935,23596,14025,-9571
5900,0.0,0.0,0.0,935,23600,14025,-9575
5901,0.0,0.0,0.0,935,23604,14025,-9579
5902,0.0,0.0,0.0,935,23608,14025,-9583
5903,0.0,0.0,0.0,935,23612,14025,-9587
5904,0.0,0.0,0.0,935,23616,14025,-9591
5905,1.0,1.0,1.0,936,23620,14040,-9580
5906,0.0,0.0,0.0,936,23624,14040,-9584
5907,0.0,0.0,0.0,936,23628,14040,-9588
5908,1.0,1.0,1.0,937,23632,14055,-9577
5909,0.0,0.0,0.0,937,23636,14055,-9581
5910,0.0,0.0,0.0,937,23640,14055,-9585
5911,0.0,0.0,0.0,937,23644,14055,-9589
5912,0.0,0.0,0.0,937,23648,14055,-9593
5913,1.0,1.0,1.0,938,23652,14070,-9582
5914,1.0,1.0,0.6666666666666666,939,23656,14085,-9571
5915,0.0,0.0,0.0,939,23660,14085,-9575
5916,0.0,0.0,0.0,939,23664,14085,-9579
5917,0.0,0.0,0.0,939,23668,14085,-9583
5918,0.0,0.0,0.0,939,23672,14085,-9587
5919,0.0,0.0,0.0,939,23676,14085,-9591
5920,0.0,0.0,0.0,939,23680,14085,-9595
5921,0.0,0.0,0.0,939,23684,14085,-9599
5922,1.0,1.0,1.0,940,23688,14100,-9588
5923,1.0,1.0,0.6666666666666666,941,23692,14115,-9577
5924,0.0,0.0,0.0,941,23696,14115,-9581
5925,0.0,0.0,0.0,941,23700,14115,-9585
5926,0.0,0.0,0.0,941,23704,14115,-9589
5927,1.0,1.0,1.0,942,23708,14130,-9578
5928,1.0,1.0,1.0,943,23712,14145,-9567
5929,0.0,0.0,0.0,943,23716,14145,-9571
5930,0.0,0.0,0.0,943,23720,14145,-9575
5931,1.0,1.0,1.0,944,23724,14160,-9564
5932,0.0,0.0,0.0,944,23728,14160,-9568
5933,0.0,0.0,0.0,944,23732,14160,-9572
5934,1.0,1.0,0.8,945,23736,14175,-9561
5935,0.0,0.0,0.0,945,23740,14175,-9565
5936,0.0,0.0,0.0,945,23744,14175,-9569
5937,0.0,0.0,0.0,945,23748,14175,-9573
5938,0.0,0.0,0.0,945,23752,14175,-9577
5939,0.0,0.0,0.0,945,23756,14175,-9581
5940,0.0,0.0,0.25,945,23760,14175,-9585
5941,0.0,0.0,0.0,945,23764,14175,-9589
5942,0.0,0.0,0.0,945,23768,14175,-9593
5943,1.0,1.0,1.0,946,23772,14190,-9582
5944,0.0,0.0,0.0,946,23776,14190,-9586
5945,1.0,1.0,1.0,947,23780,14205,-9575
5946,0.0,0.0,0.0,947,23784,14205,-9579
5947,0.0,0.0,0.0,947,23788,14205,-9583
5948,0.0,0.0,0.0,947,23792,14205,-9587
5949,0.0,0.0,0.0,947,23796,14205,-9591
5950,0.0,0.0,0.0,947,23800,14205,-9595
5951,1.0,1.0,1.0,948,23804,14220,-9584
5952,0.0,0.0,0.0,948,23808,14220,-9588
5953,1.0,1.0,1.0,949,23812,14235,-9577
5954,0.0,0.0,0.0,949,23816,14235,-9581
5955,1.0,1.0,0.6666666666666666,950,23820,14250,-9570
5956,0.0,0.0,0.3333333333333333,950,23824,14250,-9574
5957,0.0,0.0,0.0,950,23828,14250,-9578
5958,0.0,0.0,0.5,950,23832,14250,-9582
5959,0.0,0.0,0.0,950,23836,14250,-9586
5960,0.0,0.0,0.0,950,23840,14250,-9590
5961,0.0,0.0,0.0,950,23844,14250,-9594
5962,0.0,0.0,0.0,950,23848,14250,-9598
5963,0.0,0.0,0.0,950,23852,14250,-9602
5964,0.0,0.0,0.0,950,23856,14250,-9606
5965,0.0,0.0,0.0,950,23860,14250,-9610
5966,0.0,0.0,0.0,950,23864,14250,-9614
5967,1.0,1.0,1.0,951,23868,14265,-9603
5968,0.0,0.0,0.0,951,23872,14265,-9607
5969,1.0,1.0,1.0,952,23876,14280,-9596
5970,0.0,0.0,0.0,952,23880,14280,-9600
5971,0.0,0.0,0.0,952,23884,14280,-9604
5972,0.0,0.0,0.0,952,23888,14280,-9608
5973,0.0,0.0,0.0,952,23892,14280,-9612
5974,0.0,0.0,0.0,952,23896,14280,-9616
5975,0.0,0.0,0.0,952,23900,14280,-9620
5976,0.0,0.0,0.0,952,23904,14280,-9624
5977,0.0,0.0,0.0,952,23908,14280,-9628
5978,0.0,0.0,0.0,952,23912,14280,-9632
5979,0.0,0.0,0.0,952,23916,14280,-9636
5980,0.0,0.0,0.0,952,23920,14280,-9640
5981,1.0,1.0,1.0,953,23924,14295,-9629
5982,0.0,0.0,0.0,953,23928,14295,-9633
5983,1.0,1.0,0.75,954,23932,14310,-9622
5984,1.0,1.0,1.0,955,23936,14325,-9611
5985,0.0,0.0,0.2,955,23940,14325,-9615
5986,0.0,0.0,0.0,955,23944,14325,-9619
5987,1.0,1.0,1.0,956,23948,14340,-9608
5988,0.0,0.0,0.0,956,23952,14340,-9612
5989,0.0,0.0,0.0,956,23956,14340,-9616
5990,0.0,0.0,0.0,956,23960,14340,-9620
5991,0.0,0.0,0.3333333333333333,956,23964,14340,-9624
5992,0.0,0.0,0.0,956,23968,14340,-9628
5993,1.0,1.0,0.75,957,23972,14355,-9617
5994,0.0,0.0,0.0,957,23976,14355,-9621
5995,0.0,0.0,0.0,957,23980,14355,-9625
5996,0.0,0.0,0.0,957,23984,14355,-9629
5997,0.0,0.0,0.0,957,23988,14355,-9633
5998,0.0,0.0,0.0,957,23992,14355,-9637
5999,0.0,0.0,0.0,957,23996,14355,-9641
6000,0.0,0.0,0.0,957,24000,14355,-9645
6001,0.0,0.0,0.0,957,24004,14355,-9649
6002,0.0,0.0,0.0,957,24008,14355,-9653
6003,0.0,0.0,0.0,957,24012,14355,-9657
6004,0.0,0.0,0.0,957,24016,14355,-9661
6005,1.0,0.0,0.3333333333333333,958,24020,14370,-9650
6006,0.0,0.0,0.0,958,24024,14370,-9654
6007,0.0,0.0,0.0,958,24028,14370,-9658
6008,1.0,1.0,1.0,959,24032,14385,-9647
6009,0.0,0.0,0.0,959,24036,14385,-9651
6010,0.0,0.0,0.0,959,24040,14385,-9655
6011,0.0,0.0,0.0,959,24044,14385,-9659
6012,1.0,1.0,1.0,960,24048,14400,-9648
6013,0.0,0.0,0.0,960,24052,14400,-9652
6014,0.0,0.0,0.0,960,24056,14400,-9656
6015,1.0,1.0,1.0,961,24060,14415,-9645
6016,0.0,0.0,0.0,961,24064,14415,-9649
6017,0.0,0.0,0.0,961,24068,14415,-9653
6018,0.0,0.0,0.0,961,24072,14415,-9657
6019,0.0,0.0,0.0,961,24076,14415,-9661
6020,0.0,0.0,0.0,961,24080,14415,-9665
6021,0.0,0.0,0.0,961,24084,14415,-9669
6022,0.0,0.0,0.0,961,24088,14415,-9673
6023,0.0,0.0,0.0,961,24092,14415,-9677
6024,0.0,0.0,0.0,961,24096,14415,-9681
6025,0.0,0.0,0.0,961,24100,14415,-9685
6026,0.0,0.0,0.0,961,24104,14415,-9689
6027,0.0,0.0,0.0,961,24108,14415,-9693
6028,0.0,0.0,0.0,961,24112,14415,-9697
6029,0.0,0.0,0.3333333333333333,961,24116,14415,-9701
6030,0.0,0.0,0.0,961,24120,14415,-9705
6031,0.0,0.0,0.0,961,24124,14415,-9709
6032,0.0,0.0,0.0,961,24128,14415,-9713
6033,0.0,0.0,0.0,961,24132,14415,-9717
6034,0.0,0.0,0.0,961,24136,14415,-9721
6035,0.0,1.0,0.6,961,24140,14415,-9725
6036,1.0,1.0,1.0,962,24144,14430,-9714
6037,0.0,0.0,0.0,962,24148,14430,-9718
6038,1.0,1.0,1.0,963,24152,14445,-9707
6039,0.0,0.0,0.0,963,24156,14445,-9711
6040,1.0,1.0,0.6666666666666666,964,24160,14460,-9700
6041,0.0,0.0,0.0,964,24164,14460,-9704
6042,0.0,0.0,0.0,964,24168,14460,-9708
6043,0.0,0.0,0.0,964,24172,14460,-9712
6044,0.0,0.0,0.0,964,24176,14460,-9716
6045,0.0,0.0,0.0,964,24180,14460,-9720
6046,0.0,0.0,0.0,964,24184,14460,-9724
6047,1.0,1.0,1.0,965,24188,14475,-9713
6048,0.0,0.0,0.3333333333333333,965,24192,14475,-9717
6049,0.0,0.0,0.0,965,24196,14475,-9721
6050,0.0,0.0,0.0,965,24200,14475,-9725
6051,0.0,0.0,0.0,965,24204,14475,-9729
6052,0.0,0.0,0.0,965,24208,14475,-9733
6053,0.0,0.0,0.0,965,24212,14475,-9737
6054,0.0,0.0,0.0,965,24216,14475,-9741
6055,0.0,0.0,0.0,965,24220,14475,-9745
6056,0.0,0.0,0.0,965,24224,14475,-9749
6057,0.0,0.0,0.0,965,24228,14475,-9753
6058,0.0,0.0,0.0,965,24232,14475,-9757
6059,0.0,0.0,0.0,965,24236,14475,-9761
6060,1.0,1.0,1.0,966,24240,14490,-9750
6061,0.0,0.0,0.25,966,24244,14490,-9754
6062,0.0,0.0,0.0,966,24248,14490,-9758
6063,0.0,0.0,0.0,966,24252,14490,-9762
6064,0.0,0.0,0.0,966,24256,14490,-9766
6065,0.0,0.0,0.0,966,24260,14490,-9770
6066,0.0,0.0,0.0,966,24264,14490,-9774
6067,0.0,0.0,0.0,966,24268,14490,-9778
6068,0.0,0.0,0.0,966,24272,14490,-9782
6069,0.0,0.0,0.0,966,24276,14490,-9786
6070,0.0,0.0,0.0,966,24280,14490,-9790
6071,0.0,0.0,0.2,966,24284,14490,-9794
6072,0.0,0.0,0.0,966,24288,14490,-9798
6073,1.0,1.0,0.6666666666666666,967,24292,14505,-9787
6074,1.0,1.0,1.0,968,24296,14520,-9776
6075,0.0,0.0,0.0,968,24300,14520,-9780
6076,1.0,1.0,1.0,969,24304,14535,-9769
6077,0.0,0.0,0.0,969,24308,14535,-9773
6078,0.0,0.0,0.0,969,24312,14535,-9777
6079,1.0,1.0,1.0,970,24316,14550,-9766
6080,0.0,0.0,0.0,970,24320,14550,-9770
6081,0.0,0.0,0.0,970,24324,14550,-9774
6082,1.0,1.0,0.6666666666666666,971,24328,14565,-9763
6083,0.0,0.0,0.0,971,24332,14565,-9767
6084,1.0,1.0,1.0,972,24336,14580,-9756
6085,0.0,0.0,0.0,972,24340,14580,-9760
6086,0.0,0.0,0.0,972,24344,14580,-9764
6087,0.0,0.0,0.0,972,24348,14580,-9768
6088,0.0,0.0,0.0,972,24352,14580,-9772
6089,1.0,1.0,1.0,973,24356,14595,-9761
6090,0.0,0.0,0.0,973,24360,14595,-9765
6091,0.0,0.0,0.0,973,24364,14595,-9769
6092,0.0,0.0,0.0,973,24368,14595,-9773
6093,0.0,0.0,0.0,973,24372,14595,-9777
6094,1.0,1.0,1.0,974,24376,14610,-9766
6095,0.0,0.0,0.0,974,24380,14610,-9770
6096,0.0,0.0,0.0,974,24384,14610,-9774
6097,0.0,0.0,0.0,974,24388,14610,-9778
6098,0.0,0.0,0.0,974,24392,14610,-9782
6099,0.0,0.0,0.0,974,24396,14610,-9786
6100,0.0,0.0,0.0,974,24400,14610,-9790
6101,0.0,0.0,0.0,974,24404,14610,-9794
6102,0.0,0.0,0.0,974,24408,14610,-9798
6103,1.0,1.0,1.0,975,24412,14625,-9787
6104,1.0,1.0,1.0,976,24416,14640,-9776
6105,1.0,1.0,1.0,977,24420,14655,-9765
6106,1.0,1.0,1.0,978,24424,14670,-9754
6107,0.0,0.0,0.0,978,24428,14670,-9758
6108,0.0,0.0,0.0,978,24432,14670,-9762
6109,0.0,0.0,0.0,978,24436,14670,-9766
6110,0.0,0.0,0.0,978,24440,14670,-9770
6111,1.0,1.0,1.0,979,24444,14685,-9759
6112,1.0,1.0,1.0,980,24448,14700,-9748
6113,0.0,0.0,0.0,980,24452,14700,-9752
6114,0.0,0.0,0.0,980,24456,14700,-9756
6115,0.0,0.0,0.0,980,24460,14700,-9760
6116,0.0,0.0,0.0,980,24464,14700,-9764
6117,1.0,1.0,1.0,981,24468,14715,-9753
6118,0.0,0.0,0.0,981,24472,14715,-9757
6119,0.0,0.0,0.0,981,24476,14715,-9761
6120,0.0,0.0,0.0,981,24480,14715,-9765
6121,0.0,0.0,0.0,981,24484,14715,-9769
6122,0.0,0.0,0.0,981,24488,14715,-9773
6123,0.0,0.0,0.0,981,24492,14715,-9777
6124,0.0,0.0,0.0,981,24496,14715,-9781
6125,1.0,1.0,1.0,982,24500,14730,-9770
6126,0.0,0.0,0.0,982,24504,14730,-9774
6127,1.0,1.0,0.75,983,24508,14745,-9763
6128,1.0,1.0,1.0,984,24512,14760,-9752
6129,0.0,0.0,0.0,984,24516,14760,-9756
6130,0.0,0.0,0.0,984,24520,14760,-9760
6131,0.0,0.0,0.0,984,24524,14760,-9764
6132,0.0,0.0,0.0,984,24528,14760,-9768
6133,0.0,0.0,0.0,984,24532,14760,-9772
6134,0.0,0.0,0.0,984,24536,14760,-9776
6135,1.0,1.0,1.0,985,24540,14775,-9765
6136,0.0,0.0,0.0,985,24544,14775,-9769
6137,0.0,0.0,0.0,985,24548,14775,-9773
6138,0.0,0.0,0.0,985,24552,14775,-9777
6139,0.0,0.0,0.0,985,24556,14775,-9781
6140,0.0,0.0,0.0,985,24560,14775,-9785
6141,0.0,0.0,0.0,985,24564,14775,-9789
6142,0.0,0.0,0.0,985,24568,14775,-9793
6143,0.0,0.0,0.0,985,24572,14775,-9797
6144,0.0,0.0,0.0,985,24576,14775,-9801
6145,0.0,0.0,0.0,985,24580,14775,-9805
6146,0.0,0.0,0.0,985,24584,14775,-9809
6147,0.0,0.0,0.0,985,24588,14775,-9813
6148,0.0,0.0,0.0,985,24592,14775,-9817
6149,0.0,0.0,0.0,985,24596,14775,-9821
6150,0.0,0.0,0.0,985,24600,14775,-9825
6151,1.0,1.0,0.6666666666666666,986,24604,14790,-9814
6152,1.0,1.0,1.0,987,24608,14805,-9803
6153,0.0,0.0,0.0,987,24612,14805,-9807
6154,1.0,1.0,1.0,988,24616,14820,-9796
6155,0.0,0.0,0.0,988,24620,14820,-9800
6156,0.0,0.0,0.0,988,24624,14820,-9804
6157,0.0,0.0,0.0,988,24628,14820,-9808
6158,0.0,0.0,0.0,988,24632,14820,-9812
6159,1.0,1.0,1.0,989,24636,14835,-9801
6160,0.0,0.0,0.0,989,24640,14835,-9805
6161,0.0,0.0,0.0,989,24644,14835,-9809
6162,0.0,0.0,0.0,989,24648,14835,-9813
6163,0.0,0.0,0.0,989,24652,14835,-9817
6164,0.0,0.0,0.0,989,24656,14835,-9821
6165,0.0,0.0,0.0,989,24660,14835,-9825
6166,0.0,0.0,0.2,989,24664,14835,-9829
6167,0.0,0.0,0.0,989,24668,14835,-9833
6168,0.0,0.0,0.0,989,24672,14835,-9837
6169,0.0,0.0,0.0,989,24676,14835,-9841
6170,1.0,1.0,0.6666666666666666,990,24680,14850,-9830
6171,0.0,0.0,0.0,990,24684,14850,-9834
6172,0.0,0.0,0.0,990,24688,14850,-9838
6173,0.0,0.0,0.0,990,24692,14850,-9842
6174,0.0,0.0,0.0,990,24696,14850,-9846
6175,0.0,0.0,0.0,990,24700,14850,-9850
6176,0.0,0.0,0.0,990,24704,14850,-9854
6177,0.0,0.0,0.0,990,24708,14850,-9858
6178,0.0,0.0,0.0,990,24712,14850,-9862
6179,1.0,1.0,1.0,991,24716,14865,-9851
6180,0.0,0.0,0.0,991,24720,14865,-9855
6181,0.0,0.0,0.0,991,24724,14865,-9859
6182,0.0,0.0,0.0,991,24728,14865,-9863
6183,0.0,0.0,0.0,991,24732,14865,-9867
6184,0.0,0.0,0.0,991,24736,14865,-9871
6185,0.0,0.0,0.0,991,24740,14865,-9875
6186,0.0,0.0,0.0,991,24744,14865,-9879
6187,0.0,0.0,0.0,991,24748,14865,-9883
6188,0.0,0.0,0.0,991,24752,14865,-9887
6189,1.0,1.0,1.0,992,24756,14880,-9876
6190,0.0,0.0,0.0,992,24760,14880,-9880
6191,0.0,0.0,0.0,992,24764,14880,-9884
6192,0.0,0.0,0.0,992,24768,14880,-9888
6193,0.0,0.0,0.0,992,24772,14880,-9892
6194,1.0,1.0,1.0,993,24776,14895,-9881
6195,0.0,0.0,0.0,993,24780,14895,-9885
6196,1.0,1.0,1.0,994,24784,14910,-9874
6197,1.0,1.0,1.0,995,24788,14925,-9863
6198,0.0,0.0,0.0,995,24792,14925,-9867
6199,0.0,0.0,0.0,995,24796,14925,-9871
6200,0.0,0.0,0.0,995,24800,14925,-9875
6201,0.0,0.0,0.0,995,24804,14925,-9879
6202,0.0,0.0,0.0,995,24808,14925,-9883
6203,1.0,1.0,0.6666666666666666,996,24812,14940,-9872
6204,0.0,0.0,0.0,996,24816,14940,-9876
6205,1.0,1.0,1.0,997,24820,14955,-9865
6206,0.0,0.0,0.0,997,24824,14955,-9869
6207,0.0,0.0,0.0,997,24828,14955,-9873
6208,0.0,0.0,0.0,997,24832,14955,-9877
6209,0.0,0.0,0.25,997,24836,14955,-9881
6210,0.0,0.0,0.0,997,24840,14955,-9885
6211,0.0,0.0,0.0,997,24844,14955,-9889
6212,0.0,0.0,0.0,997,24848,14955,-9893
6213,0.0,0.0,0.0,997,24852,14955,-9897
6214,0.0,0.0,0.0,997,24856,14955,-9901
6215,0.0,0.0,0.0,997,24860,14955,-9905
6216,0.0,0.0,0.0,997,24864,14955,-9909
6217,1.0,0.0,0.3333333333333333,998,24868,14970,-9898
6218,0.0,0.0,0.0,998,24872,14970,-9902
6219,1.0,1.0,1.0,999,24876,14985,-9891
6220,0.0,0.0,0.25,999,24880,14985,-9895
6221,0.0,0.0,0.0,999,24884,14985,-9899
6222,0.0,0.0,0.0,999,24888,14985,-9903
6223,0.0,0.0,0.0,999,24892,14985,-9907
6224,0.0,0.0,0.0,999,24896,14985,-9911
6225,0.0,0.0,0.0,999,24900,14985,-9915
6226,1.0,1.0,1.0,1000,24904,15000,-9904
6227,0.0,0.0,0.3333333333333333,1000,24908,15000,-9908
6228,0.0,0.0,0.0,1000,24912,15000,-9912
6229,0.0,0.0,0.0,1000,24916,15000,-9916
6230,0.0,0.0,0.0,1000,24920,15000,-9920
6231,0.0,0.0,0.0,1000,24924,15000,-9924
6232,0.0,0.0,0.0,1000,24928,15000,-9928
6233,0.0,0.0,0.0,1000,24932,15000,-9932
6234,0.0,0.0,0.0,1000,24936,15000,-9936
6235,0.0,0.0,0.0,1000,24940,15000,-9940
6236,0.0,0.0,0.0,1000,24944,15000,-9944
6237,0.0,0.0,0.0,1000,24948,15000,-9948
6238,0.0,0.0,0.0,1000,24952,15000,-9952
6239,0.0,0.0,0.0,1000,24956,15000,-9956
6240,0.0,0.0,0.0,1000,24960,15000,-9960
6241,0.0,0.0,0.0,1000,24964,15000,-9964
6242,0.0,0.0,0.0,1000,24968,15000,-9968
6243,0.0,0.0,0.0,1000,24972,15000,-9972
6244,0.0,0.0,0.0,1000,24976,15000,-9976
6245,1.0,1.0,1.0,1001,24980,15015,-9965
6246,0.0,0.0,0.0,1001,24984,15015,-9969
6247,0.0,0.0,0.0,1001,24988,15015,-9973
6248,0.0,0.0,0.0,1001,24992,15015,-9977
6249,0.0,0.0,0.0,1001,24996,15015,-9981
6250,0.0,0.0,0.0,1001,25000,15015,-9985
6251,0.0,0.0,0.0,1001,25004,15015,-9989
6252,0.0,0.0,0.0,1001,25008,15015,-9993
6253,0.0,0.0,0.0,1001,25012,15015,-9997
6254,0.0,0.0,0.0,1001,25016,15015,-10001
6255,0.0,0.0,0.0,1001,25020,15015,-10005
6256,1.0,1.0,0.6666666666666666,1002,25024,15030,-9994
6257,0.0,0.0,0.0,1002,25028,15030,-9998
6258,0.0,0.0,0.0,1002,25032,15030,-10002
6259,0.0,0.0,0.0,1002,25036,15030,-10006
6260,0.0,0.0,0.0,1002,25040,15030,-10010
6261,0.0,0.0,0.0,1002,25044,15030,-10014
6262,0.0,0.0,0.0,1002,25048,15030,-10018
6263,0.0,0.0,0.0,1002,25052,15030,-10022
6264,0.0,0.0,0.0,1002,25056,15030,-10026
6265,0.0,0.0,0.0,1002,25060,15030,-10030
6266,0.0,0.0,0.0,1002,25064,15030,-10034
6267,0.0,0.0,0.0,1002,25068,15030,-10038
6268,0.0,0.0,0.0,1002,25072,15030,-10042
6269,1.0,1.0,1.0,1003,25076,15045,-10031
6270,0.0,0.0,0.0,1003,25080,15045,-10035
6271,0.0,0.0,0.0,1003,25084,15045,-10039
6272,0.0,0.0,0.0,1003,25088,15045,-10043
6273,0.0,0.0,0.0,1003,25092,15045,-10047
6274,0.0,0.0,0.0,1003,25096,15045,-10051
6275,0.0,0.0,0.0,1003,25100,15045,-10055
6276,0.0,0.0,0.0,1003,25104,15045,-10059
6277,0.0,0.0,0.0,1003,25108,15045,-10063
6278,0.0,0.0,0.0,1003,25112,15045,-10067
6279,0.0,0.0,0.0,1003,25116,15045,-10071
6280,0.0,0.0,0.0,1003,25120,15045,-10075
6281,0.0,0.0,0.0,1003,25124,15045,-10079
6282,0.0,0.0,0.0,1003,25128,15045,-10083
6283,0.0,0.0,0.0,1003,25132,15045,-10087
6284,0.0,0.0,0.0,1003,25136,15045,-10091
6285,0.0,0.0,0.0,1003,25140,15045,-10095
6286,0.0,0.0,0.0,1003,25144,15045,-10099
6287,0.0,0.0,0.0,1003,25148,15045,-10103
6288,1.0,1.0,1.0,1004,25152,15060,-10092
6289,0.0,0.0,0.0,1004,25156,15060,-10096
6290,1.0,1.0,1.0,1005,25160,15075,-10085
6291,0.0,0.0,0.0,1005,25164,15075,-10089
6292,0.0,0.0,0.0,1005,25168,15075,-10093
6293,0.0,0.0,0.0,1005,25172,15075,-10097
6294,0.0,0.0,0.0,1005,25176,15075,-10101
6295,0.0,0.0,0.0,1005,25180,15075,-10105
6296,0.0,0.0,0.0,1005,25184,15075,-10109
6297,0.0,0.0,0.0,1005,25188,15075,-10113
6298,0.0,0.0,0.0,1005,25192,15075,-10117
6299,0.0,0.0,0.0,1005,25196,15075,-10121
6300,0.0,0.0,0.0,1005,25200,15075,-10125
6301,0.0,0.0,0.0,1005,25204,15075,-10129
6302,0.0,0.0,0.0,1005,25208,15075,-10133
6303,0.0,0.0,0.0,1005,25212,15075,-10137
6304,0.0,0.0,0.0,1005,25216,15075,-10141
6305,1.0,1.0,1.0,1006,25220,15090,-10130
6306,0.0,0.0,0.0,1006,25224,15090,-10134
6307,0.0,0.0,0.0,1006,25228,15090,-10138
6308,0.0,0.0,0.0,1006,25232,15090,-10142
6309,1.0,1.0,0.6,1007,25236,15105,-10131
6310,0.0,0.0,0.0,1007,25240,15105,-10135
6311,0.0,0.0,0.0,1007,25244,15105,-10139
6312,0.0,0.0,0.5,1007,25248,15105,-10143
6313,0.0,0.0,0.0,1007,25252,15105,-10147
6314,0.0,0.0,0.0,1007,25256,15105,-10151
6315,0.0,0.0,0.0,1007,25260,15105,-10155
6316,0.0,0.0,0.0,1007,25264,15105,-10159
6317,0.0,0.0,0.0,1007,25268,15105,-10163
6318,1.0,0.0,0.4,1008,25272,15120,-10152
6319,0.0,0.0,0.0,1008,25276,15120,-10156
6320,0.0,0.0,0.0,1008,25280,15120,-10160
6321,0.0,0.0,0.0,1008,25284,15120,-10164
6322,0.0,0.0,0.0,1008,25288,15120,-10168
6323,0.0,1.0,0.75,1008,25292,15120,-10172
6324,0.0,0.0,0.0,1008,25296,15120,-10176
6325,0.0,0.0,0.0,1008,25300,15120,-10180
6326,0.0,0.0,0.0,1008,25304,15120,-10184
6327,0.0,0.0,0.0,1008,25308,15120,-10188
6328,0.0,0.0,0.0,1008,25312,15120,-10192
6329,1.0,1.0,1.0,1009,25316,15135,-10181
6330,1.0,1.0,1.0,1010,25320,15150,-10170
6331,0.0,0.0,0.0,1010,25324,15150,-10174
6332,0.0,0.0,0.0,1010,25328,15150,-10178
6333,0.0,0.0,0.0,1010,25332,15150,-10182
6334,1.0,1.0,1.0,1011,25336,15165,-10171
6335,0.0,0.0,0.0,1011,25340,15165,-10175
6336,0.0,0.0,0.0,1011,25344,15165,-10179
6337,0.0,0.0,0.0,1011,25348,15165,-10183
6338,0.0,0.0,0.0,1011,25352,15165,-10187
6339,0.0,0.0,0.0,1011,25356,15165,-10191
6340,0.0,0.0,0.0,1011,25360,15165,-10195
6341,0.0,0.0,0.0,1011,25364,15165,-10199
6342,0.0,0.0,0.0,1011,25368,15165,-10203
6343,1.0,1.0,1.0,1012,25372,15180,-10192
6344,0.0,0.0,0.25,1012,25376,15180,-10196
6345,0.0,0.0,0.0,1012,25380,15180,-10200
6346,0.0,0.0,0.0,1012,25384,15180,-10204
6347,0.0,0.0,0.0,1012,25388,15180,-10208
6348,0.0,0.0,0.0,1012,25392,15180,-10212
6349,1.0,1.0,1.0,1013,25396,15195,-10201
6350,0.0,0.0,0.0,1013,25400,15195,-10205
6351,0.0,1.0,0.6,1013,25404,15195,-10209
6352,0.0,0.0,0.0,1013,25408,15195,-10213
6353,0.0,0.0,0.0,1013,25412,15195,-10217
6354,1.0,1.0,1.0,1014,25416,15210,-10206
6355,0.0,0.0,0.0,1014,25420,15210,-10210
6356,0.0,0.0,0.0,1014,25424,15210,-10214
6357,0.0,0.0,0.0,1014,25428,15210,-10218
6358,0.0,0.0,0.0,1014,25432,15210,-10222
6359,0.0,0.0,0.0,1014,25436,15210,-10226
6360,0.0,0.0,0.0,1014,25440,15210,-10230
6361,0.0,0.0,0.0,1014,25444,15210,-10234
6362,0.0,0.0,0.0,1014,25448,15210,-10238
6363,0.0,0.0,0.0,1014,25452,15210,-10242
6364,0.0,0.0,0.0,1014,25456,15210,-10246
6365,0.0,0.0,0.0,1014,25460,15210,-10250
6366,0.0,0.0,0.0,1014,25464,15210,-10254
6367,0.0,0.0,0.0,1014,25468,15210,-10258
6368,0.0,0.0,0.0,1014,25472,15210,-10262
6369,0.0,0.0,0.0,1014,25476,15210,-10266
6370,0.0,0.0,0.0,1014,25480,15210,-10270
6371,0.0,0.0,0.0,1014,25484,15210,-10274
6372,0.0,0.0,0.0,1014,25488,15210,-10278
6373,0.0,0.0,0.0,1014,25492,15210,-10282
6374,0.0,0.0,0.0,1014,25496,15210,-10286
6375,0.0,0.0,0.0,1014,25500,15210,-10290
6376,0.0,0.0,0.3333333333333333,1014,25504,15210,-10294
6377,0.0,0.0,0.0,1014,25508,15210,-10298
6378,0.0,0.0,0.0,1014,25512,15210,-10302
6379,0.0,0.0,0.0,1014,25516,15210,-10306
6380,0.0,0.0,0.0,1014,25520,15210,-10310
6381,0.0,0.0,0.0,1014,25524,15210,-10314
6382,0.0,0.0,0.0,1014,25528,15210,-10318
6383,0.0,0.0,0.0,1014,25532,15210,-10322
6384,1.0,0.0,0.25,1015,25536,15225,-10311
6385,0.0,0.0,0.0,1015,25540,15225,-10315
6386,1.0,0.0,0.3333333333333333,1016,25544,15240,-10304
6387,0.0,0.0,0.0,1016,25548,15240,-10308
6388,0.0,1.0,0.6666666666666666,1016,25552,15240,-10312
6389,0.0,0.0,0.0,1016,25556,15240,-10316
6390,0.0,0.0,0.3333333333333333,1016,25560,15240,-10320
6391,1.0,1.0,1.0,1017,25564,15255,-10309
6392,0.0,0.0,0.0,1017,25568,15255,-10313
6393,0.0,0.0,0.0,1017,25572,15255,-10317
6394,0.0,0.0,0.0,1017,25576,15255,-10321
6395,0.0,0.0,0.0,1017,25580,15255,-10325
6396,0.0,0.0,0.0,1017,25584,15255,-10329
6397,0.0,0.0,0.0,1017,25588,15255,-10333
6398,0.0,0.0,0.0,1017,25592,15255,-10337
6399,0.0,0.0,0.0,1017,25596,15255,-10341
6400,0.0,0.0,0.0,1017,25600,15255,-10345
6401,0.0,0.0,0.0,1017,25604,15255,-10349
6402,0.0,0.0,0.0,1017,25608,15255,-10353
6403,0.0,0.0,0.0,1017,25612,15255,-10357
6404,0.0,0.0,0.0,1017,25616,15255,-10361
6405,0.0,0.0,0.0,1017,25620,15255,-10365
6406,1.0,1.0,1.0,1018,25624,15270,-10354
6407,0.0,0.0,0.0,1018,25628,15270,-10358
6408,0.0,0.0,0.0,1018,25632,15270,-10362
6409,1.0,1.0,1.0,1019,25636,15285,-10351
6410,0.0,0.0,0.0,1019,25640,15285,-10355
6411,0.0,0.0,0.0,1019,25644,15285,-10359
6412,0.0,1.0,0.6666666666666666,1019,25648,15285,-10363
6413,0.0,0.0,0.0,1019,25652,15285,-10367
6414,0.0,0.0,0.0,1019,25656,15285,-10371
6415,0.0,0.0,0.0,1019,25660,15285,-10375
6416,0.0,1.0,0.75,1019,25664,15285,-10379
6417,0.0,0.0,0.0,1019,25668,15285,-10383
6418,0.0,0.0,0.0,1019,25672,15285,-10387
6419,0.0,0.0,0.0,1019,25676,15285,-10391
6420,0.0,0.0,0.0,1019,25680,15285,-10395
6421,0.0,0.0,0.0,1019,25684,15285,-10399
6422,1.0,1.0,0.6666666666666666,1020,25688,15300,-10388
6423,0.0,0.0,0.0,1020,25692,15300,-10392
6424,1.0,1.0,0.6,1021,25696,15315,-10381
6425,0.0,0.0,0.2,1021,25700,15315,-10385
6426,0.0,0.0,0.0,1021,25704,15315,-10389
6427,0.0,0.0,0.0,1021,25708,15315,-10393
6428,0.0,0.0,0.0,1021,25712,15315,-10397
6429,0.0,0.0,0.5,1021,25716,15315,-10401
6430,0.0,0.0,0.0,1021,25720,15315,-10405
6431,0.0,0.0,0.0,1021,25724,15315,-10409
6432,0.0,0.0,0.0,1021,25728,15315,-10413
6433,0.0,0.0,0.0,1021,25732,15315,-10417
6434,1.0,1.0,1.0,1022,25736,15330,-10406
6435,0.0,0.0,0.0,1022,25740,15330,-10410
6436,0.0,0.0,0.0,1022,25744,15330,-10414
6437,0.0,0.0,0.2,1022,25748,15330,-10418
6438,0.0,0.0,0.0,1022,25752,15330,-10422
6439,0.0,0.0,0.0,1022,25756,15330,-10426
6440,0.0,0.0,0.0,1022,25760,15330,-10430
6441,0.0,0.0,0.0,1022,25764,15330,-10434
6442,0.0,0.0,0.0,1022,25768,15330,-10438
6443,0.0,0.0,0.0,1022,25772,15330,-10442
6444,0.0,0.0,0.0,1022,25776,15330,-10446
6445,0.0,0.0,0.0,1022,25780,15330,-10450
6446,0.0,0.0,0.0,1022,25784,15330,-10454
6447,0.0,0.0,0.0,1022,25788,15330,-10458
6448,1.0,1.0,1.0,1023,25792,15345,-10447
6449,0.0,0.0,0.0,1023,25796,15345,-10451
6450,0.0,0.0,0.0,1023,25800,15345,-10455
6451,0.0,0.0,0.0,1023,25804,15345,-10459
6452,0.0,0.0,0.0,1023,25808,15345,-10463
6453,0.0,0.0,0.0,1023,25812,15345,-10467
6454,1.0,1.0,1.0,1024,25816,15360,-10456
6455,0.0,0.0,0.0,1024,25820,15360,-10460
6456,0.0,0.0,0.0,1024,25824,15360,-10464
6457,0.0,0.0,0.0,1024,25828,15360,-10468
6458,1.0,1.0,0.75,1025,25832,15375,-10457
6459,0.0,0.0,0.0,1025,25836,15375,-10461
6460,0.0,0.0,0.0,1025,25840,15375,-10465
6461,1.0,1.0,0.6666666666666666,1026,25844,15390,-10454
6462,1.0,1.0,1.0,1027,25848,15405,-10443
6463,0.0,0.0,0.0,1027,25852,15405,-10447
6464,0.0,0.0,0.0,1027,25856,15405,-10451
6465,0.0,0.0,0.0,1027,25860,15405,-10455
6466,1.0,1.0,1.0,1028,25864,15420,-10444
6467,0.0,0.0,0.0,1028,25868,15420,-10448
6468,0.0,0.0,0.0,1028,25872,15420,-10452
6469,0.0,0.0,0.0,1028,25876,15420,-10456
6470,0.0,0.0,0.0,1028,25880,15420,-10460
6471,0.0,0.0,0.0,1028,25884,15420,-10464
6472,0.0,0.0,0.0,1028,25888,15420,-10468
6473,0.0,0.0,0.0,1028,25892,15420,-10472
6474,0.0,0.0,0.0,1028,25896,15420,-10476
6475,0.0,0.0,0.0,1028,25900,15420,-10480
6476,0.0,0.0,0.0,1028,25904,15420,-10484
6477,0.0,0.0,0.0,1028,25908,15420,-10488
6478,0.0,0.0,0.0,1028,25912,15420,-10492
6479,0.0,0.0,0.0,1028,25916,15420,-10496
6480,0.0,0.0,0.0,1028,25920,15420,-10500
6481,0.0,0.0,0.0,1028,25924,15420,-10504
6482,0.0,0.0,0.0,1028,25928,15420,-10508
6483,0.0,0.0,0.0,1028,25932,15420,-10512
6484,0.0,0.0,0.0,1028,25936,15420,-10516
6485,0.0,0.0,0.5,1028,25940,15420,-10520
6486,0.0,0.0,0.0,1028,25944,15420,-10524
6487,1.0,1.0,1.0,1029,25948,15435,-10513
6488,0.0,0.0,0.0,1029,25952,15435,-10517
6489,0.0,0.0,0.0,1029,25956,15435,-10521
6490,0.0,0.0,0.0,1029,25960,15435,-10525
6491,0.0,0.0,0.0,1029,25964,15435,-10529
6492,0.0,0.0,0.0,1029,25968,15435,-10533
6493,0.0,0.0,0.0,1029,25972,15435,-10537
6494,0.0,0.0,0.0,1029,25976,15435,-10541
6495,0.0,0.0,0.0,1029,25980,15435,-10545
6496,0.0,0.0,0.0,1029,25984,15435,-10549
6497,0.0,0.0,0.0,1029,25988,15435,-10553
6498,0.0,0.0,0.0,1029,25992,15435,-10557
6499,0.0,0.0,0.0,1029,25996,15435,-10561
6500,0.0,0.0,0.0,1029,26000,15435,-10565
6501,0.0,0.0,0.25,1029,26004,15435,-10569
6502,0.0,0.0,0.0,1029,26008,15435,-10573
6503,1.0,1.0,1.0,1030,26012,15450,-10562
6504,0.0,0.0,0.0,1030,26016,15450,-10566
6505,0.0,0.0,0.0,1030,26020,15450,-10570
6506,0.0,0.0,0.0,1030,26024,15450,-10574
6507,0.0,0.0,0.0,1030,26028,15450,-10578
6508,0.0,0.0,0.0,1030,26032,15450,-10582
6509,0.0,0.0,0.0,1030,26036,15450,-10586
6510,0.0,0.0,0.0,1030,26040,15450,-10590
6511,0.0,0.0,0.3333333333333333,1030,26044,15450,-10594
6512,0.0,0.0,0.0,1030,26048,15450,-10598
6513,0.0,0.0,0.0,1030,26052,15450,-10602
6514,0.0,0.0,0.0,1030,26056,15450,-10606
6515,0.0,0.0,0.0,1030,26060,15450,-10610
6516,0.0,0.0,0.0,1030,26064,15450,-10614
6517,0.0,0.0,0.0,1030,26068,15450,-10618
6518,0.0,0.0,0.0,1030,26072,15450,-10622
6519,1.0,1.0,1.0,1031,26076,15465,-10611
6520,0.0,0.0,0.0,1031,26080,15465,-10615
6521,0.0,0.0,0.0,1031,26084,15465,-10619
6522,0.0,0.0,0.0,1031,26088,15465,-10623
6523,0.0,0.0,0.0,1031,26092,15465,-10627
6524,0.0,0.0,0.0,1031,26096,15465,-10631
6525,0.0,0.0,0.0,1031,26100,15465,-10635
6526,0.0,0.0,0.3333333333333333,1031,26104,15465,-10639
6527,1.0,1.0,1.0,1032,26108,15480,-10628
6528,1.0,1.0,1.0,1033,26112,15495,-10617
6529,0.0,0.0,0.0,1033,26116,15495,-10621
6530,0.0,0.0,0.0,1033,26120,15495,-10625
6531,0.0,0.0,0.0,1033,26124,15495,-10629
6532,0.0,0.0,0.0,1033,26128,15495,-10633
6533,0.0,0.0,0.0,1033,26132,15495,-10637
6534,0.0,0.0,0.0,1033,26136,15495,-10641
6535,0.0,0.0,0.0,1033,26140,15495,-10645
6536,0.0,0.0,0.0,1033,26144,15495,-10649
6537,0.0,0.0,0.0,1033,26148,15495,-10653
6538,0.0,0.0,0.0,1033,26152,15495,-10657
6539,1.0,1.0,1.0,1034,26156,15510,-10646
6540,0.0,0.0,0.0,1034,26160,15510,-10650
6541,0.0,0.0,0.0,1034,26164,15510,-10654
6542,0.0,0.0,0.0,1034,26168,15510,-10658
6543,0.0,0.0,0.0,1034,26172,15510,-10662
6544,0.0,0.0,0.0,1034,26176,15510,-10666
6545,0.0,0.0,0.3333333333333333,1034,26180,15510,-10670
6546,0.0,0.0,0.0,1034,26184,15510,-10674
6547,1.0,0.0,0.4,1035,26188,15525,-10663
6548,1.0,1.0,1.0,1036,26192,15540,-10652
6549,0.0,0.0,0.0,1036,26196,15540,-10656
6550,0.0,0.0,0.0,1036,26200,15540,-10660
6551,0.0,0.0,0.0,1036,26204,15540,-10664
6552,0.0,0.0,0.0,1036,26208,15540,-10668
6553,0.0,0.0,0.0,1036,26212,15540,-10672
6554,1.0,1.0,0.6666666666666666,1037,26216,15555,-10661
6555,0.0,0.0,0.0,1037,26220,15555,-10665
6556,0.0,0.0,0.0,1037,26224,15555,-10669
6557,0.0,0.0,0.0,1037,26228,15555,-10673
6558,0.0,0.0,0.0,1037,26232,15555,-10677
6559,0.0,0.0,0.0,1037,26236,15555,-10681
6560,0.0,0.0,0.0,1037,26240,15555,-10685
6561,0.0,0.0,0.0,1037,26244,15555,-10689
6562,0.0,0.0,0.0,1037,26248,15555,-10693
6563,1.0,1.0,0.8,1038,26252,15570,-10682
6564,0.0,0.0,0.0,1038,26256,15570,-10686
6565,0.0,0.0,0.0,1038,26260,15570,-10690
6566,1.0,1.0,1.0,1039,26264,15585,-10679
6567,0.0,0.0,0.0,1039,26268,15585,-10683
6568,0.0,0.0,0.0,1039,26272,15585,-10687
6569,0.0,0.0,0.0,1039,26276,15585,-10691
6570,0.0,0.0,0.0,1039,26280,15585,-10695
6571,0.0,0.0,0.0,1039,26284,15585,-10699
6572,0.0,0.0,0.0,1039,26288,15585,-10703
6573,0.0,0.0,0.0,1039,26292,15585,-10707
6574,0.0,0.0,0.0,1039,26296,15585,-10711
6575,0.0,0.0,0.0,1039,26300,15585,-10715
6576,1.0,1.0,0.75,1040,26304,15600,-10704
6577,1.0,1.0,1.0,1041,26308,15615,-10693
6578,0.0,0.0,0.0,1041,26312,15615,-10697
6579,0.0,0.0,0.0,1041,26316,15615,-10701
6580,0.0,0.0,0.0,1041,26320,15615,-10705
6581,1.0,1.0,1.0,1042,26324,15630,-10694
6582,0.0,0.0,0.0,1042,26328,15630,-10698
6583,0.0,0.0,0.0,1042,26332,15630,-10702
6584,0.0,0.0,0.0,1042,26336,15630,-10706
6585,0.0,0.0,0.0,1042,26340,15630,-10710
6586,0.0,0.0,0.0,1042,26344,15630,-10714
6587,0.0,0.0,0.4,1042,26348,15630,-10718
6588,0.0,0.0,0.0,1042,26352,15630,-10722
6589,0.0,0.0,0.0,1042,26356,15630,-10726
6590,1.0,1.0,1.0,1043,26360,15645,-10715
6591,1.0,1.0,1.0,1044,26364,15660,-10704
6592,0.0,0.0,0.0,1044,26368,15660,-10708
6593,0.0,0.0,0.0,1044,26372,15660,-10712
6594,0.0,0.0,0.0,1044,26376,15660,-10716
6595,0.0,0.0,0.0,1044,26380,15660,-10720
6596,0.0,0.0,0.0,1044,26384,15660,-10724
6597,1.0,1.0,0.6,1045,26388,15675,-10713
6598,0.0,0.0,0.0,1045,26392,15675,-10717
6599,0.0,0.0,0.0,1045,26396,15675,-10721
6600,0.0,0.0,0.0,1045,26400,15675,-10725
6601,0.0,0.0,0.0,1045,26404,15675,-10729
6602,0.0,0.0,0.0,1045,26408,15675,-10733
6603,0.0,0.0,0.0,1045,26412,15675,-10737
6604,0.0,0.0,0.0,1045,26416,15675,-10741
6605,0.0,0.0,0.0,1045,26420,15675,-10745
6606,0.0,0.0,0.0,1045,26424,15675,-10749
6607,0.0,0.0,0.0,1045,26428,15675,-10753
6608,0.0,0.0,0.0,1045,26432,15675,-10757
6609,0.0,0.0,0.0,1045,26436,15675,-10761
6610,0.0,0.0,0.0,1045,26440,15675,-10765
6611,1.0,1.0,1.0,1046,26444,15690,-10754
6612,0.0,0.0,0.0,1046,26448,15690,-10758
6613,0.0,0.0,0.0,1046,26452,15690,-10762
6614,0.0,0.0,0.0,1046,26456,15690,-10766
6615,0.0,0.0,0.0,1046,26460,15690,-10770
6616,0.0,0.0,0.0,1046,26464,15690,-10774
6617,0.0,0.0,0.0,1046,26468,15690,-10778
6618,0.0,0.0,0.0,1046,26472,15690,-10782
6619,1.0,1.0,1.0,1047,26476,15705,-10771
6620,1.0,1.0,1.0,1048,26480,15720,-10760
6621,1.0,1.0,1.0,1049,26484,15735,-10749
6622,0.0,0.0,0.25,1049,26488,15735,-10753
6623,0.0,0.0,0.3333333333333333,1049,26492,15735,-10757
6624,0.0,0.0,0.0,1049,26496,15735,-10761
6625,0.0,0.0,0.0,1049,26500,15735,-10765
6626,1.0,1.0,1.0,1050,26504,15750,-10754
6627,0.0,0.0,0.0,1050,26508,15750,-10758
6628,1.0,1.0,1.0,1051,26512,15765,-10747
6629,1.0,1.0,1.0,1052,26516,15780,-10736
6630,0.0,0.0,0.0,1052,26520,15780,-10740
6631,1.0,0.0,0.3333333333333333,1053,26524,15795,-10729
6632,0.0,0.0,0.0,1053,26528,15795,-10733
6633,0.0,0.0,0.0,1053,26532,15795,-10737
6634,1.0,1.0,1.0,1054,26536,15810,-10726
6635,0.0,0.0,0.0,1054,26540,15810,-10730
6636,0.0,0.0,0.0,1054,26544,15810,-10734
6637,0.0,0.0,0.0,1054,26548,15810,-10738
6638,0.0,0.0,0.0,1054,26552,15810,-10742
6639,0.0,0.0,0.0,1054,26556,15810,-10746
6640,0.0,1.0,0.6666666666666666,1054,26560,15810,-10750
6641,0.0,0.0,0.0,1054,26564,15810,-10754
6642,0.0,0.0,0.0,1054,26568,15810,-10758
6643,0.0,0.0,0.0,1054,26572,15810,-10762
6644,0.0,0.0,0.0,1054,26576,15810,-10766
6645,0.0,0.0,0.0,1054,26580,15810,-10770
6646,0.0,0.0,0.0,1054,26584,15810,-10774
6647,0.0,0.0,0.0,1054,26588,15810,-10778
6648,0.0,0.0,0.0,1054,26592,15810,-10782
6649,1.0,1.0,1.0,1055,26596,15825,-10771
6650,0.0,0.0,0.0,1055,26600,15825,-10775
6651,0.0,0.0,0.0,1055,26604,15825,-10779
6652,0.0,0.0,0.0,1055,26608,15825,-10783
6653,0.0,0.0,0.0,1055,26612,15825,-10787
6654,1.0,1.0,1.0,1056,26616,15840,-10776
6655,0.0,0.0,0.0,1056,26620,15840,-10780
6656,0.0,0.0,0.0,1056,26624,15840,-10784
6657,0.0,0.0,0.0,1056,26628,15840,-10788
6658,0.0,0.0,0.0,1056,26632,15840,-10792
6659,0.0,0.0,0.0,1056,26636,15840,-10796
6660,0.0,0.0,0.0,1056,26640,15840,-10800
6661,0.0,0.0,0.0,1056,26644,15840,-10804
6662,0.0,0.0,0.0,1056,26648,15840,-10808
6663,0.0,0.0,0.0,1056,26652,15840,-10812
6664,0.0,0.0,0.0,1056,26656,15840,-10816
6665,0.0,0.0,0.0,1056,26660,15840,-10820
6666,0.0,0.0,0.0,1056,26664,15840,-10824
6667,0.0,0.0,0.0,1056,26668,15840,-10828
6668,0.0,0.0,0.0,1056,26672,15840,-10832
6669,0.0,0.0,0.0,1056,26676,15840,-10836
6670,0.0,0.0,0.0,1056,26680,15840,-10840
6671,0.0,0.0,0.0,1056,26684,15840,-10844
6672,0.0,0.0,0.0,1056,26688,15840,-10848
6673,0.0,0.0,0.0,1056,26692,15840,-10852
6674,0.0,0.0,0.0,1056,26696,15840,-10856
6675,0.0,0.0,0.0,1056,26700,15840,-10860
6676,0.0,0.0,0.0,1056,26704,15840,-10864
6677,0.0,0.0,0.0,1056,26708,15840,-10868
6678,0.0,0.0,0.0,1056,26712,15840,-10872
6679,0.0,0.0,0.0,1056,26716,15840,-10876
6680,0.0,0.0,0.0,1056,26720,15840,-10880
6681,0.0,0.0,0.0,1056,26724,15840,-10884
6682,0.0,0.0,0.0,1056,26728,15840,-10888
6683,0.0,0.0,0.0,1056,26732,15840,-10892
6684,0.0,0.0,0.0,1056,26736,15840,-10896
6685,0.0,0.0,0.0,1056,26740,15840,-10900
6686,0.0,0.0,0.0,1056,26744,15840,-10904
6687,0.0,0.0,0.0,1056,26748,15840,-10908
6688,0.0,0.0,0.0,1056,26752,15840,-10912
6689,0.0,0.0,0.0,1056,26756,15840,-10916
6690,0.0,0.0,0.0,1056,26760,15840,-10920
6691,0.0,0.0,0.0,1056,26764,15840,-10924
6692,0.0,0.0,0.0,1056,26768,15840,-10928
6693,0.0,0.0,0.0,1056,26772,15840,-10932
6694,0.0,0.0,0.0,1056,26776,15840,-10936
6695,1.0,1.0,1.0,1057,26780,15855,-10925
6696,0.0,0.0,0.0,1057,26784,15855,-10929
6697,0.0,1.0,0.6666666666666666,1057,26788,15855,-10933
6698,0.0,0.0,0.0,1057,26792,15855,-10937
6699,0.0,0.0,0.0,1057,26796,15855,-10941
6700,0.0,0.0,0.0,1057,26800,15855,-10945
6701,1.0,1.0,1.0,1058,26804,15870,-10934
6702,0.0,0.0,0.0,1058,26808,15870,-10938
6703,0.0,0.0,0.0,1058,26812,15870,-10942
6704,0.0,0.0,0.0,1058,26816,15870,-10946
6705,1.0,1.0,1.0,1059,26820,15885,-10935
6706,0.0,0.0,0.0,1059,26824,15885,-10939
6707,1.0,1.0,0.75,1060,26828,15900,-10928
6708,0.0,0.0,0.0,1060,26832,15900,-10932
6709,0.0,0.0,0.0,1060,26836,15900,-10936
6710,0.0,0.0,0.0,1060,26840,15900,-10940
6711,1.0,1.0,1.0,1061,26844,15915,-10929
6712,0.0,0.0,0.0,1061,26848,15915,-10933
6713,0.0,0.0,0.0,1061,26852,15915,-10937
6714,0.0,0.0,0.0,1061,26856,15915,-10941
6715,0.0,0.0,0.0,1061,26860,15915,-10945
6716,1.0,1.0,1.0,1062,26864,15930,-10934
6717,0.0,0.0,0.0,1062,26868,15930,-10938
6718,0.0,0.0,0.0,1062,26872,15930,-10942
6719,0.0,0.0,0.0,1062,26876,15930,-10946
6720,1.0,1.0,1.0,1063,26880,15945,-10935
6721,0.0,1.0,0.6666666666666666,1063,26884,15945,-10939
6722,1.0,1.0,1.0,1064,26888,15960,-10928
6723,0.0,0.0,0.0,1064,26892,15960,-10932
6724,1.0,1.0,1.0,1065,26896,15975,-10921
6725,0.0,0.0,0.0,1065,26900,15975,-10925
6726,0.0,0.0,0.0,1065,26904,15975,-10929
6727,1.0,1.0,1.0,1066,26908,15990,-10918
6728,0.0,0.0,0.0,1066,26912,15990,-10922
6729,0.0,0.0,0.0,1066,26916,15990,-10926
6730,0.0,0.0,0.0,1066,26920,15990,-10930
6731,0.0,0.0,0.0,1066,26924,15990,-10934
6732,0.0,0.0,0.0,1066,26928,15990,-10938
6733,0.0,0.0,0.0,1066,26932,15990,-10942
6734,0.0,0.0,0.0,1066,26936,15990,-10946
6735,0.0,0.0,0.0,1066,26940,15990,-10950
6736,0.0,1.0,0.6,1066,26944,15990,-10954
6737,0.0,0.0,0.3333333333333333,1066,26948,15990,-10958
6738,0.0,0.0,0.0,1066,26952,15990,-10962
6739,0.0,0.0,0.0,1066,26956,15990,-10966
6740,0.0,0.0,0.0,1066,26960,15990,-10970
6741,0.0,0.0,0.0,1066,26964,15990,-10974
6742,1.0,1.0,1.0,1067,26968,16005,-10963
6743,0.0,0.0,0.0,1067,26972,16005,-10967
6744,0.0,0.0,0.0,1067,26976,16005,-10971
6745,0.0,0.0,0.0,1067,26980,16005,-10975
6746,0.0,0.0,0.0,1067,26984,16005,-10979
6747,0.0,0.0,0.0,1067,26988,16005,-10983
6748,1.0,1.0,1.0,1068,26992,16020,-10972
6749,1.0,1.0,0.6666666666666666,1069,26996,16035,-10961
6750,0.0,0.0,0.0,1069,27000,16035,-10965
6751,0.0,0.0,0.0,1069,27004,16035,-10969
6752,1.0,1.0,0.6666666666666666,1070,27008,16050,-10958
6753,0.0,0.0,0.0,1070,27012,16050,-10962
6754,1.0,0.0,0.5,1071,27016,16065,-10951
6755,0.0,0.0,0.0,1071,27020,16065,-10955
6756,1.0,1.0,1.0,1072,27024,16080,-10944
6757,1.0,1.0,1.0,1073,27028,16095,-10933
6758,0.0,0.0,0.0,1073,27032,16095,-10937
6759,1.0,1.0,1.0,1074,27036,16110,-10926
6760,0.0,0.0,0.0,1074,27040,16110,-10930
6761,0.0,0.0,0.0,1074,27044,16110,-10934
6762,0.0,0.0,0.0,1074,27048,16110,-10938
6763,0.0,0.0,0.3333333333333333,1074,27052,16110,-10942
6764,0.0,0.0,0.0,1074,27056,16110,-10946
6765,0.0,0.0,0.0,1074,27060,16110,-10950
6766,0.0,0.0,0.0,1074,27064,16110,-10954
6767,0.0,0.0,0.0,1074,27068,16110,-10958
6768,0.0,0.0,0.0,1074,27072,16110,-10962
6769,0.0,0.0,0.0,1074,27076,16110,-10966
6770,0.0,0.0,0.0,1074,27080,16110,-10970
6771,0.0,0.0,0.0,1074,27084,16110,-10974
6772,0.0,0.0,0.0,1074,27088,16110,-10978
6773,1.0,1.0,1.0,1075,27092,16125,-10967
6774,0.0,0.0,0.0,1075,27096,16125,-10971
6775,0.0,0.0,0.0,1075,27100,16125,-10975
6776,0.0,0.0,0.0,1075,27104,16125,-10979
6777,0.0,0.0,0.0,1075,27108,16125,-10983
6778,0.0,0.0,0.0,1075,27112,16125,-10987
6779,0.0,0.0,0.0,1075,27116,16125,-10991
6780,0.0,0.0,0.0,1075,27120,16125,-10995
6781,1.0,1.0,1.0,1076,27124,16140,-10984
6782,0.0,0.0,0.3333333333333333,1076,27128,16140,-10988
6783,0.0,0.0,0.0,1076,27132,16140,-10992
6784,0.0,0.0,0.0,1076,27136,16140,-10996
6785,0.0,0.0,0.0,1076,27140,16140,-11000
6786,1.0,1.0,1.0,1077,27144,16155,-10989
6787,0.0,0.0,0.0,1077,27148,16155,-10993
6788,0.0,0.0,0.0,1077,27152,16155,-10997
6789,0.0,0.0,0.0,1077,27156,16155,-11001
6790,1.0,1.0,1.0,1078,27160,16170,-10990
6791,0.0,0.0,0.0,1078,27164,16170,-10994
6792,0.0,0.0,0.0,1078,27168,16170,-10998
6793,0.0,0.0,0.0,1078,27172,16170,-11002
6794,1.0,0.0,0.2,1079,27176,16185,-10991
6795,0.0,0.0,0.0,1079,27180,16185,-10995
6796,0.0,0.0,0.0,1079,27184,16185,-10999
6797,0.0,0.0,0.0,1079,27188,16185,-11003
6798,0.0,0.0,0.0,1079,27192,16185,-11007
6799,0.0,0.0,0.0,1079,27196,16185,-11011
6800,0.0,0.0,0.0,1079,27200,16185,-11015
6801,0.0,0.0,0.0,1079,27204,16185,-11019
6802,0.0,0.0,0.0,1079,27208,16185,-11023
6803,0.0,0.0,0.0,1079,27212,16185,-11027
6804,0.0,0.0,0.0,1079,27216,16185,-11031
6805,1.0,1.0,1.0,1080,27220,16200,-11020
6806,0.0,0.0,0.0,1080,27224,16200,-11024
6807,0.0,0.0,0.0,1080,27228,16200,-11028
6808,0.0,0.0,0.0,1080,27232,16200,-11032
6809,0.0,0.0,0.0,1080,27236,16200,-11036
6810,1.0,1.0,1.0,1081,27240,16215,-11025
6811,0.0,0.0,0.0,1081,27244,16215,-11029
6812,0.0,0.0,0.0,1081,27248,16215,-11033
6813,1.0,1.0,1.0,1082,27252,16230,-11022
6814,0.0,0.0,0.0,1082,27256,16230,-11026
6815,0.0,0.0,0.0,1082,27260,16230,-11030
6816,0.0,0.0,0.0,1082,27264,16230,-11034
6817,0.0,0.0,0.0,1082,27268,16230,-11038
6818,0.0,0.0,0.3333333333333333,1082,27272,16230,-11042
6819,0.0,0.0,0.0,1082,27276,16230,-11046
6820,1.0,1.0,0.6,1083,27280,16245,-11035
6821,0.0,0.0,0.0,1083,27284,16245,-11039
6822,0.0,0.0,0.0,1083,27288,16245,-11043
6823,0.0,0.0,0.0,1083,27292,16245,-11047
6824,0.0,0.0,0.0,1083,27296,16245,-11051
6825,0.0,0.0,0.0,1083,27300,16245,-11055
6826,0.0,0.0,0.0,1083,27304,16245,-11059
6827,0.0,0.0,0.0,1083,27308,16245,-11063
6828,0.0,0.0,0.0,1083,27312,16245,-11067
6829,0.0,0.0,0.0,1083,27316,16245,-11071
6830,0.0,0.0,0.0,1083,27320,16245,-11075
6831,0.0,0.0,0.0,1083,27324,16245,-11079
6832,1.0,1.0,1.0,1084,27328,16260,-11068
6833,0.0,1.0,0.6666666666666666,1084,27332,16260,-11072
6834,0.0,0.0,0.0,1084,27336,16260,-11076
6835,0.0,0.0,0.0,1084,27340,16260,-11080
6836,0.0,0.0,0.0,1084,27344,16260,-11084
6837,1.0,1.0,0.6666666666666666,1085,27348,16275,-11073
6838,0.0,0.0,0.0,1085,27352,16275,-11077
6839,0.0,0.0,0.0,1085,27356,16275,-11081
6840,1.0,1.0,1.0,1086,27360,16290,-11070
6841,0.0,0.0,0.0,1086,27364,16290,-11074
6842,0.0,0.0,0.0,1086,27368,16290,-11078
6843,0.0,0.0,0.0,1086,27372,16290,-11082
6844,1.0,1.0,1.0,1087,27376,16305,-11071
6845,0.0,0.0,0.0,1087,27380,16305,-11075
6846,0.0,0.0,0.3333333333333333,1087,27384,16305,-11079
6847,0.0,0.0,0.0,1087,27388,16305,-11083
6848,0.0,0.0,0.0,1087,27392,16305,-11087
6849,0.0,0.0,0.3333333333333333,1087,27396,16305,-11091
6850,0.0,0.0,0.0,1087,27400,16305,-11095
6851,0.0,0.0,0.0,1087,27404,16305,-11099
6852,0.0,0.0,0.0,1087,27408,16305,-11103
6853,1.0,1.0,1.0,1088,27412,16320,-11092
6854,0.0,0.0,0.0,1088,27416,16320,-11096
6855,0.0,0.0,0.0,1088,27420,16320,-11100
6856,1.0,1.0,1.0,1089,27424,16335,-11089
6857,0.0,0.0,0.0,1089,27428,16335,-11093
6858,0.0,0.0,0.0,1089,27432,16335,-11097
6859,0.0,0.0,0.0,1089,27436,16335,-11101
6860,1.0,1.0,1.0,1090,27440,16350,-11090
6861,0.0,0.0,0.0,1090,27444,16350,-11094
6862,0.0,0.0,0.0,1090,27448,16350,-11098
6863,1.0,1.0,1.0,1091,27452,16365,-11087
6864,0.0,0.0,0.0,1091,27456,16365,-11091
6865,0.0,0.0,0.0,1091,27460,16365,-11095
6866,0.0,0.0,0.0,1091,27464,16365,-11099
6867,0.0,0.0,0.0,1091,27468,16365,-11103
6868,0.0,0.0,0.0,1091,27472,16365,-11107
6869,1.0,1.0,1.0,1092,27476,16380,-11096
6870,0.0,0.0,0.0,1092,27480,16380,-11100
6871,1.0,1.0,1.0,1093,27484,16395,-11089
6872,0.0,0.0,0.0,1093,27488,16395,-11093
6873,0.0,0.0,0.0,1093,27492,16395,-11097
6874,0.0,0.0,0.0,1093,27496,16395,-11101
6875,0.0,0.0,0.0,1093,27500,16395,-11105
6876,0.0,0.0,0.0,1093,27504,16395,-11109
6877,0.0,0.0,0.0,1093,27508,16395,-11113
6878,0.0,0.0,0.0,1093,27512,16395,-11117
6879,0.0,0.0,0.0,1093,27516,16395,-11121
6880,0.0,0.0,0.0,1093,27520,16395,-11125
6881,0.0,0.0,0.0,1093,27524,16395,-11129
6882,0.0,0.0,0.0,1093,27528,16395,-11133
6883,0.0,0.0,0.0,1093,27532,16395,-11137
6884,0.0,0.0,0.0,1093,27536,16395,-11141
6885,1.0,1.0,1.0,1094,27540,16410,-11130
6886,0.0,0.0,0.0,1094,27544,16410,-11134
6887,1.0,1.0,1.0,1095,27548,16425,-11123
6888,0.0,0.0,0.2,1095,27552,16425,-11127
6889,0.0,0.0,0.0,1095,27556,16425,-11131
6890,0.0,0.0,0.0,1095,27560,16425,-11135
6891,0.0,0.0,0.0,1095,27564,16425,-11139
6892,0.0,0.0,0.0,1095,27568,16425,-11143
6893,0.0,0.0,0.0,1095,27572,16425,-11147
6894,0.0,0.0,0.0,1095,27576,16425,-11151
6895,0.0,0.0,0.0,1095,27580,16425,-11155
6896,0.0,0.0,0.0,1095,27584,16425,-11159
6897,0.0,0.0,0.0,1095,27588,16425,-11163
6898,0.0,0.0,0.0,1095,27592,16425,-11167
6899,0.0,0.0,0.0,1095,27596,16425,-11171
6900,0.0,0.0,0.0,1095,27600,16425,-11175
6901,0.0,0.0,0.0,1095,27604,16425,-11179
6902,0.0,0.0,0.0,1095,27608,16425,-11183
6903,1.0,1.0,1.0,1096,27612,16440,-11172
6904,0.0,0.0,0.0,1096,27616,16440,-11176
6905,0.0,0.0,0.0,1096,27620,16440,-11180
6906,0.0,0.0,0.0,1096,27624,16440,-11184
6907,0.0,0.0,0.0,1096,27628,16440,-11188
6908,1.0,1.0,1.0,1097,27632,16455,-11177
6909,0.0,0.0,0.0,1097,27636,16455,-11181
6910,0.0,0.0,0.0,1097,27640,16455,-11185
6911,0.0,0.0,0.0,1097,27644,16455,-11189
6912,0.0,0.0,0.0,1097,27648,16455,-11193
6913,0.0,0.0,0.0,1097,27652,16455,-11197
6914,0.0,0.0,0.0,1097,27656,16455,-11201
6915,0.0,0.0,0.0,1097,27660,16455,-11205
6916,0.0,0.0,0.3333333333333333,1097,27664,16455,-11209
6917,0.0,0.0,0.0,1097,27668,16455,-11213
6918,0.0,0.0,0.0,1097,27672,16455,-11217
6919,0.0,0.0,0.0,1097,27676,16455,-11221
6920,0.0,0.0,0.0,1097,27680,16455,-11225
6921,0.0,0.0,0.0,1097,27684,16455,-11229
6922,0.0,0.0,0.0,1097,27688,16455,-11233
6923,0.0,0.0,0.0,1097,27692,16455,-11237
6924,0.0,0.0,0.25,1097,27696,16455,-11241
6925,0.0,0.0,0.0,1097,27700,16455,-11245
6926,0.0,0.0,0.0,1097,27704,16455,-11249
6927,0.0,0.0,0.0,1097,27708,16455,-11253
6928,0.0,0.0,0.0,1097,27712,16455,-11257
6929,0.0,0.0,0.0,1097,27716,16455,-11261
6930,0.0,0.0,0.0,1097,27720,16455,-11265
6931,0.0,0.0,0.0,1097,27724,16455,-11269
6932,0.0,0.0,0.0,1097,27728,16455,-11273
6933,0.0,0.0,0.0,1097,27732,16455,-11277
6934,0.0,0.0,0.0,1097,27736,16455,-11281
6935,0.0,0.0,0.0,1097,27740,16455,-11285
6936,0.0,0.0,0.0,1097,27744,16455,-11289
6937,0.0,0.0,0.0,1097,27748,16455,-11293
6938,0.0,0.0,0.0,1097,27752,16455,-11297
6939,0.0,0.0,0.0,1097,27756,16455,-11301
6940,0.0,0.0,0.0,1097,27760,16455,-11305
6941,0.0,0.0,0.0,1097,27764,16455,-11309
6942,0.0,0.0,0.0,1097,27768,16455,-11313
6943,0.0,0.0,0.0,1097,27772,16455,-11317
6944,0.0,0.0,0.0,1097,27776,16455,-11321
6945,1.0,1.0,1.0,1098,27780,16470,-11310
6946,0.0,0.0,0.0,1098,27784,16470,-11314
6947,1.0,1.0,0.6666666666666666,1099,27788,16485,-11303
6948,0.0,0.0,0.0,1099,27792,16485,-11307
6949,0.0,0.0,0.0,1099,27796,16485,-11311
6950,0.0,0.0,0.0,1099,27800,16485,-11315
6951,0.0,0.0,0.0,1099,27804,16485,-11319
6952,0.0,0.0,0.0,1099,27808,16485,-11323
6953,0.0,0.0,0.0,1099,27812,16485,-11327
6954,0.0,0.0,0.0,1099,27816,16485,-11331
6955,0.0,0.0,0.0,1099,27820,16485,-11335
6956,0.0,1.0,0.75,1099,27824,16485,-11339
6957,1.0,1.0,1.0,1100,27828,16500,-11328
6958,0.0,0.0,0.0,1100,27832,16500,-11332
6959,0.0,0.0,0.0,1100,27836,16500,-11336
6960,0.0,0.0,0.0,1100,27840,16500,-11340
6961,0.0,0.0,0.0,1100,27844,16500,-11344
6962,0.0,0.0,0.0,1100,27848,16500,-11348
6963,0.0,0.0,0.0,1100,27852,16500,-11352
6964,0.0,0.0,0.0,1100,27856,16500,-11356
6965,0.0,0.0,0.0,1100,27860,16500,-11360
6966,0.0,0.0,0.0,1100,27864,16500,-11364
6967,0.0,0.0,0.0,1100,27868,16500,-11368
6968,1.0,1.0,1.0,1101,27872,16515,-11357
6969,0.0,0.0,0.0,1101,27876,16515,-11361
6970,0.0,0.0,0.0,1101,27880,16515,-11365
6971,0.0,0.0,0.0,1101,27884,16515,-11369
6972,0.0,0.0,0.0,1101,27888,16515,-11373
6973,0.0,0.0,0.0,1101,27892,16515,-11377
6974,0.0,0.0,0.3333333333333333,1101,27896,16515,-11381
6975,0.0,0.0,0.0,1101,27900,16515,-11385
6976,1.0,1.0,1.0,1102,27904,16530,-11374
6977,0.0,0.0,0.0,1102,27908,16530,-11378
6978,0.0,0.0,0.0,1102,27912,16530,-11382
6979,1.0,1.0,1.0,1103,27916,16545,-11371
6980,0.0,0.0,0.0,1103,27920,16545,-11375
6981,0.0,0.0,0.0,1103,27924,16545,-11379
6982,0.0,0.0,0.0,1103,27928,16545,-11383
6983,1.0,1.0,0.6666666666666666,1104,27932,16560,-11372
6984,0.0,0.0,0.0,1104,27936,16560,-11376
6985,1.0,1.0,1.0,1105,27940,16575,-11365
6986,1.0,1.0,1.0,1106,27944,16590,-11354
6987,0.0,0.0,0.0,1106,27948,16590,-11358
6988,0.0,0.0,0.0,1106,27952,16590,-11362
6989,0.0,0.0,0.0,1106,27956,16590,-11366
6990,0.0,0.0,0.0,1106,27960,16590,-11370
6991,0.0,0.0,0.0,1106,27964,16590,-11374
6992,0.0,0.0,0.0,1106,27968,16590,-11378
6993,0.0,0.0,0.0,1106,27972,16590,-11382
6994,0.0,0.0,0.0,1106,27976,16590,-11386
6995,0.0,0.0,0.0,1106,27980,16590,-11390
6996,0.0,0.0,0.0,1106,27984,16590,-11394
6997,0.0,0.0,0.0,1106,27988,16590,-11398
6998,0.0,0.0,0.0,1106,27992,16590,-11402
6999,0.0,0.0,0.0,1106,27996,16590,-11406
7000,1.0,1.0,1.0,1107,28000,16605,-11395
7001,1.0,1.0,1.0,1108,28004,16620,-11384
7002,0.0,0.0,0.0,1108,28008,16620,-11388
7003,0.0,0.0,0.0,1108,28012,16620,-11392
7004,0.0,0.0,0.0,1108,28016,16620,-11396
7005,0.0,0.0,0.0,1108,28020,16620,-11400
7006,0.0,0.0,0.0,1108,28024,16620,-11404
7007,0.0,0.0,0.0,1108,28028,16620,-11408
7008,0.0,0.0,0.0,1108,28032,16620,-11412
7009,0.0,0.0,0.0,1108,28036,16620,-11416
7010,0.0,0.0,0.0,1108,28040,16620,-11420
7011,0.0,0.0,0.0,1108,28044,16620,-11424
7012,0.0,0.0,0.0,1108,28048,16620,-11428
7013,0.0,0.0,0.0,1108,28052,16620,-11432
7014,0.0,0.0,0.0,1108,28056,16620,-11436
7015,0.0,0.0,0.0,1108,28060,16620,-11440
7016,0.0,0.0,0.0,1108,28064,16620,-11444
7017,0.0,0.0,0.0,1108,28068,16620,-11448
7018,0.0,0.0,0.0,1108,28072,16620,-11452
7019,1.0,1.0,1.0,1109,28076,16635,-11441
7020,1.0,1.0,1.0,1110,28080,16650,-11430
7021,0.0,0.0,0.0,1110,28084,16650,-11434
7022,1.0,1.0,1.0,1111,28088,16665,-11423
7023,0.0,0.0,0.0,1111,28092,16665,-11427
7024,0.0,0.0,0.0,1111,28096,16665,-11431
7025,0.0,0.0,0.0,1111,28100,16665,-11435
7026,0.0,0.0,0.0,1111,28104,16665,-11439
7027,0.0,0.0,0.0,1111,28108,16665,-11443
7028,0.0,0.0,0.0,1111,28112,16665,-11447
7029,0.0,0.0,0.5,1111,28116,16665,-11451
7030,0.0,0.0,0.0,1111,28120,16665,-11455
7031,0.0,0.0,0.0,1111,28124,16665,-11459
7032,0.0,0.0,0.0,1111,28128,16665,-11463
7033,0.0,0.0,0.0,1111,28132,16665,-11467
7034,0.0,0.0,0.0,1111,28136,16665,-11471
7035,0.0,0.0,0.0,1111,28140,16665,-11475
7036,0.0,0.0,0.0,1111,28144,16665,-11479
7037,0.0,0.0,0.0,1111,28148,16665,-11483
7038,0.0,0.0,0.0,1111,28152,16665,-11487
7039,0.0,0.0,0.0,1111,28156,16665,-11491
7040,0.0,0.0,0.0,1111,28160,16665,-11495
7041,1.0,1.0,1.0,1112,28164,16680,-11484
7042,0.0,0.0,0.0,1112,28168,16680,-11488
7043,0.0,0.0,0.0,1112,28172,16680,-11492
7044,0.0,0.0,0.0,1112,28176,16680,-11496
7045,0.0,0.0,0.0,1112,28180,16680,-11500
7046,0.0,0.0,0.0,1112,28184,16680,-11504
7047,1.0,1.0,1.0,1113,28188,16695,-11493
7048,0.0,0.0,0.0,1113,28192,16695,-11497
7049,0.0,0.0,0.0,1113,28196,16695,-11501
7050,0.0,0.0,0.0,1113,28200,16695,-11505
7051,0.0,0.0,0.0,1113,28204,16695,-11509
7052,0.0,0.0,0.0,1113,28208,16695,-11513
7053,0.0,0.0,0.0,1113,28212,16695,-11517
7054,0.0,0.0,0.0,1113,28216,16695,-11521
7055,0.0,0.0,0.0,1113,28220,16695,-11525
7056,0.0,0.0,0.0,1113,28224,16695,-11529
7057,0.0,0.0,0.0,1113,28228,16695,-11533
7058,0.0,0.0,0.0,1113,28232,16695,-11537
7059,0.0,0.0,0.0,1113,28236,16695,-11541
7060,0.0,0.0,0.0,1113,28240,16695,-11545
7061,0.0,0.0,0.0,1113,28244,16695,-11549
7062,0.0,0.0,0.0,1113,28248,16695,-11553
7063,0.0,0.0,0.0,1113,28252,16695,-11557
7064,0.0,0.0,0.0,1113,28256,16695,-11561
7065,0.0,0.0,0.0,1113,28260,16695,-11565
7066,1.0,1.0,0.6666666666666666,1114,28264,16710,-11554
7067,0.0,0.0,0.0,1114,28268,16710,-11558
7068,0.0,0.0,0.0,1114,28272,16710,-11562
7069,0.0,0.0,0.0,1114,28276,16710,-11566
7070,0.0,0.0,0.0,1114,28280,16710,-11570
7071,0.0,0.0,0.0,1114,28284,16710,-11574
7072,0.0,0.0,0.0,1114,28288,16710,-11578
7073,0.0,0.0,0.0,1114,28292,16710,-11582
7074,0.0,0.0,0.0,1114,28296,16710,-11586
7075,0.0,0.0,0.0,1114,28300,16710,-11590
7076,0.0,0.0,0.0,1114,28304,16710,-11594
7077,0.0,0.0,0.0,1114,28308,16710,-11598
7078,0.0,0.0,0.0,1114,28312,16710,-11602
7079,0.0,0.0,0.0,1114,28316,16710,-11606
7080,0.0,0.0,0.2,1114,28320,16710,-11610
7081,1.0,1.0,1.0,1115,28324,16725,-11599
7082,0.0,0.0,0.0,1115,28328,16725,-11603
7083,0.0,0.0,0.0,1115,28332,16725,-11607
7084,0.0,0.0,0.0,1115,28336,16725,-11611
7085,0.0,0.0,0.0,1115,28340,16725,-11615
7086,1.0,1.0,1.0,1116,28344,16740,-11604
7087,1.0,1.0,1.0,1117,28348,16755,-11593
7088,0.0,0.0,0.0,1117,28352,16755,-11597
7089,0.0,0.0,0.5,1117,28356,16755,-11601
7090,0.0,0.0,0.0,1117,28360,16755,-11605
7091,0.0,0.0,0.0,1117,28364,16755,-11609
7092,0.0,0.0,0.3333333333333333,1117,28368,16755,-11613
7093,0.0,0.0,0.0,1117,28372,16755,-11617
7094,0.0,0.0,0.0,1117,28376,16755,-11621
7095,0.0,0.0,0.0,1117,28380,16755,-11625
7096,0.0,0.0,0.0,1117,28384,16755,-11629
7097,0.0,0.0,0.0,1117,28388,16755,-11633
7098,0.0,0.0,0.0,1117,28392,16755,-11637
7099,1.0,1.0,1.0,1118,28396,16770,-11626
7100,0.0,0.0,0.0,1118,28400,16770,-11630
7101,0.0,0.0,0.0,1118,28404,16770,-11634
7102,1.0,1.0,1.0,1119,28408,16785,-11623
7103,1.0,1.0,1.0,1120,28412,16800,-11612
7104,0.0,0.0,0.3333333333333333,1120,28416,16800,-11616
7105,1.0,1.0,1.0,1121,28420,16815,-11605
7106,0.0,0.0,0.0,1121,28424,16815,-11609
7107,0.0,0.0,0.0,1121,28428,16815,-11613
7108,0.0,0.0,0.0,1121,28432,16815,-11617
7109,0.0,0.0,0.0,1121,28436,16815,-11621
7110,1.0,1.0,1.0,1122,28440,16830,-11610
7111,0.0,0.0,0.0,1122,28444,16830,-11614
7112,0.0,0.0,0.0,1122,28448,16830,-11618
7113,0.0,0.0,0.0,1122,28452,16830,-11622
7114,0.0,0.0,0.0,1122,28456,16830,-11626
7115,1.0,1.0,1.0,1123,28460,16845,-11615
7116,1.0,0.0,0.3333333333333333,1124,28464,16860,-11604
7117,0.0,0.0,0.0,1124,28468,16860,-11608
7118,0.0,0.0,0.0,1124,28472,16860,-11612
7119,0.0,0.0,0.0,1124,28476,16860,-11616
7120,0.0,0.0,0.0,1124,28480,16860,-11620
7121,0.0,0.0,0.0,1124,28484,16860,-11624
7122,1.0,1.0,1.0,1125,28488,16875,-11613
7123,0.0,0.0,0.0,1125,28492,16875,-11617
7124,1.0,1.0,1.0,1126,28496,16890,-11606
7125,0.0,0.0,0.0,1126,28500,16890,-11610
7126,0.0,0.0,0.0,1126,28504,16890,-11614
7127,1.0,0.0,0.3333333333333333,1127,28508,16905,-11603
7128,0.0,0.0,0.0,1127,28512,16905,-11607
7129,0.0,0.0,0.0,1127,28516,16905,-11611
7130,0.0,0.0,0.0,1127,28520,16905,-11615
7131,0.0,0.0,0.0,1127,28524,16905,-11619
7132,0.0,0.0,0.0,1127,28528,16905,-11623
7133,0.0,0.0,0.0,1127,28532,16905,-11627
7134,0.0,0.0,0.0,1127,28536,16905,-11631
7135,0.0,0.0,0.0,1127,28540,16905,-11635
7136,1.0,1.0,1.0,1128,28544,16920,-11624
7137,0.0,0.0,0.0,1128,28548,16920,-11628
7138,0.0,0.0,0.0,1128,28552,16920,-11632
7139,0.0,0.0,0.0,1128,28556,16920,-11636
7140,0.0,0.0,0.0,1128,28560,16920,-11640
7141,0.0,0.0,0.0,1128,28564,16920,-11644
7142,1.0,1.0,1.0,1129,28568,16935,-11633
7143,1.0,1.0,1.0,1130,28572,16950,-11622
7144,1.0,1.0,1.0,1131,28576,16965,-11611
7145,0.0,0.0,0.0,1131,28580,16965,-11615
7146,0.0,0.0,0.0,1131,28584,16965,-11619
7147,0.0,0.0,0.0,1131,28588,16965,-11623
7148,0.0,0.0,0.0,1131,28592,16965,-11627
7149,1.0,1.0,1.0,1132,28596,16980,-11616
7150,0.0,0.0,0.0,1132,28600,16980,-11620
7151,0.0,0.0,0.0,1132,28604,16980,-11624
7152,0.0,0.0,0.0,1132,28608,16980,-11628
7153,1.0,1.0,1.0,1133,28612,16995,-11617
7154,0.0,0.0,0.0,1133,28616,16995,-11621
7155,0.0,0.0,0.0,1133,28620,16995,-11625
7156,0.0,0.0,0.0,1133,28624,16995,-11629
7157,0.0,0.0,0.0,1133,28628,16995,-11633
7158,0.0,0.0,0.0,1133,28632,16995,-11637
7159,0.0,0.0,0.0,1133,28636,16995,-11641
7160,0.0,0.0,0.0,1133,28640,16995,-11645
7161,1.0,1.0,0.6666666666666666,1134,28644,17010,-11634
7162,0.0,0.0,0.0,1134,28648,17010,-11638
7163,1.0,1.0,1.0,1135,28652,17025,-11627
7164,0.0,0.0,0.0,1135,28656,17025,-11631
7165,0.0,0.0,0.0,1135,28660,17025,-11635
7166,0.0,0.0,0.0,1135,28664,17025,-11639
7167,0.0,0.0,0.0,1135,28668,17025,-11643
7168,0.0,0.0,0.0,1135,28672,17025,-11647
7169,0.0,0.0,0.0,1135,28676,17025,-11651
7170,0.0,0.0,0.0,1135,28680,17025,-11655
7171,0.0,0.0,0.0,1135,28684,17025,-11659
7172,1.0,1.0,0.6666666666666666,1136,28688,17040,-11648
7173,0.0,0.0,0.0,1136,28692,17040,-11652
7174,0.0,0.0,0.0,1136,28696,17040,-11656
7175,0.0,0.0,0.0,1136,28700,17040,-11660
7176,0.0,0.0,0.0,1136,28704,17040,-11664
7177,0.0,0.0,0.0,1136,28708,17040,-11668
7178,0.0,0.0,0.0,1136,28712,17040,-11672
7179,0.0,0.0,0.0,1136,28716,17040,-11676
7180,0.0,0.0,0.0,1136,28720,17040,-11680
7181,0.0,0.0,0.0,1136,28724,17040,-11684
7182,1.0,0.0,0.2,1137,28728,17055,-11673
7183,0.0,0.0,0.0,1137,28732,17055,-11677
7184,0.0,0.0,0.0,1137,28736,17055,-11681
7185,0.0,0.0,0.0,1137,28740,17055,-11685
7186,0.0,0.0,0.0,1137,28744,17055,-11689
7187,0.0,0.0,0.0,1137,28748,17055,-11693
7188,1.0,1.0,1.0,1138,28752,17070,-11682
7189,1.0,0.0,0.25,1139,28756,17085,-11671
7190,0.0,0.0,0.0,1139,28760,17085,-11675
7191,0.0,0.0,0.0,1139,28764,17085,-11679
7192,0.0,0.0,0.0,1139,28768,17085,-11683
7193,0.0,0.0,0.0,1139,28772,17085,-11687
7194,1.0,1.0,1.0,1140,28776,17100,-11676
7195,0.0,0.0,0.0,1140,28780,17100,-11680
7196,1.0,0.0,0.5,1141,28784,17115,-11669
7197,1.0,1.0,1.0,1142,28788,17130,-11658
7198,0.0,0.0,0.0,1142,28792,17130,-11662
7199,0.0,0.0,0.0,1142,28796,17130,-11666
7200,0.0,0.0,0.0,1142,28800,17130,-11670
7201,0.0,0.0,0.0,1142,28804,17130,-11674
7202,0.0,0.0,0.0,1142,28808,17130,-11678
7203,1.0,1.0,1.0,1143,28812,17145,-11667
7204,0.0,0.0,0.0,1143,28816,17145,-11671
7205,0.0,0.0,0.0,1143,28820,17145,-11675
7206,0.0,0.0,0.0,1143,28824,17145,-11679
7207,0.0,0.0,0.0,1143,28828,17145,-11683
7208,0.0,0.0,0.0,1143,28832,17145,-11687
7209,0.0,0.0,0.0,1143,28836,17145,-11691
7210,0.0,0.0,0.0,1143,28840,17145,-11695
7211,0.0,0.0,0.0,1143,28844,17145,-11699
7212,1.0,1.0,1.0,1144,28848,17160,-11688
7213,0.0,0.0,0.0,1144,28852,17160,-11692
7214,0.0,0.0,0.0,1144,28856,17160,-11696
7215,0.0,0.0,0.0,1144,28860,17160,-11700
7216,1.0,0.0,0.3333333333333333,1145,28864,17175,-11689
7217,0.0,0.0,0.0,1145,28868,17175,-11693
7218,0.0,0.0,0.0,1145,28872,17175,-11697
7219,0.0,0.0,0.0,1145,28876,17175,-11701
7220,0.0,0.0,0.0,1145,28880,17175,-11705
7221,0.0,0.0,0.0,1145,28884,17175,-11709
7222,0.0,0.0,0.0,1145,28888,17175,-11713
7223,0.0,0.0,0.25,1145,28892,17175,-11717
7224,0.0,0.0,0.0,1145,28896,17175,-11721
7225,1.0,1.0,0.6666666666666666,1146,28900,17190,-11710
7226,0.0,0.0,0.0,1146,28904,17190,-11714
7227,0.0,0.0,0.0,1146,28908,17190,-11718
7228,0.0,0.0,0.0,1146,28912,17190,-11722
7229,0.0,0.0,0.0,1146,28916,17190,-11726
7230,1.0,1.0,0.6,1147,28920,17205,-11715
7231,1.0,0.0,0.3333333333333333,1148,28924,17220,-11704
7232,0.0,0.0,0.0,1148,28928,17220,-11708
7233,1.0,1.0,0.8,1149,28932,17235,-11697
7234,0.0,0.0,0.0,1149,28936,17235,-11701
7235,0.0,0.0,0.0,1149,28940,17235,-11705
7236,0.0,0.0,0.0,1149,28944,17235,-11709
7237,0.0,0.0,0.0,1149,28948,17235,-11713
7238,0.0,0.0,0.0,1149,28952,17235,-11717
7239,0.0,0.0,0.0,1149,28956,17235,-11721
7240,0.0,0.0,0.0,1149,28960,17235,-11725
7241,0.0,0.0,0.0,1149,28964,17235,-11729
7242,0.0,0.0,0.0,1149,28968,17235,-11733
7243,0.0,0.0,0.0,1149,28972,17235,-11737
7244,0.0,0.0,0.0,1149,28976,17235,-11741
7245,1.0,1.0,1.0,1150,28980,17250,-11730
7246,0.0,0.0,0.0,1150,28984,17250,-11734
7247,0.0,0.0,0.0,1150,28988,17250,-11738
7248,0.0,0.0,0.0,1150,28992,17250,-11742
7249,1.0,1.0,1.0,1151,28996,17265,-11731
7250,0.0,0.0,0.0,1151,29000,17265,-11735
7251,0.0,0.0,0.0,1151,29004,17265,-11739
7252,0.0,0.0,0.0,1151,29008,17265,-11743
7253,0.0,0.0,0.0,1151,29012,17265,-11747
7254,0.0,0.0,0.0,1151,29016,17265,-11751
7255,0.0,0.0,0.0,1151,29020,17265,-11755
7256,0.0,0.0,0.0,1151,29024,17265,-11759
7257,0.0,0.0,0.0,1151,29028,17265,-11763
7258,1.0,1.0,1.0,1152,29032,17280,-11752
7259,0.0,0.0,0.0,1152,29036,17280,-11756
7260,0.0,0.0,0.0,1152,29040,17280,-11760
7261,0.0,0.0,0.0,1152,29044,17280,-11764
7262,0.0,0.0,0.0,1152,29048,17280,-11768
7263,0.0,0.0,0.0,1152,29052,17280,-11772
7264,0.0,0.0,0.0,1152,29056,17280,-11776
7265,0.0,0.0,0.0,1152,29060,17280,-11780
7266,0.0,0.0,0.0,1152,29064,17280,-11784
7267,0.0,0.0,0.0,1152,29068,17280,-11788
7268,0.0,0.0,0.0,1152,29072,17280,-11792
7269,0.0,0.0,0.0,1152,29076,17280,-11796
7270,1.0,1.0,0.6666666666666666,1153,29080,17295,-11785
7271,0.0,0.0,0.0,1153,29084,17295,-11789
7272,0.0,0.0,0.0,1153,29088,17295,-11793
7273,0.0,0.0,0.0,1153,29092,17295,-11797
7274,1.0,1.0,0.6666666666666666,1154,29096,17310,-11786
7275,1.0,1.0,1.0,1155,29100,17325,-11775
7276,0.0,0.0,0.0,1155,29104,17325,-11779
7277,0.0,0.0,0.0,1155,29108,17325,-11783
7278,0.0,0.0,0.0,1155,29112,17325,-11787
7279,0.0,0.0,0.0,1155,29116,17325,-11791
7280,0.0,0.0,0.0,1155,29120,17325,-11795
7281,0.0,0.0,0.0,1155,29124,17325,-11799
7282,0.0,0.0,0.0,1155,29128,17325,-11803
7283,1.0,1.0,1.0,1156,29132,17340,-11792
7284,0.0,0.0,0.0,1156,29136,17340,-11796
7285,0.0,0.0,0.0,1156,29140,17340,-11800
7286,0.0,0.0,0.0,1156,29144,17340,-11804
7287,0.0,0.0,0.0,1156,29148,17340,-11808
7288,0.0,0.0,0.0,1156,29152,17340,-11812
7289,0.0,0.0,0.0,1156,29156,17340,-11816
7290,1.0,1.0,1.0,1157,29160,17355,-11805
7291,0.0,0.0,0.0,1157,29164,17355,-11809
7292,0.0,0.0,0.0,1157,29168,17355,-11813
7293,0.0,0.0,0.0,1157,29172,17355,-11817
7294,1.0,0.0,0.5,1158,29176,17370,-11806
7295,0.0,0.0,0.0,1158,29180,17370,-11810
7296,0.0,0.0,0.0,1158,29184,17370,-11814
7297,0.0,0.0,0.0,1158,29188,17370,-11818
7298,1.0,1.0,0.6666666666666666,1159,29192,17385,-11807
7299,1.0,1.0,1.0,1160,29196,17400,-11796
7300,1.0,1.0,0.6,1161,29200,17415,-11785
7301,0.0,0.0,0.0,1161,29204,17415,-11789
7302,0.0,0.0,0.0,1161,29208,17415,-11793
7303,0.0,0.0,0.0,1161,29212,17415,-11797
7304,1.0,1.0,1.0,1162,29216,17430,-11786
7305,1.0,0.0,0.4,1163,29220,17445,-11775
7306,1.0,1.0,1.0,1164,29224,17460,-11764
7307,0.0,1.0,0.6666666666666666,1164,29228,17460,-11768
7308,0.0,0.0,0.0,1164,29232,17460,-11772
7309,0.0,0.0,0.0,1164,29236,17460,-11776
7310,1.0,1.0,1.0,1165,29240,17475,-11765
7311,0.0,0.0,0.0,1165,29244,17475,-11769
7312,0.0,0.0,0.0,1165,29248,17475,-11773
7313,1.0,1.0,1.0,1166,29252,17490,-11762
7314,0.0,0.0,0.0,1166,29256,17490,-11766
7315,0.0,0.0,0.0,1166,29260,17490,-11770
7316,1.0,1.0,0.75,1167,29264,17505,-11759
7317,1.0,1.0,1.0,1168,29268,17520,-11748
7318,0.0,0.0,0.3333333333333333,1168,29272,17520,-11752
7319,1.0,1.0,1.0,1169,29276,17535,-11741
7320,0.0,0.0,0.0,1169,29280,17535,-11745
7321,1.0,1.0,1.0,1170,29284,17550,-11734
7322,0.0,0.0,0.0,1170,29288,17550,-11738
7323,0.0,0.0,0.0,1170,29292,17550,-11742
7324,0.0,0.0,0.0,1170,29296,17550,-11746
7325,0.0,0.0,0.0,1170,29300,17550,-11750
7326,0.0,0.0,0.0,1170,29304,17550,-11754
7327,0.0,0.0,0.0,1170,29308,17550,-11758
7328,0.0,0.0,0.0,1170,29312,17550,-11762
7329,0.0,0.0,0.0,1170,29316,17550,-11766
7330,0.0,0.0,0.0,1170,29320,17550,-11770
7331,0.0,0.0,0.0,1170,29324,17550,-11774
7332,0.0,0.0,0.0,1170,29328,17550,-11778
7333,0.0,0.0,0.0,1170,29332,17550,-11782
7334,0.0,0.0,0.0,1170,29336,17550,-11786
7335,0.0,0.0,0.0,1170,29340,17550,-11790
7336,0.0,0.0,0.0,1170,29344,17550,-11794
7337,0.0,0.0,0.3333333333333333,1170,29348,17550,-11798
7338,0.0,0.0,0.0,1170,29352,17550,-11802
7339,0.0,0.0,0.0,1170,29356,17550,-11806
7340,0.0,0.0,0.0,1170,29360,17550,-11810
7341,0.0,0.0,0.0,1170,29364,17550,-11814
7342,0.0,0.0,0.0,1170,29368,17550,-11818
7343,0.0,0.0,0.0,1170,29372,17550,-11822
7344,0.0,0.0,0.0,1170,29376,17550,-11826
7345,0.0,0.0,0.0,1170,29380,17550,-11830
7346,0.0,0.0,0.0,1170,29384,17550,-11834
7347,1.0,1.0,1.0,1171,29388,17565,-11823
7348,0.0,1.0,0.75,1171,29392,17565,-11827
7349,0.0,0.0,0.0,1171,29396,17565,-11831
7350,0.0,0.0,0.0,1171,29400,17565,-11835
7351,0.0,0.0,0.0,1171,29404,17565,-11839
7352,0.0,0.0,0.0,1171,29408,17565,-11843
7353,0.0,0.0,0.0,1171,29412,17565,-11847
7354,1.0,1.0,1.0,1172,29416,17580,-11836
7355,1.0,1.0,0.6666666666666666,1173,29420,17595,-11825
7356,1.0,1.0,1.0,1174,29424,17610,-11814
7357,0.0,0.0,0.0,1174,29428,17610,-11818
7358,1.0,1.0,0.8,1175,29432,17625,-11807
7359,0.0,0.0,0.0,1175,29436,17625,-11811
7360,0.0,0.0,0.0,1175,29440,17625,-11815
7361,0.0,0.0,0.0,1175,29444,17625,-11819
7362,0.0,0.0,0.0,1175,29448,17625,-11823
7363,0.0,0.0,0.0,1175,29452,17625,-11827
7364,0.0,0.0,0.0,1175,29456,17625,-11831
7365,0.0,0.0,0.0,1175,29460,17625,-11835
7366,1.0,1.0,1.0,1176,29464,17640,-11824
7367,0.0,0.0,0.0,1176,29468,17640,-11828
7368,1.0,1.0,1.0,1177,29472,17655,-11817
7369,0.0,0.0,0.0,1177,29476,17655,-11821
7370,0.0,0.0,0.0,1177,29480,17655,-11825
7371,0.0,0.0,0.0,1177,29484,17655,-11829
7372,0.0,0.0,0.0,1177,29488,17655,-11833
7373,0.0,0.0,0.0,1177,29492,17655,-11837
7374,0.0,0.0,0.3333333333333333,1177,29496,17655,-11841
7375,0.0,0.0,0.0,1177,29500,17655,-11845
7376,0.0,0.0,0.0,1177,29504,17655,-11849
7377,0.0,0.0,0.0,1177,29508,17655,-11853
7378,0.0,0.0,0.0,1177,29512,17655,-11857
7379,0.0,0.0,0.0,1177,29516,17655,-11861
7380,0.0,0.0,0.0,1177,29520,17655,-11865
7381,0.0,0.0,0.0,1177,29524,17655,-11869
7382,0.0,0.0,0.0,1177,29528,17655,-11873
7383,0.0,0.0,0.0,1177,29532,17655,-11877
7384,1.0,1.0,1.0,1178,29536,17670,-11866
7385,1.0,1.0,1.0,1179,29540,17685,-11855
7386,1.0,1.0,1.0,1180,29544,17700,-11844
7387,1.0,1.0,0.6666666666666666,1181,29548,17715,-11833
7388,1.0,1.0,0.6666666666666666,1182,29552,17730,-11822
7389,0.0,0.0,0.0,1182,29556,17730,-11826
7390,1.0,0.0,0.25,1183,29560,17745,-11815
7391,0.0,0.0,0.0,1183,29564,17745,-11819
7392,0.0,0.0,0.0,1183,29568,17745,-11823
7393,0.0,0.0,0.0,1183,29572,17745,-11827
7394,0.0,1.0,0.6,1183,29576,17745,-11831
7395,0.0,0.0,0.0,1183,29580,17745,-11835
7396,0.0,0.0,0.0,1183,29584,17745,-11839
7397,0.0,0.0,0.0,1183,29588,17745,-11843
7398,1.0,1.0,1.0,1184,29592,17760,-11832
7399,0.0,0.0,0.5,1184,29596,17760,-11836
7400,0.0,0.0,0.0,1184,29600,17760,-11840
7401,0.0,0.0,0.0,1184,29604,17760,-11844
7402,0.0,0.0,0.0,1184,29608,17760,-11848
7403,0.0,0.0,0.0,1184,29612,17760,-11852
7404,0.0,0.0,0.0,1184,29616,17760,-11856
7405,0.0,0.0,0.0,1184,29620,17760,-11860
7406,1.0,1.0,1.0,1185,29624,17775,-11849
7407,0.0,0.0,0.0,1185,29628,17775,-11853
7408,0.0,0.0,0.0,1185,29632,17775,-11857
7409,0.0,0.0,0.0,1185,29636,17775,-11861
7410,0.0,0.0,0.0,1185,29640,17775,-11865
7411,1.0,1.0,0.6,1186,29644,17790,-11854
7412,0.0,0.0,0.0,1186,29648,17790,-11858
7413,0.0,0.0,0.4,1186,29652,17790,-11862
7414,0.0,0.0,0.0,1186,29656,17790,-11866
7415,0.0,0.0,0.0,1186,29660,17790,-11870
7416,1.0,1.0,1.0,1187,29664,17805,-11859
7417,0.0,0.0,0.0,1187,29668,17805,-11863
7418,0.0,0.0,0.0,1187,29672,17805,-11867
7419,1.0,1.0,0.75,1188,29676,17820,-11856
7420,0.0,0.0,0.0,1188,29680,17820,-11860
7421,0.0,0.0,0.0,1188,29684,17820,-11864
7422,0.0,0.0,0.0,1188,29688,17820,-11868
7423,0.0,0.0,0.0,1188,29692,17820,-11872
7424,0.0,0.0,0.0,1188,29696,17820,-11876
7425,1.0,0.0,0.25,1189,29700,17835,-11865
7426,0.0,0.0,0.0,1189,29704,17835,-11869
7427,1.0,1.0,0.6666666666666666,1190,29708,17850,-11858
7428,0.0,0.0,0.0,1190,29712,17850,-11862
7429,0.0,0.0,0.0,1190,29716,17850,-11866
7430,0.0,0.0,0.0,1190,29720,17850,-11870
7431,1.0,1.0,1.0,1191,29724,17865,-11859
7432,1.0,1.0,1.0,1192,29728,17880,-11848
7433,1.0,0.0,0.25,1193,29732,17895,-11837
7434,0.0,0.0,0.0,1193,29736,17895,-11841
7435,1.0,1.0,1.0,1194,29740,17910,-11830
7436,0.0,0.0,0.0,1194,29744,17910,-11834
7437,0.0,0.0,0.0,1194,29748,17910,-11838
7438,0.0,0.0,0.0,1194,29752,17910,-11842
7439,0.0,0.0,0.0,1194,29756,17910,-11846
7440,1.0,1.0,1.0,1195,29760,17925,-11835
7441,0.0,0.0,0.0,1195,29764,17925,-11839
7442,0.0,0.0,0.0,1195,29768,17925,-11843
7443,0.0,0.0,0.0,1195,29772,17925,-11847
7444,0.0,0.0,0.0,1195,29776,17925,-11851
7445,0.0,0.0,0.0,1195,29780,17925,-11855
7446,1.0,1.0,1.0,1196,29784,17940,-11844
7447,0.0,0.0,0.0,1196,29788,17940,-11848
7448,0.0,0.0,0.0,1196,29792,17940,-11852
7449,0.0,0.0,0.0,1196,29796,17940,-11856
7450,0.0,0.0,0.0,1196,29800,17940,-11860
7451,1.0,1.0,1.0,1197,29804,17955,-11849
7452,0.0,0.0,0.0,1197,29808,17955,-11853
7453,0.0,0.0,0.0,1197,29812,17955,-11857
7454,0.0,0.0,0.0,1197,29816,17955,-11861
7455,0.0,0.0,0.0,1197,29820,17955,-11865
7456,0.0,0.0,0.0,1197,29824,17955,-11869
7457,0.0,0.0,0.0,1197,29828,17955,-11873
7458,1.0,1.0,1.0,1198,29832,17970,-11862
7459,0.0,0.0,0.0,1198,29836,17970,-11866
7460,1.0,1.0,1.0,1199,29840,17985,-11855
7461,1.0,1.0,0.6666666666666666,1200,29844,18000,-11844
7462,0.0,0.0,0.0,1200,29848,18000,-11848
7463,0.0,0.0,0.0,1200,29852,18000,-11852
7464,0.0,0.0,0.0,1200,29856,18000,-11856
7465,0.0,0.0,0.0,1200,29860,18000,-11860
7466,0.0,0.0,0.0,1200,29864,18000,-11864
7467,0.0,0.0,0.0,1200,29868,18000,-11868
7468,0.0,0.0,0.0,1200,29872,18000,-11872
7469,0.0,0.0,0.0,1200,29876,18000,-11876
7470,0.0,0.0,0.0,1200,29880,18000,-11880
7471,0.0,0.0,0.0,1200,29884,18000,-11884
7472,1.0,1.0,1.0,1201,29888,18015,-11873
7473,0.0,0.0,0.0,1201,29892,18015,-11877
7474,0.0,0.0,0.0,1201,29896,18015,-11881
7475,1.0,1.0,0.6666666666666666,1202,29900,18030,-11870
7476,0.0,0.0,0.0,1202,29904,18030,-11874
7477,0.0,0.0,0.0,1202,29908,18030,-11878
7478,0.0,0.0,0.0,1202,29912,18030,-11882
7479,0.0,0.0,0.4,1202,29916,18030,-11886
7480,0.0,0.0,0.0,1202,29920,18030,-11890
7481,0.0,0.0,0.0,1202,29924,18030,-11894
7482,0.0,0.0,0.0,1202,29928,18030,-11898
7483,0.0,0.0,0.0,1202,29932,18030,-11902
7484,1.0,1.0,1.0,1203,29936,18045,-11891
7485,1.0,1.0,1.0,1204,29940,18060,-11880
7486,0.0,0.0,0.0,1204,29944,18060,-11884
7487,1.0,1.0,1.0,1205,29948,18075,-11873
7488,0.0,0.0,0.0,1205,29952,18075,-11877
7489,0.0,0.0,0.0,1205,29956,18075,-11881
7490,1.0,1.0,1.0,1206,29960,18090,-11870
7491,0.0,0.0,0.0,1206,29964,18090,-11874
7492,0.0,0.0,0.0,1206,29968,18090,-11878
7493,1.0,1.0,1.0,1207,29972,18105,-11867
7494,1.0,1.0,0.75,1208,29976,18120,-11856
7495,0.0,0.0,0.3333333333333333,1208,29980,18120,-11860
7496,0.0,0.0,0.0,1208,29984,18120,-11864
7497,0.0,0.0,0.0,1208,29988,18120,-11868
7498,0.0,0.0,0.0,1208,29992,18120,-11872
7499,0.0,0.0,0.0,1208,29996,18120,-11876
7500,0.0,0.0,0.0,1208,30000,18120,-11880
7501,0.0,0.0,0.0,1208,30004,18120,-11884
7502,1.0,1.0,1.0,1209,30008,18135,-11873
7503,0.0,0.0,0.0,1209,30012,18135,-11877
7504,0.0,0.0,0.0,1209,30016,18135,-11881
7505,0.0,0.0,0.0,1209,30020,18135,-11885
7506,0.0,0.0,0.0,1209,30024,18135,-11889
7507,0.0,0.0,0.0,1209,30028,18135,-11893
7508,0.0,0.0,0.0,1209,30032,18135,-11897
7509,0.0,0.0,0.0,1209,30036,18135,-11901
7510,1.0,1.0,0.6,1210,30040,18150,-11890
7511,1.0,0.0,0.5,1211,30044,18165,-11879
7512,0.0,0.0,0.0,1211,30048,18165,-11883
7513,0.0,0.0,0.0,1211,30052,18165,-11887
7514,1.0,1.0,0.6,1212,30056,18180,-11876
7515,0.0,0.0,0.0,1212,30060,18180,-11880
7516,0.0,0.0,0.0,1212,30064,18180,-11884
7517,0.0,0.0,0.0,1212,30068,18180,-11888
7518,0.0,0.0,0.0,1212,30072,18180,-11892
7519,0.0,1.0,0.6666666666666666,1212,30076,18180,-11896
7520,0.0,0.0,0.0,1212,30080,18180,-11900
7521,0.0,0.0,0.0,1212,30084,18180,-11904
7522,0.0,0.0,0.0,1212,30088,18180,-11908
7523,1.0,1.0,1.0,1213,30092,18195,-11897
7524,1.0,1.0,1.0,1214,30096,18210,-11886
7525,0.0,0.0,0.0,1214,30100,18210,-11890
7526,0.0,0.0,0.0,1214,30104,18210,-11894
7527,0.0,0.0,0.0,1214,30108,18210,-11898
7528,0.0,0.0,0.0,1214,30112,18210,-11902
7529,0.0,0.0,0.0,1214,30116,18210,-11906
7530,0.0,0.0,0.0,1214,30120,18210,-11910
7531,1.0,1.0,1.0,1215,30124,18225,-11899
7532,0.0,0.0,0.0,1215,30128,18225,-11903
7533,1.0,1.0,0.75,1216,30132,18240,-11892
7534,0.0,0.0,0.0,1216,30136,18240,-11896
7535,0.0,0.0,0.0,1216,30140,18240,-11900
7536,0.0,0.0,0.0,1216,30144,18240,-11904
7537,0.0,1.0,0.6666666666666666,1216,30148,18240,-11908
7538,0.0,0.0,0.0,1216,30152,18240,-11912
7539,1.0,0.0,0.2,1217,30156,18255,-11901
7540,0.0,0.0,0.0,1217,30160,18255,-11905
7541,0.0,0.0,0.0,1217,30164,18255,-11909
7542,1.0,1.0,0.75,1218,30168,18270,-11898
7543,0.0,0.0,0.0,1218,30172,18270,-11902
7544,1.0,1.0,1.0,1219,30176,18285,-11891
7545,0.0,0.0,0.0,1219,30180,18285,-11895
7546,1.0,1.0,0.75,1220,30184,18300,-11884
7547,1.0,0.0,0.25,1221,30188,18315,-11873
7548,0.0,0.0,0.0,1221,30192,18315,-11877
7549,0.0,0.0,0.0,1221,30196,18315,-11881
7550,1.0,1.0,1.0,1222,30200,18330,-11870
7551,1.0,1.0,1.0,1223,30204,18345,-11859
7552,0.0,0.0,0.0,1223,30208,18345,-11863
7553,1.0,1.0,1.0,1224,30212,18360,-11852
7554,0.0,0.0,0.0,1224,30216,18360,-11856
7555,0.0,0.0,0.0,1224,30220,18360,-11860
7556,0.0,0.0,0.0,1224,30224,18360,-11864
7557,0.0,0.0,0.0,1224,30228,18360,-11868
7558,0.0,0.0,0.0,1224,30232,18360,-11872
7559,0.0,0.0,0.0,1224,30236,18360,-11876
7560,0.0,0.0,0.0,1224,30240,18360,-11880
7561,0.0,0.0,0.0,1224,30244,18360,-11884
7562,0.0,0.0,0.0,1224,30248,18360,-11888
7563,0.0,0.0,0.0,1224,30252,18360,-11892
7564,0.0,0.0,0.0,1224,30256,18360,-11896
7565,0.0,0.0,0.0,1224,30260,18360,-11900
7566,0.0,0.0,0.0,1224,30264,18360,-11904
7567,0.0,0.0,0.0,1224,30268,18360,-11908
7568,0.0,0.0,0.0,1224,30272,18360,-11912
7569,0.0,0.0,0.0,1224,30276,18360,-11916
7570,0.0,0.0,0.0,1224,30280,18360,-11920
7571,0.0,0.0,0.0,1224,30284,18360,-11924
7572,0.0,0.0,0.0,1224,30288,18360,-11928
7573,1.0,1.0,1.0,1225,30292,18375,-11917
7574,0.0,0.0,0.0,1225,30296,18375,-11921
7575,0.0,0.0,0.0,1225,30300,18375,-11925
7576,0.0,0.0,0.0,1225,30304,18375,-11929
7577,0.0,0.0,0.0,1225,30308,18375,-11933
7578,0.0,0.0,0.0,1225,30312,18375,-11937
7579,0.0,0.0,0.0,1225,30316,18375,-11941
7580,0.0,0.0,0.0,1225,30320,18375,-11945
7581,1.0,1.0,1.0,1226,30324,18390,-11934
7582,0.0,0.0,0.0,1226,30328,18390,-11938
7583,1.0,1.0,1.0,1227,30332,18405,-11927
7584,0.0,0.0,0.0,1227,30336,18405,-11931
7585,0.0,0.0,0.0,1227,30340,18405,-11935
7586,0.0,0.0,0.0,1227,30344,18405,-11939
7587,0.0,0.0,0.0,1227,30348,18405,-11943
7588,0.0,0.0,0.0,1227,30352,18405,-11947
7589,0.0,0.0,0.0,1227,30356,18405,-11951
7590,0.0,0.0,0.0,1227,30360,18405,-11955
7591,0.0,1.0,0.6,1227,30364,18405,-11959
7592,0.0,0.0,0.0,1227,30368,18405,-11963
7593,0.0,0.0,0.0,1227,30372,18405,-11967
7594,0.0,0.0,0.0,1227,30376,18405,-11971
7595,1.0,1.0,1.0,1228,30380,18420,-11960
7596,1.0,1.0,0.6666666666666666,1229,30384,18435,-11949
7597,0.0,0.0,0.0,1229,30388,18435,-11953
7598,1.0,1.0,1.0,1230,30392,18450,-11942
7599,0.0,0.0,0.0,1230,30396,18450,-11946
7600,0.0,0.0,0.0,1230,30400,18450,-11950
7601,0.0,0.0,0.0,1230,30404,18450,-11954
7602,1.0,1.0,1.0,1231,30408,18465,-11943
7603,0.0,1.0,0.75,1231,30412,18465,-11947
7604,0.0,0.0,0.0,1231,30416,18465,-11951
7605,0.0,0.0,0.0,1231,30420,18465,-11955
7606,0.0,0.0,0.0,1231,30424,18465,-11959
7607,0.0,0.0,0.0,1231,30428,18465,-11963
7608,0.0,0.0,0.0,1231,30432,18465,-11967
7609,0.0,0.0,0.0,1231,30436,18465,-11971
7610,0.0,0.0,0.0,1231,30440,18465,-11975
7611,0.0,0.0,0.0,1231,30444,18465,-11979
7612,0.0,0.0,0.0,1231,30448,18465,-11983
7613,0.0,0.0,0.0,1231,30452,18465,-11987
7614,0.0,0.0,0.0,1231,30456,18465,-11991
7615,0.0,0.0,0.0,1231,30460,18465,-11995
7616,0.0,0.0,0.0,1231,30464,18465,-11999
7617,0.0,0.0,0.0,1231,30468,18465,-12003
7618,0.0,0.0,0.0,1231,30472,18465,-12007
7619,0.0,0.0,0.0,1231,30476,18465,-12011
7620,0.0,0.0,0.0,1231,30480,18465,-12015
7621,0.0,0.0,0.0,1231,30484,18465,-12019
7622,0.0,0.0,0.0,1231,30488,18465,-12023
7623,1.0,1.0,1.0,1232,30492,18480,-12012
7624,0.0,0.0,0.0,1232,30496,18480,-12016
7625,0.0,0.0,0.0,1232,30500,18480,-12020
7626,0.0,0.0,0.0,1232,30504,18480,-12024
7627,0.0,0.0,0.0,1232,30508,18480,-12028
7628,1.0,1.0,0.6666666666666666,1233,30512,18495,-12017
7629,1.0,1.0,1.0,1234,30516,18510,-12006
7630,0.0,0.0,0.0,1234,30520,18510,-12010
7631,0.0,0.0,0.0,1234,30524,18510,-12014
7632,1.0,1.0,0.6666666666666666,1235,30528,18525,-12003
7633,0.0,0.0,0.0,1235,30532,18525,-12007
7634,0.0,0.0,0.0,1235,30536,18525,-12011
7635,0.0,0.0,0.0,1235,30540,18525,-12015
7636,0.0,0.0,0.0,1235,30544,18525,-12019
7637,0.0,0.0,0.0,1235,30548,18525,-12023
7638,1.0,1.0,1.0,1236,30552,18540,-12012
7639,0.0,0.0,0.0,1236,30556,18540,-12016
7640,0.0,0.0,0.0,1236,30560,18540,-12020
7641,1.0,1.0,1.0,1237,30564,18555,-12009
7642,1.0,1.0,1.0,1238,30568,18570,-11998
7643,0.0,0.0,0.0,1238,30572,18570,-12002
7644,0.0,0.0,0.0,1238,30576,18570,-12006
7645,0.0,0.0,0.0,1238,30580,18570,-12010
7646,0.0,0.0,0.0,1238,30584,18570,-12014
7647,1.0,0.0,0.5,1239,30588,18585,-12003
7648,0.0,0.0,0.0,1239,30592,18585,-12007
7649,1.0,1.0,1.0,1240,30596,18600,-11996
7650,0.0,0.0,0.0,1240,30600,18600,-12000
7651,0.0,0.0,0.0,1240,30604,18600,-12004
7652,1.0,1.0,1.0,1241,30608,18615,-11993
7653,0.0,0.0,0.0,1241,30612,18615,-11997
7654,1.0,1.0,0.6666666666666666,1242,30616,18630,-11986
7655,0.0,0.0,0.0,1242,30620,18630,-11990
7656,0.0,0.0,0.0,1242,30624,18630,-11994
7657,0.0,0.0,0.0,1242,30628,18630,-11998
7658,0.0,0.0,0.0,1242,30632,18630,-12002
7659,0.0,0.0,0.0,1242,30636,18630,-12006
7660,0.0,0.0,0.0,1242,30640,18630,-12010
7661,0.0,0.0,0.0,1242,30644,18630,-12014
7662,0.0,0.0,0.0,1242,30648,18630,-12018
7663,1.0,0.0,0.2,1243,30652,18645,-12007
7664,0.0,0.0,0.0,1243,30656,18645,-12011
7665,0.0,0.0,0.0,1243,30660,18645,-12015
7666,1.0,1.0,0.6666666666666666,1244,30664,18660,-12004
7667,0.0,0.0,0.0,1244,30668,18660,-12008
7668,0.0,0.0,0.0,1244,30672,18660,-12012
7669,0.0,0.0,0.0,1244,30676,18660,-12016
7670,0.0,0.0,0.0,1244,30680,18660,-12020
7671,0.0,1.0,0.6,1244,30684,18660,-12024
7672,0.0,0.0,0.0,1244,30688,18660,-12028
7673,0.0,0.0,0.3333333333333333,1244,30692,18660,-12032
7674,0.0,0.0,0.0,1244,30696,18660,-12036
7675,0.0,0.0,0.0,1244,30700,18660,-12040
7676,0.0,0.0,0.0,1244,30704,18660,-12044
7677,0.0,0.0,0.0,1244,30708,18660,-12048
7678,0.0,0.0,0.0,1244,30712,18660,-12052
7679,0.0,0.0,0.0,1244,30716,18660,-12056
7680,0.0,0.0,0.0,1244,30720,18660,-12060
7681,1.0,1.0,1.0,1245,30724,18675,-12049
7682,0.0,0.0,0.0,1245,30728,18675,-12053
7683,0.0,0.0,0.0,1245,30732,18675,-12057
7684,0.0,0.0,0.0,1245,30736,18675,-12061
7685,0.0,0.0,0.0,1245,30740,18675,-12065
7686,1.0,1.0,1.0,1246,30744,18690,-12054
7687,1.0,1.0,1.0,1247,30748,18705,-12043
7688,0.0,0.0,0.0,1247,30752,18705,-12047
7689,0.0,0.0,0.0,1247,30756,18705,-12051
7690,0.0,0.0,0.0,1247,30760,18705,-12055
7691,0.0,0.0,0.0,1247,30764,18705,-12059
7692,1.0,1.0,1.0,1248,30768,18720,-12048
7693,0.0,0.0,0.0,1248,30772,18720,-12052
7694,0.0,0.0,0.25,1248,30776,18720,-12056
7695,0.0,0.0,0.0,1248,30780,18720,-12060
7696,0.0,0.0,0.0,1248,30784,18720,-12064
7697,0.0,1.0,0.6,1248,30788,18720,-12068
7698,1.0,1.0,1.0,1249,30792,18735,-12057
7699,0.0,0.0,0.0,1249,30796,18735,-12061
7700,0.0,0.0,0.0,1249,30800,18735,-12065
7701,0.0,0.0,0.0,1249,30804,18735,-12069
7702,0.0,0.0,0.0,1249,30808,18735,-12073
7703,0.0,0.0,0.0,1249,30812,18735,-12077
7704,0.0,0.0,0.0,1249,30816,18735,-12081
7705,0.0,0.0,0.0,1249,30820,18735,-12085
7706,0.0,0.0,0.0,1249,30824,18735,-12089
7707,0.0,0.0,0.0,1249,30828,18735,-12093
7708,0.0,0.0,0.0,1249,30832,18735,-12097
7709,1.0,1.0,1.0,1250,30836,18750,-12086
7710,0.0,0.0,0.0,1250,30840,18750,-12090
7711,0.0,0.0,0.0,1250,30844,18750,-12094
7712,0.0,0.0,0.0,1250,30848,18750,-12098
7713,0.0,0.0,0.0,1250,30852,18750,-12102
7714,0.0,0.0,0.0,1250,30856,18750,-12106
7715,0.0,0.0,0.0,1250,30860,18750,-12110
7716,0.0,0.0,0.0,1250,30864,18750,-12114
7717,1.0,1.0,1.0,1251,30868,18765,-12103
7718,0.0,0.0,0.0,1251,30872,18765,-12107
7719,0.0,0.0,0.0,1251,30876,18765,-12111
7720,0.0,0.0,0.0,1251,30880,18765,-12115
7721,0.0,0.0,0.0,1251,30884,18765,-12119
7722,0.0,0.0,0.0,1251,30888,18765,-12123
7723,0.0,0.0,0.0,1251,30892,18765,-12127
7724,0.0,0.0,0.0,1251,30896,18765,-12131
7725,0.0,0.0,0.0,1251,30900,18765,-12135
7726,1.0,1.0,0.6666666666666666,1252,30904,18780,-12124
7727,0.0,0.0,0.0,1252,30908,18780,-12128
7728,0.0,0.0,0.0,1252,30912,18780,-12132
7729,0.0,0.0,0.0,1252,30916,18780,-12136
7730,0.0,0.0,0.0,1252,30920,18780,-12140
7731,0.0,0.0,0.0,1252,30924,18780,-12144
7732,1.0,1.0,1.0,1253,30928,18795,-12133
7733,1.0,0.0,0.25,1254,30932,18810,-12122
7734,0.0,0.0,0.0,1254,30936,18810,-12126
7735,0.0,0.0,0.0,1254,30940,18810,-12130
7736,0.0,0.0,0.0,1254,30944,18810,-12134
7737,0.0,0.0,0.0,1254,30948,18810,-12138
7738,0.0,0.0,0.0,1254,30952,18810,-12142
7739,0.0,0.0,0.0,1254,30956,18810,-12146
7740,1.0,1.0,1.0,1255,30960,18825,-12135
7741,0.0,0.0,0.0,1255,30964,18825,-12139
7742,1.0,1.0,1.0,1256,30968,18840,-12128
7743,0.0,0.0,0.0,1256,30972,18840,-12132
7744,0.0,0.0,0.0,1256,30976,18840,-12136
7745,0.0,0.0,0.0,1256,30980,18840,-12140
7746,0.0,0.0,0.4,1256,30984,18840,-12144
7747,0.0,0.0,0.0,1256,30988,18840,-12148
7748,0.0,0.0,0.4,1256,30992,18840,-12152
7749,0.0,0.0,0.4,1256,30996,18840,-12156
7750,1.0,1.0,1.0,1257,31000,18855,-12145
7751,0.0,0.0,0.0,1257,31004,18855,-12149
7752,0.0,0.0,0.0,1257,31008,18855,-12153
7753,1.0,0.0,0.4,1258,31012,18870,-12142
7754,0.0,0.0,0.0,1258,31016,18870,-12146
7755,0.0,0.0,0.0,1258,31020,18870,-12150
7756,0.0,0.0,0.0,1258,31024,18870,-12154
7757,1.0,1.0,1.0,1259,31028,18885,-12143
7758,0.0,0.0,0.0,1259,31032,18885,-12147
7759,0.0,0.0,0.0,1259,31036,18885,-12151
7760,0.0,0.0,0.0,1259,31040,18885,-12155
7761,0.0,0.0,0.0,1259,31044,18885,-12159
7762,0.0,0.0,0.0,1259,31048,18885,-12163
7763,0.0,0.0,0.0,1259,31052,18885,-12167
7764,0.0,0.0,0.0,1259,31056,18885,-12171
7765,0.0,0.0,0.0,1259,31060,18885,-12175
7766,0.0,0.0,0.0,1259,31064,18885,-12179
7767,0.0,0.0,0.0,1259,31068,18885,-12183
7768,0.0,0.0,0.0,1259,31072,18885,-12187
7769,0.0,0.0,0.0,1259,31076,18885,-12191
7770,0.0,0.0,0.0,1259,31080,18885,-12195
7771,0.0,0.0,0.0,1259,31084,18885,-12199
7772,0.0,0.0,0.0,1259,31088,18885,-12203
7773,0.0,0.0,0.0,1259,31092,18885,-12207
7774,0.0,0.0,0.0,1259,31096,18885,-12211
7775,0.0,0.0,0.0,1259,31100,18885,-12215
7776,0.0,0.0,0.0,1259,31104,18885,-12219
7777,0.0,0.0,0.0,1259,31108,18885,-12223
7778,0.0,0.0,0.0,1259,31112,18885,-12227
7779,0.0,0.0,0.0,1259,31116,18885,-12231
7780,1.0,1.0,1.0,1260,31120,18900,-12220
7781,0.0,0.0,0.0,1260,31124,18900,-12224
7782,0.0,0.0,0.0,1260,31128,18900,-12228
7783,0.0,0.0,0.0,1260,31132,18900,-12232
7784,0.0,0.0,0.0,1260,31136,18900,-12236
7785,0.0,0.0,0.0,1260,31140,18900,-12240
7786,0.0,0.0,0.0,1260,31144,18900,-12244
7787,0.0,0.0,0.0,1260,31148,18900,-12248
7788,0.0,0.0,0.0,1260,31152,18900,-12252
7789,0.0,0.0,0.0,1260,31156,18900,-12256
7790,0.0,0.0,0.0,1260,31160,18900,-12260
7791,0.0,0.0,0.0,1260,31164,18900,-12264
7792,0.0,0.0,0.0,1260,31168,18900,-12268
7793,0.0,0.0,0.0,1260,31172,18900,-12272
7794,0.0,0.0,0.0,1260,31176,18900,-12276
7795,0.0,0.0,0.0,1260,31180,18900,-12280
7796,1.0,1.0,0.6,1261,31184,18915,-12269
7797,0.0,0.0,0.0,1261,31188,18915,-12273
7798,0.0,0.0,0.0,1261,31192,18915,-12277
7799,0.0,0.0,0.0,1261,31196,18915,-12281
7800,0.0,0.0,0.0,1261,31200,18915,-12285
7801,0.0,0.0,0.0,1261,31204,18915,-12289
7802,0.0,0.0,0.0,1261,31208,18915,-12293
7803,1.0,1.0,1.0,1262,31212,18930,-12282
7804,0.0,0.0,0.0,1262,31216,18930,-12286
7805,1.0,1.0,1.0,1263,31220,18945,-12275
7806,0.0,0.0,0.0,1263,31224,18945,-12279
7807,0.0,0.0,0.0,1263,31228,18945,-12283
7808,0.0,0.0,0.0,1263,31232,18945,-12287
7809,1.0,1.0,1.0,1264,31236,18960,-12276
7810,0.0,0.0,0.0,1264,31240,18960,-12280
7811,1.0,1.0,1.0,1265,31244,18975,-12269
7812,0.0,0.0,0.0,1265,31248,18975,-12273
7813,0.0,0.0,0.0,1265,31252,18975,-12277
7814,0.0,0.0,0.0,1265,31256,18975,-12281
7815,0.0,0.0,0.0,1265,31260,18975,-12285
7816,1.0,1.0,1.0,1266,31264,18990,-12274
7817,0.0,1.0,0.6666666666666666,1266,31268,18990,-12278
7818,0.0,0.0,0.0,1266,31272,18990,-12282
7819,0.0,0.0,0.0,1266,31276,18990,-12286
7820,0.0,0.0,0.0,1266,31280,18990,-12290
7821,1.0,1.0,1.0,1267,31284,19005,-12279
7822,0.0,0.0,0.0,1267,31288,19005,-12283
7823,0.0,0.0,0.0,1267,31292,19005,-12287
7824,0.0,0.0,0.0,1267,31296,19005,-12291
7825,0.0,0.0,0.0,1267,31300,19005,-12295
7826,0.0,0.0,0.0,1267,31304,19005,-12299
7827,0.0,0.0,0.0,1267,31308,19005,-12303
7828,1.0,1.0,1.0,1268,31312,19020,-12292
7829,1.0,1.0,1.0,1269,31316,19035,-12281
7830,0.0,0.0,0.0,1269,31320,19035,-12285
7831,1.0,1.0,1.0,1270,31324,19050,-12274
7832,0.0,0.0,0.0,1270,31328,19050,-12278
7833,0.0,0.0,0.0,1270,31332,19050,-12282
7834,0.0,0.0,0.0,1270,31336,19050,-12286
7835,0.0,0.0,0.5,1270,31340,19050,-12290
7836,0.0,0.0,0.0,1270,31344,19050,-12294
7837,0.0,0.0,0.0,1270,31348,19050,-12298
7838,1.0,1.0,1.0,1271,31352,19065,-12287
7839,1.0,1.0,1.0,1272,31356,19080,-12276
7840,0.0,0.0,0.0,1272,31360,19080,-12280
7841,0.0,0.0,0.0,1272,31364,19080,-12284
7842,0.0,0.0,0.0,1272,31368,19080,-12288
7843,1.0,0.0,0.25,1273,31372,19095,-12277
7844,1.0,1.0,1.0,1274,31376,19110,-12266
7845,0.0,0.0,0.0,1274,31380,19110,-12270
7846,1.0,1.0,1.0,1275,31384,19125,-12259
7847,0.0,0.0,0.0,1275,31388,19125,-12263
7848,0.0,0.0,0.0,1275,31392,19125,-12267
7849,0.0,0.0,0.0,1275,31396,19125,-12271
7850,0.0,0.0,0.0,1275,31400,19125,-12275
7851,0.0,0.0,0.0,1275,31404,19125,-12279
7852,0.0,0.0,0.0,1275,31408,19125,-12283
7853,1.0,1.0,1.0,1276,31412,19140,-12272
7854,0.0,0.0,0.0,1276,31416,19140,-12276
7855,0.0,1.0,0.6666666666666666,1276,31420,19140,-12280
7856,0.0,0.0,0.0,1276,31424,19140,-12284
7857,0.0,0.0,0.0,1276,31428,19140,-12288
7858,0.0,0.0,0.0,1276,31432,19140,-12292
7859,1.0,1.0,1.0,1277,31436,19155,-12281
7860,0.0,0.0,0.0,1277,31440,19155,-12285
7861,0.0,0.0,0.0,1277,31444,19155,-12289
7862,0.0,0.0,0.0,1277,31448,19155,-12293
7863,1.0,0.0,0.2,1278,31452,19170,-12282
7864,0.0,0.0,0.0,1278,31456,19170,-12286
7865,1.0,1.0,1.0,1279,31460,19185,-12275
7866,0.0,0.0,0.0,1279,31464,19185,-12279
7867,0.0,0.0,0.0,1279,31468,19185,-12283
7868,0.0,0.0,0.0,1279,31472,19185,-12287
7869,0.0,0.0,0.0,1279,31476,19185,-12291
7870,1.0,1.0,1.0,1280,31480,19200,-12280
7871,1.0,1.0,0.6666666666666666,1281,31484,19215,-12269
7872,0.0,0.0,0.0,1281,31488,19215,-12273
7873,0.0,0.0,0.0,1281,31492,19215,-12277
7874,0.0,0.0,0.0,1281,31496,19215,-12281
7875,0.0,0.0,0.0,1281,31500,19215,-12285
7876,0.0,0.0,0.0,1281,31504,19215,-12289
7877,0.0,0.0,0.0,1281,31508,19215,-12293
7878,0.0,0.0,0.0,1281,31512,19215,-12297
7879,0.0,1.0,0.6,1281,31516,19215,-12301
7880,0.0,0.0,0.0,1281,31520,19215,-12305
7881,0.0,0.0,0.0,1281,31524,19215,-12309
7882,1.0,1.0,0.6666666666666666,1282,31528,19230,-12298
7883,0.0,0.0,0.0,1282,31532,19230,-12302
7884,0.0,0.0,0.0,1282,31536,19230,-12306
7885,1.0,1.0,1.0,1283,31540,19245,-12295
7886,0.0,0.0,0.0,1283,31544,19245,-12299
7887,0.0,0.0,0.0,1283,31548,19245,-12303
7888,0.0,0.0,0.0,1283,31552,19245,-12307
7889,0.0,0.0,0.0,1283,31556,19245,-12311
7890,0.0,0.0,0.0,1283,31560,19245,-12315
7891,0.0,0.0,0.5,1283,31564,19245,-12319
7892,0.0,0.0,0.0,1283,31568,19245,-12323
7893,0.0,0.0,0.0,1283,31572,19245,-12327
7894,0.0,0.0,0.0,1283,31576,19245,-12331
7895,0.0,0.0,0.0,1283,31580,19245,-12335
7896,1.0,1.0,1.0,1284,31584,19260,-12324
7897,0.0,0.0,0.0,1284,31588,19260,-12328
7898,0.0,0.0,0.0,1284,31592,19260,-12332
7899,1.0,1.0,1.0,1285,31596,19275,-12321
7900,1.0,1.0,1.0,1286,31600,19290,-12310
7901,0.0,0.0,0.0,1286,31604,19290,-12314
7902,0.0,0.0,0.0,1286,31608,19290,-12318
7903,0.0,0.0,0.0,1286,31612,19290,-12322
7904,0.0,0.0,0.0,1286,31616,19290,-12326
7905,0.0,0.0,0.3333333333333333,1286,31620,19290,-12330
7906,0.0,0.0,0.0,1286,31624,19290,-12334
7907,1.0,0.0,0.25,1287,31628,19305,-12323
7908,0.0,0.0,0.4,1287,31632,19305,-12327
7909,0.0,0.0,0.0,1287,31636,19305,-12331
7910,0.0,0.0,0.0,1287,31640,19305,-12335
7911,0.0,0.0,0.0,1287,31644,19305,-12339
7912,0.0,0.0,0.0,1287,31648,19305,-12343
7913,0.0,0.0,0.0,1287,31652,19305,-12347
7914,0.0,0.0,0.0,1287,31656,19305,-12351
7915,1.0,1.0,1.0,1288,31660,19320,-12340
7916,0.0,0.0,0.0,1288,31664,19320,-12344
7917,0.0,0.0,0.0,1288,31668,19320,-12348
7918,0.0,0.0,0.0,1288,31672,19320,-12352
7919,0.0,0.0,0.0,1288,31676,19320,-12356
7920,0.0,0.0,0.0,1288,31680,19320,-12360
7921,0.0,0.0,0.0,1288,31684,19320,-12364
7922,0.0,0.0,0.0,1288,31688,19320,-12368
7923,0.0,0.0,0.0,1288,31692,19320,-12372
7924,0.0,0.0,0.0,1288,31696,19320,-12376
7925,0.0,0.0,0.0,1288,31700,19320,-12380
7926,0.0,0.0,0.0,1288,31704,19320,-12384
7927,1.0,1.0,1.0,1289,31708,19335,-12373
7928,0.0,0.0,0.0,1289,31712,19335,-12377
7929,1.0,1.0,1.0,1290,31716,19350,-12366
7930,0.0,0.0,0.0,1290,31720,19350,-12370
7931,0.0,0.0,0.0,1290,31724,19350,-12374
7932,1.0,1.0,1.0,1291,31728,19365,-12363
7933,0.0,0.0,0.0,1291,31732,19365,-12367
7934,0.0,1.0,0.6,1291,31736,19365,-12371
7935,0.0,0.0,0.0,1291,31740,19365,-12375
7936,0.0,0.0,0.0,1291,31744,19365,-12379
7937,1.0,1.0,1.0,1292,31748,19380,-12368
7938,0.0,0.0,0.0,1292,31752,19380,-12372
7939,0.0,0.0,0.0,1292,31756,19380,-12376
7940,0.0,0.0,0.0,1292,31760,19380,-12380
7941,0.0,0.0,0.0,1292,31764,19380,-12384
7942,0.0,0.0,0.0,1292,31768,19380,-12388
7943,0.0,0.0,0.0,1292,31772,19380,-12392
7944,0.0,0.0,0.0,1292,31776,19380,-12396
7945,0.0,0.0,0.0,1292,31780,19380,-12400
7946,1.0,1.0,1.0,1293,31784,19395,-12389
7947,0.0,0.0,0.0,1293,31788,19395,-12393
7948,0.0,0.0,0.0,1293,31792,19395,-12397
7949,0.0,0.0,0.0,1293,31796,19395,-12401
7950,0.0,0.0,0.0,1293,31800,19395,-12405
7951,0.0,0.0,0.0,1293,31804,19395,-12409
7952,1.0,1.0,1.0,1294,31808,19410,-12398
7953,0.0,0.0,0.0,1294,31812,19410,-12402
7954,0.0,0.0,0.0,1294,31816,19410,-12406
7955,0.0,0.0,0.0,1294,31820,19410,-12410
7956,0.0,0.0,0.0,1294,31824,19410,-12414
7957,0.0,0.0,0.0,1294,31828,19410,-12418
7958,0.0,0.0,0.0,1294,31832,19410,-12422
7959,0.0,0.0,0.0,1294,31836,19410,-12426
7960,0.0,0.0,0.0,1294,31840,19410,-12430
7961,0.0,0.0,0.0,1294,31844,19410,-12434
7962,0.0,0.0,0.0,1294,31848,19410,-12438
7963,0.0,0.0,0.0,1294,31852,19410,-12442
7964,0.0,0.0,0.0,1294,31856,19410,-12446
7965,0.0,0.0,0.0,1294,31860,19410,-12450
7966,1.0,1.0,0.6666666666666666,1295,31864,19425,-12439
7967,0.0,0.0,0.0,1295,31868,19425,-12443
7968,0.0,0.0,0.0,1295,31872,19425,-12447
7969,0.0,0.0,0.0,1295,31876,19425,-12451
7970,0.0,0.0,0.0,1295,31880,19425,-12455
7971,0.0,1.0,0.6,1295,31884,19425,-12459
7972,0.0,0.0,0.0,1295,31888,19425,-12463
7973,0.0,0.0,0.0,1295,31892,19425,-12467
7974,0.0,0.0,0.0,1295,31896,19425,-12471
7975,1.0,1.0,1.0,1296,31900,19440,-12460
7976,0.0,0.0,0.0,1296,31904,19440,-12464
7977,0.0,0.0,0.0,1296,31908,19440,-12468
7978,0.0,0.0,0.0,1296,31912,19440,-12472
7979,0.0,0.0,0.0,1296,31916,19440,-12476
7980,0.0,0.0,0.0,1296,31920,19440,-12480
7981,0.0,0.0,0.0,1296,31924,19440,-12484
7982,1.0,1.0,1.0,1297,31928,19455,-12473
7983,0.0,0.0,0.0,1297,31932,19455,-12477
7984,0.0,0.0,0.0,1297,31936,19455,-12481
7985,0.0,0.0,0.0,1297,31940,19455,-12485
7986,0.0,0.0,0.0,1297,31944,19455,-12489
7987,0.0,0.0,0.0,1297,31948,19455,-12493
7988,0.0,0.0,0.0,1297,31952,19455,-12497
7989,1.0,1.0,1.0,1298,31956,19470,-12486
7990,0.0,0.0,0.0,1298,31960,19470,-12490
7991,1.0,0.0,0.3333333333333333,1299,31964,19485,-12479
7992,0.0,0.0,0.0,1299,31968,19485,-12483
7993,0.0,0.0,0.0,1299,31972,19485,-12487
7994,0.0,0.0,0.0,1299,31976,19485,-12491
7995,0.0,0.0,0.0,1299,31980,19485,-12495
7996,0.0,0.0,0.0,1299,31984,19485,-12499
7997,0.0,0.0,0.0,1299,31988,19485,-12503
7998,0.0,0.0,0.0,1299,31992,19485,-12507
7999,0.0,0.0,0.0,1299,31996,19485,-12511
8000,0.0,0.0,0.0,1299,32000,19485,-12515
8001,0.0,0.0,0.0,1299,32004,19485,-12519
8002,1.0,1.0,1.0,1300,32008,19500,-12508
8003,0.0,0.0,0.0,1300,32012,19500,-12512
8004,0.0,0.0,0.0,1300,32016,19500,-12516
8005,0.0,0.0,0.0,1300,32020,19500,-12520
8006,0.0,0.0,0.0,1300,32024,19500,-12524
8007,0.0,0.0,0.0,1300,32028,19500,-12528
8008,0.0,0.0,0.0,1300,32032,19500,-12532
8009,0.0,0.0,0.0,1300,32036,19500,-12536
8010,1.0,1.0,0.6666666666666666,1301,32040,19515,-12525
8011,0.0,0.0,0.0,1301,32044,19515,-12529
8012,0.0,0.0,0.0,1301,32048,19515,-12533
8013,0.0,0.0,0.0,1301,32052,19515,-12537
8014,1.0,1.0,1.0,1302,32056,19530,-12526
8015,0.0,0.0,0.0,1302,32060,19530,-12530
8016,0.0,0.0,0.0,1302,32064,19530,-12534
8017,0.0,0.0,0.0,1302,32068,19530,-12538
8018,0.0,0.0,0.0,1302,32072,19530,-12542
8019,1.0,1.0,1.0,1303,32076,19545,-12531
8020,0.0,0.0,0.2,1303,32080,19545,-12535
8021,0.0,0.0,0.0,1303,32084,19545,-12539
8022,0.0,0.0,0.0,1303,32088,19545,-12543
8023,0.0,0.0,0.25,1303,32092,19545,-12547
8024,0.0,0.0,0.0,1303,32096,19545,-12551
8025,0.0,0.0,0.0,1303,32100,19545,-12555
8026,0.0,0.0,0.0,1303,32104,19545,-12559
8027,0.0,0.0,0.0,1303,32108,19545,-12563
8028,0.0,0.0,0.0,1303,32112,19545,-12567
8029,0.0,0.0,0.0,1303,32116,19545,-12571
8030,0.0,0.0,0.0,1303,32120,19545,-12575
8031,0.0,0.0,0.0,1303,32124,19545,-12579
8032,0.0,0.0,0.0,1303,32128,19545,-12583
8033,0.0,0.0,0.0,1303,32132,19545,-12587
8034,0.0,0.0,0.0,1303,32136,19545,-12591
8035,0.0,0.0,0.0,1303,32140,19545,-12595
8036,0.0,0.0,0.0,1303,32144,19545,-12599
8037,0.0,0.0,0.0,1303,32148,19545,-12603
8038,1.0,1.0,0.6666666666666666,1304,32152,19560,-12592
8039,0.0,0.0,0.0,1304,32156,19560,-12596
8040,0.0,0.0,0.0,1304,32160,19560,-12600
8041,0.0,0.0,0.0,1304,32164,19560,-12604
8042,0.0,0.0,0.0,1304,32168,19560,-12608
8043,0.0,0.0,0.0,1304,32172,19560,-12612
8044,1.0,0.0,0.3333333333333333,1305,32176,19575,-12601
8045,1.0,1.0,1.0,1306,32180,19590,-12590
8046,0.0,0.0,0.0,1306,32184,19590,-12594
8047,0.0,0.0,0.0,1306,32188,19590,-12598
8048,0.0,0.0,0.0,1306,32192,19590,-12602
8049,1.0,1.0,1.0,1307,32196,19605,-12591
8050,0.0,0.0,0.2,1307,32200,19605,-12595
8051,1.0,1.0,0.6666666666666666,1308,32204,19620,-12584
8052,0.0,0.0,0.0,1308,32208,19620,-12588
8053,0.0,1.0,0.6666666666666666,1308,32212,19620,-12592
8054,1.0,1.0,1.0,1309,32216,19635,-12581
8055,1.0,1.0,1.0,1310,32220,19650,-12570
8056,0.0,0.0,0.0,1310,32224,19650,-12574
8057,0.0,0.0,0.25,1310,32228,19650,-12578
8058,0.0,0.0,0.0,1310,32232,19650,-12582
8059,0.0,0.0,0.0,1310,32236,19650,-12586
8060,1.0,0.0,0.5,1311,32240,19665,-12575
8061,0.0,0.0,0.0,1311,32244,19665,-12579
8062,0.0,0.0,0.0,1311,32248,19665,-12583
8063,1.0,1.0,1.0,1312,32252,19680,-12572
8064,0.0,0.0,0.0,1312,32256,19680,-12576
8065,0.0,0.0,0.0,1312,32260,19680,-12580
8066,0.0,0.0,0.0,1312,32264,19680,-12584
8067,0.0,0.0,0.0,1312,32268,19680,-12588
8068,1.0,1.0,1.0,1313,32272,19695,-12577
8069,0.0,0.0,0.0,1313,32276,19695,-12581
8070,0.0,0.0,0.0,1313,32280,19695,-12585
8071,0.0,0.0,0.0,1313,32284,19695,-12589
8072,0.0,0.0,0.0,1313,32288,19695,-12593
8073,1.0,1.0,1.0,1314,32292,19710,-12582
8074,0.0,0.0,0.0,1314,32296,19710,-12586
8075,0.0,0.0,0.0,1314,32300,19710,-12590
8076,0.0,0.0,0.2,1314,32304,19710,-12594
8077,0.0,0.0,0.0,1314,32308,19710,-12598
8078,0.0,0.0,0.0,1314,32312,19710,-12602
8079,0.0,0.0,0.0,1314,32316,19710,-12606
8080,0.0,0.0,0.0,1314,32320,19710,-12610
8081,0.0,0.0,0.0,1314,32324,19710,-12614
8082,0.0,0.0,0.0,1314,32328,19710,-12618
8083,1.0,1.0,1.0,1315,32332,19725,-12607
8084,0.0,0.0,0.0,1315,32336,19725,-12611
8085,1.0,0.0,0.4,1316,32340,19740,-12600
8086,0.0,0.0,0.0,1316,32344,19740,-12604
8087,0.0,0.0,0.0,1316,32348,19740,-12608
8088,0.0,0.0,0.0,1316,32352,19740,-12612
8089,1.0,0.0,0.25,1317,32356,19755,-12601
8090,0.0,0.0,0.0,1317,32360,19755,-12605
8091,0.0,0.0,0.0,1317,32364,19755,-12609
8092,0.0,0.0,0.0,1317,32368,19755,-12613
8093,0.0,0.0,0.0,1317,32372,19755,-12617
8094,1.0,1.0,0.8,1318,32376,19770,-12606
8095,0.0,0.0,0.0,1318,32380,19770,-12610
8096,0.0,0.0,0.0,1318,32384,19770,-12614
8097,0.0,0.0,0.0,1318,32388,19770,-12618
8098,0.0,0.0,0.0,1318,32392,19770,-12622
8099,0.0,0.0,0.0,1318,32396,19770,-12626
8100,0.0,0.0,0.0,1318,32400,19770,-12630
8101,0.0,0.0,0.0,1318,32404,19770,-12634
8102,0.0,0.0,0.0,1318,32408,19770,-12638
8103,0.0,0.0,0.0,1318,32412,19770,-12642
8104,0.0,0.0,0.0,1318,32416,19770,-12646
8105,0.0,0.0,0.0,1318,32420,19770,-12650
8106,0.0,0.0,0.0,1318,32424,19770,-12654
8107,0.0,0.0,0.0,1318,32428,19770,-12658
8108,0.0,0.0,0.0,1318,32432,19770,-12662
8109,1.0,1.0,1.0,1319,32436,19785,-12651
8110,0.0,0.0,0.0,1319,32440,19785,-12655
8111,1.0,1.0,1.0,1320,32444,19800,-12644
8112,0.0,0.0,0.0,1320,32448,19800,-12648
8113,0.0,0.0,0.0,1320,32452,19800,-12652
8114,0.0,0.0,0.0,1320,32456,19800,-12656
8115,0.0,0.0,0.0,1320,32460,19800,-12660
8116,0.0,0.0,0.0,1320,32464,19800,-12664
8117,0.0,0.0,0.0,1320,32468,19800,-12668
8118,1.0,1.0,1.0,1321,32472,19815,-12657
8119,1.0,1.0,1.0,1322,32476,19830,-12646
8120,0.0,0.0,0.0,1322,32480,19830,-12650
8121,0.0,0.0,0.0,1322,32484,19830,-12654
8122,1.0,1.0,1.0,1323,32488,19845,-12643
8123,0.0,0.0,0.0,1323,32492,19845,-12647
8124,0.0,0.0,0.0,1323,32496,19845,-12651
8125,1.0,1.0,0.8,1324,32500,19860,-12640
8126,0.0,0.0,0.0,1324,32504,19860,-12644
8127,0.0,0.0,0.0,1324,32508,19860,-12648
8128,0.0,0.0,0.0,1324,32512,19860,-12652
8129,1.0,1.0,1.0,1325,32516,19875,-12641
8130,0.0,0.0,0.0,1325,32520,19875,-12645
8131,0.0,0.0,0.0,1325,32524,19875,-12649
8132,0.0,0.0,0.0,1325,32528,19875,-12653
8133,0.0,0.0,0.0,1325,32532,19875,-12657
8134,0.0,0.0,0.0,1325,32536,19875,-12661
8135,0.0,0.0,0.0,1325,32540,19875,-12665
8136,0.0,0.0,0.0,1325,32544,19875,-12669
8137,0.0,0.0,0.0,1325,32548,19875,-12673
8138,0.0,0.0,0.0,1325,32552,19875,-12677
8139,0.0,0.0,0.0,1325,32556,19875,-12681
8140,0.0,0.0,0.0,1325,32560,19875,-12685
8141,0.0,0.0,0.0,1325,32564,19875,-12689
8142,0.0,0.0,0.0,1325,32568,19875,-12693
8143,0.0,0.0,0.0,1325,32572,19875,-12697
8144,0.0,1.0,0.6666666666666666,1325,32576,19875,-12701
8145,0.0,0.0,0.0,1325,32580,19875,-12705
8146,0.0,0.0,0.0,1325,32584,19875,-12709
8147,0.0,0.0,0.0,1325,32588,19875,-12713
8148,0.0,0.0,0.0,1325,32592,19875,-12717
8149,0.0,0.0,0.0,1325,32596,19875,-12721
8150,0.0,0.0,0.0,1325,32600,19875,-12725
8151,0.0,0.0,0.0,1325,32604,19875,-12729
8152,0.0,0.0,0.2,1325,32608,19875,-12733
8153,0.0,0.0,0.0,1325,32612,19875,-12737
8154,0.0,0.0,0.0,1325,32616,19875,-12741
8155,0.0,0.0,0.0,1325,32620,19875,-12745
8156,0.0,0.0,0.0,1325,32624,19875,-12749
8157,0.0,0.0,0.0,1325,32628,19875,-12753
8158,1.0,1.0,1.0,1326,32632,19890,-12742
8159,0.0,0.0,0.0,1326,32636,19890,-12746
8160,1.0,0.0,0.25,1327,32640,19905,-12735
8161,0.0,0.0,0.0,1327,32644,19905,-12739
8162,0.0,0.0,0.0,1327,32648,19905,-12743
8163,0.0,0.0,0.0,1327,32652,19905,-12747
8164,0.0,0.0,0.0,1327,32656,19905,-12751
8165,1.0,1.0,0.6,1328,32660,19920,-12740
8166,0.0,0.0,0.0,1328,32664,19920,-12744
8167,0.0,0.0,0.0,1328,32668,19920,-12748
8168,0.0,0.0,0.0,1328,32672,19920,-12752
8169,0.0,0.0,0.0,1328,32676,19920,-12756
8170,0.0,0.0,0.0,1328,32680,19920,-12760
8171,1.0,1.0,1.0,1329,32684,19935,-12749
8172,0.0,0.0,0.3333333333333333,1329,32688,19935,-12753
8173,0.0,0.0,0.0,1329,32692,19935,-12757
8174,0.0,0.0,0.0,1329,32696,19935,-12761
8175,0.0,0.0,0.0,1329,32700,19935,-12765
8176,0.0,1.0,0.6,1329,32704,19935,-12769
8177,1.0,0.0,0.4,1330,32708,19950,-12758
8178,0.0,0.0,0.0,1330,32712,19950,-12762
8179,0.0,0.0,0.0,1330,32716,19950,-12766
8180,0.0,0.0,0.0,1330,32720,19950,-12770
8181,0.0,0.0,0.0,1330,32724,19950,-12774
8182,0.0,0.0,0.5,1330,32728,19950,-12778
8183,1.0,1.0,0.75,1331,32732,19965,-12767
8184,0.0,0.0,0.0,1331,32736,19965,-12771
8185,0.0,0.0,0.0,1331,32740,19965,-12775
8186,0.0,0.0,0.0,1331,32744,19965,-12779
8187,1.0,1.0,1.0,1332,32748,19980,-12768
8188,0.0,0.0,0.0,1332,32752,19980,-12772
8189,0.0,0.0,0.0,1332,32756,19980,-12776
8190,0.0,0.0,0.0,1332,32760,19980,-12780
8191,0.0,0.0,0.0,1332,32764,19980,-12784
8192,0.0,0.0,0.0,1332,32768,19980,-12788
8193,0.0,0.0,0.0,1332,32772,19980,-12792
8194,0.0,0.0,0.0,1332,32776,19980,-12796
8195,0.0,0.0,0.0,1332,32780,19980,-12800
8196,0.0,0.0,0.0,1332,32784,19980,-12804
8197,0.0,0.0,0.0,1332,32788,19980,-12808
8198,0.0,0.0,0.0,1332,32792,19980,-12812
8199,0.0,0.0,0.0,1332,32796,19980,-12816
8200,0.0,0.0,0.0,1332,32800,19980,-12820
8201,0.0,0.0,0.0,1332,32804,19980,-12824
8202,1.0,0.0,0.3333333333333333,1333,32808,19995,-12813
8203,1.0,1.0,1.0,1334,32812,20010,-12802
8204,0.0,0.0,0.0,1334,32816,20010,-12806
8205,0.0,0.0,0.0,1334,32820,20010,-12810
8206,0.0,1.0,0.6,1334,32824,20010,-12814
8207,0.0,0.0,0.0,1334,32828,20010,-12818
8208,1.0,1.0,1.0,1335,32832,20025,-12807
8209,0.0,0.0,0.0,1335,32836,20025,-12811
8210,0.0,0.0,0.0,1335,32840,20025,-12815
8211,0.0,0.0,0.0,1335,32844,20025,-12819
8212,0.0,0.0,0.0,1335,32848,20025,-12823
8213,0.0,0.0,0.0,1335,32852,20025,-12827
8214,0.0,0.0,0.0,1335,32856,20025,-12831
8215,0.0,0.0,0.0,1335,32860,20025,-12835
8216,1.0,1.0,1.0,1336,32864,20040,-12824
8217,0.0,0.0,0.0,1336,32868,20040,-12828
8218,0.0,0.0,0.0,1336,32872,20040,-12832
8219,0.0,0.0,0.0,1336,32876,20040,-12836
8220,0.0,0.0,0.0,1336,32880,20040,-12840
8221,0.0,0.0,0.0,1336,32884,20040,-12844
8222,0.0,0.0,0.0,1336,32888,20040,-12848
8223,1.0,0.0,0.3333333333333333,1337,32892,20055,-12837
8224,1.0,1.0,0.8,1338,32896,20070,-12826
8225,0.0,0.0,0.0,1338,32900,20070,-12830
8226,0.0,0.0,0.0,1338,32904,20070,-12834
8227,0.0,0.0,0.0,1338,32908,20070,-12838
8228,0.0,0.0,0.0,1338,32912,20070,-12842
8229,0.0,0.0,0.0,1338,32916,20070,-12846
8230,0.0,0.0,0.0,1338,32920,20070,-12850
8231,0.0,0.0,0.0,1338,32924,20070,-12854
8232,0.0,0.0,0.0,1338,32928,20070,-12858
8233,0.0,0.0,0.0,1338,32932,20070,-12862
8234,0.0,0.0,0.0,1338,32936,20070,-12866
8235,0.0,0.0,0.0,1338,32940,20070,-12870
8236,0.0,1.0,0.6666666666666666,1338,32944,20070,-12874
8237,0.0,0.0,0.0,1338,32948,20070,-12878
8238,0.0,0.0,0.0,1338,32952,20070,-12882
8239,0.0,0.0,0.0,1338,32956,20070,-12886
8240,0.0,0.0,0.0,1338,32960,20070,-12890
8241,0.0,0.0,0.0,1338,32964,20070,-12894
8242,0.0,0.0,0.0,1338,32968,20070,-12898
8243,1.0,1.0,1.0,1339,32972,20085,-12887
8244,0.0,0.0,0.0,1339,32976,20085,-12891
8245,1.0,1.0,1.0,1340,32980,20100,-12880
8246,0.0,0.0,0.0,1340,32984,20100,-12884
8247,0.0,0.0,0.0,1340,32988,20100,-12888
8248,1.0,1.0,0.6,1341,32992,20115,-12877
8249,0.0,0.0,0.0,1341,32996,20115,-12881
8250,0.0,0.0,0.0,1341,33000,20115,-12885
8251,0.0,0.0,0.0,1341,33004,20115,-12889
8252,0.0,0.0,0.0,1341,33008,20115,-12893
8253,0.0,0.0,0.0,1341,33012,20115,-12897
8254,0.0,0.0,0.0,1341,33016,20115,-12901
8255,0.0,0.0,0.0,1341,33020,20115,-12905
8256,0.0,0.0,0.0,1341,33024,20115,-12909
8257,0.0,0.0,0.0,1341,33028,20115,-12913
8258,0.0,0.0,0.0,1341,33032,20115,-12917
8259,1.0,0.0,0.3333333333333333,1342,33036,20130,-12906
8260,0.0,0.0,0.0,1342,33040,20130,-12910
8261,1.0,1.0,1.0,1343,33044,20145,-12899
8262,1.0,0.0,0.5,1344,33048,20160,-12888
8263,0.0,0.0,0.0,1344,33052,20160,-12892
8264,0.0,0.0,0.0,1344,33056,20160,-12896
8265,1.0,1.0,1.0,1345,33060,20175,-12885
8266,0.0,0.0,0.0,1345,33064,20175,-12889
8267,0.0,0.0,0.0,1345,33068,20175,-12893
8268,0.0,0.0,0.0,1345,33072,20175,-12897
8269,0.0,0.0,0.0,1345,33076,20175,-12901
8270,0.0,0.0,0.0,1345,33080,20175,-12905
8271,0.0,0.0,0.0,1345,33084,20175,-12909
8272,0.0,0.0,0.2,1345,33088,20175,-12913
8273,0.0,0.0,0.2,1345,33092,20175,-12917
8274,1.0,1.0,0.6666666666666666,1346,33096,20190,-12906
8275,0.0,0.0,0.0,1346,33100,20190,-12910
8276,1.0,1.0,1.0,1347,33104,20205,-12899
8277,1.0,1.0,1.0,1348,33108,20220,-12888
8278,0.0,0.0,0.0,1348,33112,20220,-12892
8279,0.0,0.0,0.0,1348,33116,20220,-12896
8280,0.0,0.0,0.0,1348,33120,20220,-12900
8281,0.0,0.0,0.0,1348,33124,20220,-12904
8282,0.0,0.0,0.0,1348,33128,20220,-12908
8283,0.0,0.0,0.0,1348,33132,20220,-12912
8284,0.0,0.0,0.0,1348,33136,20220,-12916
8285,0.0,0.0,0.0,1348,33140,20220,-12920
8286,1.0,1.0,0.6666666666666666,1349,33144,20235,-12909
8287,0.0,0.0,0.0,1349,33148,20235,-12913
8288,0.0,0.0,0.0,1349,33152,20235,-12917
8289,1.0,1.0,1.0,1350,33156,20250,-12906
8290,1.0,1.0,1.0,1351,33160,20265,-12895
8291,0.0,0.0,0.0,1351,33164,20265,-12899
8292,0.0,0.0,0.0,1351,33168,20265,-12903
8293,0.0,0.0,0.0,1351,33172,20265,-12907
8294,0.0,0.0,0.0,1351,33176,20265,-12911
8295,0.0,0.0,0.0,1351,33180,20265,-12915
8296,0.0,0.0,0.0,1351,33184,20265,-12919
8297,0.0,0.0,0.0,1351,33188,20265,-12923
8298,0.0,0.0,0.0,1351,33192,20265,-12927
8299,0.0,0.0,0.0,1351,33196,20265,-12931
8300,0.0,0.0,0.0,1351,33200,20265,-12935
8301,0.0,0.0,0.3333333333333333,1351,33204,20265,-12939
8302,0.0,0.0,0.0,1351,33208,20265,-12943
8303,0.0,0.0,0.0,1351,33212,20265,-12947
8304,0.0,0.0,0.0,1351,33216,20265,-12951
8305,1.0,1.0,1.0,1352,33220,20280,-12940
8306,0.0,0.0,0.0,1352,33224,20280,-12944
8307,0.0,0.0,0.3333333333333333,1352,33228,20280,-12948
8308,0.0,0.0,0.0,1352,33232,20280,-12952
8309,0.0,0.0,0.25,1352,33236,20280,-12956
8310,0.0,0.0,0.0,1352,33240,20280,-12960
8311,0.0,0.0,0.0,1352,33244,20280,-12964
8312,1.0,1.0,1.0,1353,33248,20295,-12953
8313,0.0,0.0,0.0,1353,33252,20295,-12957
8314,1.0,1.0,0.6666666666666666,1354,33256,20310,-12946
8315,0.0,0.0,0.0,1354,33260,20310,-12950
8316,0.0,0.0,0.0,1354,33264,20310,-12954
8317,0.0,0.0,0.0,1354,33268,20310,-12958
8318,0.0,0.0,0.0,1354,33272,20310,-12962
8319,0.0,0.0,0.0,1354,33276,20310,-12966
8320,0.0,0.0,0.0,1354,33280,20310,-12970
8321,1.0,1.0,1.0,1355,33284,20325,-12959
8322,1.0,1.0,0.6666666666666666,1356,33288,20340,-12948
8323,0.0,0.0,0.0,1356,33292,20340,-12952
8324,0.0,0.0,0.0,1356,33296,20340,-12956
8325,0.0,0.0,0.0,1356,33300,20340,-12960
8326,0.0,0.0,0.0,1356,33304,20340,-12964
8327,0.0,0.0,0.0,1356,33308,20340,-12968
8328,0.0,0.0,0.0,1356,33312,20340,-12972
8329,0.0,0.0,0.0,1356,33316,20340,-12976
8330,0.0,0.0,0.0,1356,33320,20340,-12980
8331,0.0,0.0,0.0,1356,33324,20340,-12984
8332,0.0,0.0,0.0,1356,33328,20340,-12988
8333,0.0,0.0,0.0,1356,33332,20340,-12992
8334,0.0,0.0,0.0,1356,33336,20340,-12996
8335,0.0,0.0,0.0,1356,33340,20340,-13000
8336,0.0,0.0,0.0,1356,33344,20340,-13004
8337,0.0,0.0,0.0,1356,33348,20340,-13008
8338,1.0,1.0,0.6666666666666666,1357,33352,20355,-12997
8339,0.0,0.0,0.0,1357,33356,20355,-13001
8340,1.0,1.0,0.75,1358,33360,20370,-12990
8341,0.0,0.0,0.0,1358,33364,20370,-12994
8342,0.0,0.0,0.0,1358,33368,20370,-12998
8343,0.0,0.0,0.0,1358,33372,20370,-13002
8344,0.0,0.0,0.0,1358,33376,20370,-13006
8345,0.0,0.0,0.0,1358,33380,20370,-13010
8346,0.0,0.0,0.0,1358,33384,20370,-13014
8347,0.0,0.0,0.0,1358,33388,20370,-13018
8348,0.0,0.0,0.0,1358,33392,20370,-13022
8349,0.0,0.0,0.0,1358,33396,20370,-13026
8350,0.0,0.0,0.0,1358,33400,20370,-13030
8351,0.0,0.0,0.0,1358,33404,20370,-13034
8352,0.0,0.0,0.0,1358,33408,20370,-13038
8353,0.0,0.0,0.0,1358,33412,20370,-13042
8354,0.0,0.0,0.0,1358,33416,20370,-13046
8355,0.0,0.0,0.0,1358,33420,20370,-13050
8356,1.0,1.0,1.0,1359,33424,20385,-13039
8357,0.0,0.0,0.0,1359,33428,20385,-13043
8358,1.0,0.0,0.3333333333333333,1360,33432,20400,-13032
8359,0.0,0.0,0.0,1360,33436,20400,-13036
8360,0.0,1.0,0.6666666666666666,1360,33440,20400,-13040
8361,0.0,0.0,0.0,1360,33444,20400,-13044
8362,1.0,1.0,1.0,1361,33448,20415,-13033
8363,0.0,0.0,0.0,1361,33452,20415,-13037
8364,0.0,0.0,0.0,1361,33456,20415,-13041
8365,0.0,0.0,0.0,1361,33460,20415,-13045
8366,0.0,0.0,0.0,1361,33464,20415,-13049
8367,0.0,0.0,0.0,1361,33468,20415,-13053
8368,0.0,0.0,0.0,1361,33472,20415,-13057
8369,0.0,0.0,0.0,1361,33476,20415,-13061
8370,0.0,0.0,0.0,1361,33480,20415,-13065
8371,0.0,0.0,0.0,1361,33484,20415,-13069
8372,0.0,0.0,0.25,1361,33488,20415,-13073
8373,0.0,0.0,0.0,1361,33492,20415,-13077
8374,0.0,0.0,0.0,1361,33496,20415,-13081
8375,0.0,0.0,0.0,1361,33500,20415,-13085
8376,0.0,0.0,0.0,1361,33504,20415,-13089
8377,0.0,0.0,0.0,1361,33508,20415,-13093
8378,0.0,0.0,0.0,1361,33512,20415,-13097
8379,0.0,0.0,0.0,1361,33516,20415,-13101
8380,0.0,0.0,0.0,1361,33520,20415,-13105
8381,0.0,0.0,0.0,1361,33524,20415,-13109
8382,0.0,0.0,0.0,1361,33528,20415,-13113
8383,0.0,0.0,0.0,1361,33532,20415,-13117
8384,0.0,0.0,0.0,1361,33536,20415,-13121
8385,0.0,0.0,0.0,1361,33540,20415,-13125
8386,0.0,0.0,0.0,1361,33544,20415,-13129
8387,0.0,0.0,0.0,1361,33548,20415,-13133
8388,0.0,0.0,0.0,1361,33552,20415,-13137
8389,0.0,0.0,0.0,1361,33556,20415,-13141
8390,0.0,0.0,0.0,1361,33560,20415,-13145
8391,0.0,0.0,0.0,1361,33564,20415,-13149
8392,0.0,0.0,0.0,1361,33568,20415,-13153
8393,0.0,0.0,0.0,1361,33572,20415,-13157
8394,0.0,0.0,0.0,1361,33576,20415,-13161
8395,0.0,0.0,0.0,1361,33580,20415,-13165
8396,0.0,0.0,0.0,1361,33584,20415,-13169
8397,0.0,0.0,0.0,1361,33588,20415,-13173
8398,0.0,0.0,0.0,1361,33592,20415,-13177
8399,1.0,1.0,0.6,1362,33596,20430,-13166
8400,0.0,0.0,0.0,1362,33600,20430,-13170
8401,0.0,0.0,0.0,1362,33604,20430,-13174
8402,0.0,0.0,0.3333333333333333,1362,33608,20430,-13178
8403,0.0,0.0,0.0,1362,33612,20430,-13182
8404,0.0,0.0,0.0,1362,33616,20430,-13186
8405,0.0,0.0,0.25,1362,33620,20430,-13190
8406,1.0,1.0,1.0,1363,33624,20445,-13179
8407,0.0,0.0,0.0,1363,33628,20445,-13183
8408,1.0,1.0,1.0,1364,33632,20460,-13172
8409,0.0,0.0,0.0,1364,33636,20460,-13176
8410,0.0,0.0,0.0,1364,33640,20460,-13180
8411,0.0,0.0,0.0,1364,33644,20460,-13184
8412,0.0,0.0,0.0,1364,33648,20460,-13188
8413,0.0,0.0,0.0,1364,33652,20460,-13192
8414,0.0,0.0,0.0,1364,33656,20460,-13196
8415,0.0,0.0,0.0,1364,33660,20460,-13200
8416,0.0,0.0,0.0,1364,33664,20460,-13204
8417,0.0,0.0,0.0,1364,33668,20460,-13208
8418,0.0,0.0,0.0,1364,33672,20460,-13212
8419,1.0,1.0,1.0,1365,33676,20475,-13201
8420,0.0,0.0,0.0,1365,33680,20475,-13205
8421,0.0,0.0,0.0,1365,33684,20475,-13209
8422,0.0,0.0,0.0,1365,33688,20475,-13213
8423,0.0,0.0,0.0,1365,33692,20475,-13217
8424,0.0,0.0,0.0,1365,33696,20475,-13221
8425,0.0,0.0,0.0,1365,33700,20475,-13225
8426,0.0,0.0,0.0,1365,33704,20475,-13229
8427,0.0,0.0,0.0,1365,33708,20475,-13233
8428,0.0,0.0,0.0,1365,33712,20475,-13237
8429,0.0,0.0,0.0,1365,33716,20475,-13241
8430,0.0,0.0,0.0,1365,33720,20475,-13245
8431,0.0,0.0,0.0,1365,33724,20475,-13249
8432,0.0,0.0,0.0,1365,33728,20475,-13253
8433,0.0,0.0,0.0,1365,33732,20475,-13257
8434,0.0,0.0,0.0,1365,33736,20475,-13261
8435,0.0,0.0,0.0,1365,33740,20475,-13265
8436,1.0,1.0,1.0,1366,33744,20490,-13254
8437,0.0,0.0,0.0,1366,33748,20490,-13258
8438,0.0,0.0,0.0,1366,33752,20490,-13262
8439,0.0,0.0,0.0,1366,33756,20490,-13266
8440,0.0,0.0,0.0,1366,33760,20490,-13270
8441,0.0,0.0,0.0,1366,33764,20490,-13274
8442,1.0,1.0,1.0,1367,33768,20505,-13263
8443,0.0,0.0,0.0,1367,33772,20505,-13267
8444,0.0,0.0,0.0,1367,33776,20505,-13271
8445,0.0,0.0,0.0,1367,33780,20505,-13275
8446,1.0,1.0,1.0,1368,33784,20520,-13264
8447,0.0,1.0,0.6,1368,33788,20520,-13268
8448,0.0,0.0,0.0,1368,33792,20520,-13272
8449,0.0,0.0,0.0,1368,33796,20520,-13276
8450,0.0,0.0,0.0,1368,33800,20520,-13280
8451,0.0,0.0,0.0,1368,33804,20520,-13284
8452,0.0,0.0,0.0,1368,33808,20520,-13288
8453,0.0,0.0,0.0,1368,33812,20520,-13292
8454,0.0,0.0,0.0,1368,33816,20520,-13296
8455,0.0,0.0,0.0,1368,33820,20520,-13300
8456,0.0,0.0,0.0,1368,33824,20520,-13304
8457,1.0,1.0,1.0,1369,33828,20535,-13293
8458,0.0,0.0,0.0,1369,33832,20535,-13297
8459,1.0,1.0,1.0,1370,33836,20550,-13286
8460,0.0,0.0,0.0,1370,33840,20550,-13290
8461,1.0,1.0,1.0,1371,33844,20565,-13279
8462,1.0,1.0,1.0,1372,33848,20580,-13268
8463,0.0,0.0,0.0,1372,33852,20580,-13272
8464,0.0,0.0,0.0,1372,33856,20580,-13276
8465,0.0,0.0,0.0,1372,33860,20580,-13280
8466,0.0,0.0,0.0,1372,33864,20580,-13284
8467,0.0,0.0,0.0,1372,33868,20580,-13288
8468,0.0,0.0,0.0,1372,33872,20580,-13292
8469,0.0,0.0,0.0,1372,33876,20580,-13296
8470,0.0,0.0,0.0,1372,33880,20580,-13300
8471,0.0,0.0,0.0,1372,33884,20580,-13304
8472,0.0,0.0,0.25,1372,33888,20580,-13308
8473,0.0,0.0,0.0,1372,33892,20580,-13312
8474,0.0,0.0,0.0,1372,33896,20580,-13316
8475,0.0,0.0,0.0,1372,33900,20580,-13320
8476,1.0,1.0,0.8,1373,33904,20595,-13309
8477,0.0,0.0,0.0,1373,33908,20595,-13313
8478,0.0,0.0,0.0,1373,33912,20595,-13317
8479,0.0,0.0,0.0,1373,33916,20595,-13321
8480,0.0,0.0,0.0,1373,33920,20595,-13325
8481,0.0,0.0,0.0,1373,33924,20595,-13329
8482,0.0,0.0,0.0,1373,33928,20595,-13333
8483,0.0,0.0,0.0,1373,33932,20595,-13337
8484,0.0,0.0,0.0,1373,33936,20595,-13341
8485,0.0,0.0,0.0,1373,33940,20595,-13345
8486,0.0,0.0,0.0,1373,33944,20595,-13349
8487,0.0,1.0,0.6666666666666666,1373,33948,20595,-13353
8488,0.0,0.0,0.0,1373,33952,20595,-13357
8489,1.0,1.0,1.0,1374,33956,20610,-13346
8490,0.0,0.0,0.0,1374,33960,20610,-13350
8491,1.0,1.0,1.0,1375,33964,20625,-13339
8492,0.0,0.0,0.0,1375,33968,20625,-13343
8493,0.0,0.0,0.0,1375,33972,20625,-13347
8494,0.0,0.0,0.0,1375,33976,20625,-13351
8495,0.0,0.0,0.0,1375,33980,20625,-13355
8496,0.0,0.0,0.0,1375,33984,20625,-13359
8497,0.0,0.0,0.0,1375,33988,20625,-13363
8498,0.0,0.0,0.0,1375,33992,20625,-13367
8499,1.0,1.0,1.0,1376,33996,20640,-13356
8500,0.0,0.0,0.0,1376,34000,20640,-13360
8501,1.0,1.0,1.0,1377,34004,20655,-13349
8502,0.0,0.0,0.0,1377,34008,20655,-13353
8503,0.0,0.0,0.0,1377,34012,20655,-13357
8504,0.0,0.0,0.0,1377,34016,20655,-13361
8505,0.0,0.0,0.0,1377,34020,20655,-13365
8506,0.0,0.0,0.0,1377,34024,20655,-13369
8507,0.0,0.0,0.0,1377,34028,20655,-13373
8508,0.0,0.0,0.5,1377,34032,20655,-13377
8509,0.0,0.0,0.0,1377,34036,20655,-13381
8510,0.0,0.0,0.0,1377,34040,20655,-13385
8511,0.0,0.0,0.0,1377,34044,20655,-13389
8512,0.0,0.0,0.0,1377,34048,20655,-13393
8513,0.0,0.0,0.0,1377,34052,20655,-13397
8514,0.0,0.0,0.0,1377,34056,20655,-13401
8515,1.0,1.0,1.0,1378,34060,20670,-13390
8516,0.0,0.0,0.0,1378,34064,20670,-13394
8517,0.0,0.0,0.0,1378,34068,20670,-13398
8518,0.0,0.0,0.0,1378,34072,20670,-13402
8519,0.0,0.0,0.0,1378,34076,20670,-13406
8520,0.0,0.0,0.0,1378,34080,20670,-13410
8521,1.0,1.0,1.0,1379,34084,20685,-13399
8522,0.0,0.0,0.0,1379,34088,20685,-13403
8523,0.0,0.0,0.0,1379,34092,20685,-13407
8524,0.0,0.0,0.0,1379,34096,20685,-13411
8525,1.0,1.0,1.0,1380,34100,20700,-13400
8526,0.0,0.0,0.0,1380,34104,20700,-13404
8527,0.0,0.0,0.0,1380,34108,20700,-13408
8528,0.0,0.0,0.0,1380,34112,20700,-13412
8529,0.0,0.0,0.0,1380,34116,20700,-13416
8530,1.0,0.0,0.3333333333333333,1381,34120,20715,-13405
8531,0.0,0.0,0.0,1381,34124,20715,-13409
8532,0.0,0.0,0.0,1381,34128,20715,-13413
8533,0.0,0.0,0.0,1381,34132,20715,-13417
8534,0.0,0.0,0.0,1381,34136,20715,-13421
8535,0.0,0.0,0.0,1381,34140,20715,-13425
8536,0.0,0.0,0.0,1381,34144,20715,-13429
8537,0.0,0.0,0.0,1381,34148,20715,-13433
8538,0.0,0.0,0.0,1381,34152,20715,-13437
8539,0.0,0.0,0.0,1381,34156,20715,-13441
8540,0.0,0.0,0.0,1381,34160,20715,-13445
8541,0.0,0.0,0.0,1381,34164,20715,-13449
8542,0.0,0.0,0.0,1381,34168,20715,-13453
8543,0.0,0.0,0.0,1381,34172,20715,-13457
8544,1.0,1.0,1.0,1382,34176,20730,-13446
8545,0.0,0.0,0.0,1382,34180,20730,-13450
8546,1.0,1.0,1.0,1383,34184,20745,-13439
8547,0.0,0.0,0.0,1383,34188,20745,-13443
8548,0.0,0.0,0.0,1383,34192,20745,-13447
8549,1.0,1.0,1.0,1384,34196,20760,-13436
8550,0.0,0.0,0.0,1384,34200,20760,-13440
8551,0.0,0.0,0.0,1384,34204,20760,-13444
8552,0.0,0.0,0.0,1384,34208,20760,-13448
8553,1.0,1.0,1.0,1385,34212,20775,-13437
8554,0.0,0.0,0.0,1385,34216,20775,-13441
8555,1.0,1.0,0.6,1386,34220,20790,-13430
8556,0.0,0.0,0.0,1386,34224,20790,-13434
8557,0.0,0.0,0.0,1386,34228,20790,-13438
8558,1.0,1.0,0.6666666666666666,1387,34232,20805,-13427
8559,0.0,0.0,0.0,1387,34236,20805,-13431
8560,0.0,0.0,0.0,1387,34240,20805,-13435
8561,0.0,0.0,0.0,1387,34244,20805,-13439
8562,0.0,0.0,0.0,1387,34248,20805,-13443
8563,0.0,0.0,0.0,1387,34252,20805,-13447
8564,0.0,1.0,0.75,1387,34256,20805,-13451
8565,0.0,0.0,0.0,1387,34260,20805,-13455
8566,1.0,1.0,1.0,1388,34264,20820,-13444
8567,1.0,1.0,1.0,1389,34268,20835,-13433
8568,0.0,0.0,0.0,1389,34272,20835,-13437
8569,1.0,1.0,1.0,1390,34276,20850,-13426
8570,0.0,0.0,0.0,1390,34280,20850,-13430
8571,0.0,0.0,0.0,1390,34284,20850,-13434
8572,1.0,0.0,0.5,1391,34288,20865,-13423
8573,0.0,0.0,0.0,1391,34292,20865,-13427
8574,0.0,0.0,0.0,1391,34296,20865,-13431
8575,0.0,0.0,0.0,1391,34300,20865,-13435
8576,0.0,0.0,0.0,1391,34304,20865,-13439
8577,1.0,1.0,1.0,1392,34308,20880,-13428
8578,0.0,0.0,0.0,1392,34312,20880,-13432
8579,0.0,0.0,0.0,1392,34316,20880,-13436
8580,1.0,1.0,1.0,1393,34320,20895,-13425
8581,0.0,0.0,0.0,1393,34324,20895,-13429
8582,0.0,0.0,0.0,1393,34328,20895,-13433
8583,0.0,0.0,0.0,1393,34332,20895,-13437
8584,1.0,1.0,1.0,1394,34336,20910,-13426
8585,0.0,0.0,0.0,1394,34340,20910,-13430
8586,0.0,0.0,0.0,1394,34344,20910,-13434
8587,1.0,1.0,1.0,1395,34348,20925,-13423
8588,0.0,0.0,0.25,1395,34352,20925,-13427
8589,0.0,0.0,0.0,1395,34356,20925,-13431
8590,1.0,0.0,0.3333333333333333,1396,34360,20940,-13420
8591,0.0,0.0,0.0,1396,34364,20940,-13424
8592,0.0,0.0,0.0,1396,34368,20940,-13428
8593,0.0,0.0,0.0,1396,34372,20940,-13432
8594,0.0,0.0,0.0,1396,34376,20940,-13436
8595,0.0,0.0,0.0,1396,34380,20940,-13440
8596,0.0,0.0,0.0,1396,34384,20940,-13444
8597,0.0,0.0,0.0,1396,34388,20940,-13448
8598,0.0,0.0,0.0,1396,34392,20940,-13452
8599,0.0,0.0,0.0,1396,34396,20940,-13456
8600,0.0,0.0,0.0,1396,34400,20940,-13460
8601,0.0,0.0,0.0,1396,34404,20940,-13464
8602,0.0,0.0,0.0,1396,34408,20940,-13468
8603,0.0,0.0,0.0,1396,34412,20940,-13472
8604,0.0,0.0,0.0,1396,34416,20940,-13476
8605,0.0,0.0,0.0,1396,34420,20940,-13480
8606,0.0,0.0,0.0,1396,34424,20940,-13484
8607,0.0,0.0,0.5,1396,34428,20940,-13488
8608,0.0,0.0,0.0,1396,34432,20940,-13492
8609,0.0,0.0,0.0,1396,34436,20940,-13496
8610,0.0,0.0,0.0,1396,34440,20940,-13500
8611,0.0,0.0,0.0,1396,34444,20940,-13504
8612,0.0,0.0,0.0,1396,34448,20940,-13508
8613,0.0,0.0,0.0,1396,34452,20940,-13512
8614,0.0,0.0,0.0,1396,34456,20940,-13516
8615,1.0,1.0,1.0,1397,34460,20955,-13505
8616,0.0,0.0,0.0,1397,34464,20955,-13509
8617,0.0,0.0,0.0,1397,34468,20955,-13513
8618,0.0,0.0,0.0,1397,34472,20955,-13517
8619,1.0,1.0,1.0,1398,34476,20970,-13506
8620,1.0,1.0,1.0,1399,34480,20985,-13495
8621,0.0,0.0,0.0,1399,34484,20985,-13499
8622,0.0,0.0,0.0,1399,34488,20985,-13503
8623,1.0,1.0,1.0,1400,34492,21000,-13492
8624,0.0,0.0,0.0,1400,34496,21000,-13496
8625,0.0,0.0,0.0,1400,34500,21000,-13500
8626,0.0,0.0,0.0,1400,34504,21000,-13504
8627,1.0,1.0,1.0,1401,34508,21015,-13493
8628,0.0,0.0,0.0,1401,34512,21015,-13497
8629,0.0,0.0,0.0,1401,34516,21015,-13501
8630,0.0,0.0,0.0,1401,34520,21015,-13505
8631,0.0,0.0,0.0,1401,34524,21015,-13509
8632,0.0,0.0,0.0,1401,34528,21015,-13513
8633,0.0,0.0,0.0,1401,34532,21015,-13517
8634,0.0,0.0,0.0,1401,34536,21015,-13521
8635,0.0,0.0,0.0,1401,34540,21015,-13525
8636,1.0,1.0,1.0,1402,34544,21030,-13514
8637,0.0,0.0,0.0,1402,34548,21030,-13518
8638,1.0,1.0,1.0,1403,34552,21045,-13507
8639,0.0,0.0,0.0,1403,34556,21045,-13511
8640,1.0,1.0,0.8,1404,34560,21060,-13500
8641,0.0,0.0,0.0,1404,34564,21060,-13504
8642,0.0,0.0,0.0,1404,34568,21060,-13508
8643,0.0,0.0,0.0,1404,34572,21060,-13512
8644,0.0,0.0,0.0,1404,34576,21060,-13516
8645,0.0,0.0,0.0,1404,34580,21060,-13520
8646,0.0,0.0,0.0,1404,34584,21060,-13524
8647,0.0,0.0,0.0,1404,34588,21060,-13528
8648,0.0,0.0,0.0,1404,34592,21060,-13532
8649,0.0,0.0,0.0,1404,34596,21060,-13536
8650,0.0,0.0,0.0,1404,34600,21060,-13540
8651,0.0,0.0,0.0,1404,34604,21060,-13544
8652,0.0,0.0,0.0,1404,34608,21060,-13548
8653,0.0,0.0,0.0,1404,34612,21060,-13552
8654,0.0,0.0,0.0,1404,34616,21060,-13556
8655,0.0,0.0,0.0,1404,34620,21060,-13560
8656,0.0,0.0,0.0,1404,34624,21060,-13564
8657,1.0,1.0,1.0,1405,34628,21075,-13553
8658,1.0,1.0,1.0,1406,34632,21090,-13542
8659,0.0,0.0,0.0,1406,34636,21090,-13546
8660,0.0,0.0,0.0,1406,34640,21090,-13550
8661,1.0,1.0,1.0,1407,34644,21105,-13539
8662,0.0,0.0,0.0,1407,34648,21105,-13543
8663,0.0,0.0,0.0,1407,34652,21105,-13547
8664,0.0,0.0,0.0,1407,34656,21105,-13551
8665,0.0,0.0,0.0,1407,34660,21105,-13555
8666,0.0,0.0,0.0,1407,34664,21105,-13559
8667,0.0,0.0,0.0,1407,34668,21105,-13563
8668,0.0,0.0,0.0,1407,34672,21105,-13567
8669,0.0,0.0,0.0,1407,34676,21105,-13571
8670,0.0,0.0,0.0,1407,34680,21105,-13575
8671,1.0,1.0,1.0,1408,34684,21120,-13564
8672,0.0,0.0,0.0,1408,34688,21120,-13568
8673,1.0,1.0,1.0,1409,34692,21135,-13557
8674,1.0,1.0,1.0,1410,34696,21150,-13546
8675,1.0,1.0,1.0,1411,34700,21165,-13535
8676,1.0,1.0,1.0,1412,34704,21180,-13524
8677,0.0,0.0,0.0,1412,34708,21180,-13528
8678,0.0,0.0,0.0,1412,34712,21180,-13532
8679,1.0,1.0,1.0,1413,34716,21195,-13521
8680,0.0,0.0,0.0,1413,34720,21195,-13525
8681,0.0,0.0,0.0,1413,34724,21195,-13529
8682,0.0,0.0,0.0,1413,34728,21195,-13533
8683,0.0,0.0,0.0,1413,34732,21195,-13537
8684,0.0,0.0,0.0,1413,34736,21195,-13541
8685,1.0,1.0,1.0,1414,34740,21210,-13530
8686,0.0,0.0,0.0,1414,34744,21210,-13534
8687,0.0,0.0,0.0,1414,34748,21210,-13538
8688,0.0,0.0,0.0,1414,34752,21210,-13542
8689,0.0,0.0,0.0,1414,34756,21210,-13546
8690,0.0,0.0,0.0,1414,34760,21210,-13550
8691,0.0,0.0,0.5,1414,34764,21210,-13554
8692,1.0,1.0,1.0,1415,34768,21225,-13543
8693,1.0,1.0,1.0,1416,34772,21240,-13532
8694,0.0,0.0,0.0,1416,34776,21240,-13536
8695,0.0,0.0,0.0,1416,34780,21240,-13540
8696,0.0,0.0,0.0,1416,34784,21240,-13544
8697,1.0,1.0,1.0,1417,34788,21255,-13533
8698,0.0,0.0,0.0,1417,34792,21255,-13537
8699,0.0,0.0,0.0,1417,34796,21255,-13541
8700,0.0,0.0,0.0,1417,34800,21255,-13545
8701,0.0,0.0,0.0,1417,34804,21255,-13549
8702,0.0,0.0,0.0,1417,34808,21255,-13553
8703,0.0,0.0,0.0,1417,34812,21255,-13557
8704,0.0,0.0,0.0,1417,34816,21255,-13561
8705,0.0,0.0,0.0,1417,34820,21255,-13565
8706,0.0,0.0,0.0,1417,34824,21255,-13569
8707,1.0,1.0,1.0,1418,34828,21270,-13558
8708,0.0,0.0,0.0,1418,34832,21270,-13562
8709,0.0,0.0,0.0,1418,34836,21270,-13566
8710,1.0,1.0,1.0,1419,34840,21285,-13555
8711,0.0,0.0,0.0,1419,34844,21285,-13559
8712,1.0,0.0,0.25,1420,34848,21300,-13548
8713,0.0,0.0,0.0,1420,34852,21300,-13552
8714,0.0,0.0,0.0,1420,34856,21300,-13556
8715,0.0,0.0,0.0,1420,34860,21300,-13560
8716,0.0,0.0,0.0,1420,34864,21300,-13564
8717,0.0,0.0,0.0,1420,34868,21300,-13568
8718,0.0,0.0,0.0,1420,34872,21300,-13572
8719,0.0,0.0,0.0,1420,34876,21300,-13576
8720,0.0,0.0,0.0,1420,34880,21300,-13580
8721,0.0,0.0,0.0,1420,34884,21300,-13584
8722,0.0,0.0,0.0,1420,34888,21300,-13588
8723,0.0,0.0,0.0,1420,34892,21300,-13592
8724,0.0,0.0,0.4,1420,34896,21300,-13596
8725,0.0,0.0,0.0,1420,34900,21300,-13600
8726,0.0,0.0,0.0,1420,34904,21300,-13604
8727,1.0,1.0,1.0,1421,34908,21315,-13593
8728,0.0,0.0,0.0,1421,34912,21315,-13597
8729,0.0,0.0,0.0,1421,34916,21315,-13601
8730,0.0,0.0,0.0,1421,34920,21315,-13605
8731,0.0,0.0,0.0,1421,34924,21315,-13609
8732,0.0,0.0,0.0,1421,34928,21315,-13613
8733,0.0,0.0,0.0,1421,34932,21315,-13617
8734,0.0,0.0,0.0,1421,34936,21315,-13621
8735,0.0,0.0,0.0,1421,34940,21315,-13625
8736,1.0,1.0,0.6,1422,34944,21330,-13614
8737,0.0,0.0,0.0,1422,34948,21330,-13618
8738,0.0,0.0,0.0,1422,34952,21330,-13622
8739,0.0,0.0,0.0,1422,34956,21330,-13626
8740,0.0,0.0,0.0,1422,34960,21330,-13630
8741,0.0,0.0,0.0,1422,34964,21330,-13634
8742,0.0,0.0,0.0,1422,34968,21330,-13638
8743,0.0,0.0,0.0,1422,34972,21330,-13642
8744,0.0,0.0,0.0,1422,34976,21330,-13646
8745,0.0,0.0,0.0,1422,34980,21330,-13650
8746,0.0,0.0,0.0,1422,34984,21330,-13654
8747,1.0,0.0,0.2,1423,34988,21345,-13643
8748,1.0,1.0,1.0,1424,34992,21360,-13632
8749,0.0,0.0,0.0,1424,34996,21360,-13636
8750,0.0,0.0,0.0,1424,35000,21360,-13640
8751,0.0,0.0,0.0,1424,35004,21360,-13644
8752,0.0,0.0,0.0,1424,35008,21360,-13648
8753,0.0,0.0,0.0,1424,35012,21360,-13652
8754,0.0,0.0,0.0,1424,35016,21360,-13656
8755,0.0,0.0,0.2,1424,35020,21360,-13660
8756,0.0,0.0,0.0,1424,35024,21360,-13664
8757,0.0,0.0,0.0,1424,35028,21360,-13668
8758,0.0,0.0,0.0,1424,35032,21360,-13672
8759,0.0,0.0,0.0,1424,35036,21360,-13676
8760,0.0,0.0,0.0,1424,35040,21360,-13680
8761,0.0,0.0,0.0,1424,35044,21360,-13684
8762,0.0,0.0,0.0,1424,35048,21360,-13688
8763,0.0,0.0,0.0,1424,35052,21360,-13692
8764,0.0,0.0,0.0,1424,35056,21360,-13696
8765,0.0,0.0,0.0,1424,35060,21360,-13700
8766,0.0,0.0,0.0,1424,35064,21360,-13704
8767,0.0,1.0,0.6666666666666666,1424,35068,21360,-13708
8768,0.0,0.0,0.0,1424,35072,21360,-13712
8769,0.0,0.0,0.0,1424,35076,21360,-13716
8770,1.0,1.0,1.0,1425,35080,21375,-13705
8771,0.0,0.0,0.0,1425,35084,21375,-13709
8772,0.0,0.0,0.0,1425,35088,21375,-13713
8773,0.0,0.0,0.0,1425,35092,21375,-13717
8774,1.0,1.0,1.0,1426,35096,21390,-13706
8775,0.0,0.0,0.3333333333333333,1426,35100,21390,-13710
8776,1.0,1.0,1.0,1427,35104,21405,-13699
8777,0.0,0.0,0.0,1427,35108,21405,-13703
8778,1.0,1.0,1.0,1428,35112,21420,-13692
8779,0.0,0.0,0.0,1428,35116,21420,-13696
8780,0.0,0.0,0.0,1428,35120,21420,-13700
8781,0.0,0.0,0.0,1428,35124,21420,-13704
8782,0.0,0.0,0.0,1428,35128,21420,-13708
8783,1.0,1.0,1.0,1429,35132,21435,-13697
8784,0.0,0.0,0.0,1429,35136,21435,-13701
8785,0.0,0.0,0.0,1429,35140,21435,-13705
8786,0.0,0.0,0.0,1429,35144,21435,-13709
8787,0.0,0.0,0.0,1429,35148,21435,-13713
8788,0.0,0.0,0.4,1429,35152,21435,-13717
8789,0.0,0.0,0.0,1429,35156,21435,-13721
8790,0.0,0.0,0.0,1429,35160,21435,-13725
8791,0.0,0.0,0.0,1429,35164,21435,-13729
8792,0.0,0.0,0.0,1429,35168,21435,-13733
8793,1.0,1.0,1.0,1430,35172,21450,-13722
8794,0.0,0.0,0.0,1430,35176,21450,-13726
8795,0.0,0.0,0.0,1430,35180,21450,-13730
8796,0.0,0.0,0.0,1430,35184,21450,-13734
8797,0.0,0.0,0.0,1430,35188,21450,-13738
8798,1.0,1.0,1.0,1431,35192,21465,-13727
8799,0.0,0.0,0.0,1431,35196,21465,-13731
8800,0.0,0.0,0.0,1431,35200,21465,-13735
8801,0.0,0.0,0.0,1431,35204,21465,-13739
8802,0.0,0.0,0.0,1431,35208,21465,-13743
8803,0.0,0.0,0.0,1431,35212,21465,-13747
8804,0.0,0.0,0.0,1431,35216,21465,-13751
8805,0.0,0.0,0.0,1431,35220,21465,-13755
8806,0.0,0.0,0.0,1431,35224,21465,-13759
8807,0.0,0.0,0.0,1431,35228,21465,-13763
8808,0.0,0.0,0.0,1431,35232,21465,-13767
8809,0.0,0.0,0.0,1431,35236,21465,-13771
8810,0.0,0.0,0.0,1431,35240,21465,-13775
8811,1.0,0.0,0.3333333333333333,1432,35244,21480,-13764
8812,0.0,0.0,0.0,1432,35248,21480,-13768
8813,0.0,0.0,0.0,1432,35252,21480,-13772
8814,1.0,1.0,1.0,1433,35256,21495,-13761
8815,0.0,0.0,0.0,1433,35260,21495,-13765
8816,0.0,0.0,0.0,1433,35264,21495,-13769
8817,0.0,0.0,0.0,1433,35268,21495,-13773
8818,1.0,1.0,1.0,1434,35272,21510,-13762
8819,0.0,0.0,0.0,1434,35276,21510,-13766
8820,1.0,1.0,1.0,1435,35280,21525,-13755
8821,0.0,0.0,0.0,1435,35284,21525,-13759
8822,0.0,0.0,0.0,1435,35288,21525,-13763
8823,0.0,0.0,0.0,1435,35292,21525,-13767
8824,1.0,1.0,1.0,1436,35296,21540,-13756
8825,0.0,0.0,0.0,1436,35300,21540,-13760
8826,1.0,1.0,1.0,1437,35304,21555,-13749
8827,0.0,0.0,0.0,1437,35308,21555,-13753
8828,0.0,0.0,0.0,1437,35312,21555,-13757
8829,0.0,0.0,0.0,1437,35316,21555,-13761
8830,0.0,0.0,0.0,1437,35320,21555,-13765
8831,1.0,0.0,0.3333333333333333,1438,35324,21570,-13754
8832,0.0,0.0,0.0,1438,35328,21570,-13758
8833,1.0,1.0,1.0,1439,35332,21585,-13747
8834,1.0,1.0,1.0,1440,35336,21600,-13736
8835,0.0,0.0,0.0,1440,35340,21600,-13740
8836,0.0,0.0,0.0,1440,35344,21600,-13744
8837,0.0,0.0,0.0,1440,35348,21600,-13748
8838,0.0,0.0,0.3333333333333333,1440,35352,21600,-13752
8839,0.0,0.0,0.0,1440,35356,21600,-13756
8840,0.0,0.0,0.0,1440,35360,21600,-13760
8841,0.0,0.0,0.0,1440,35364,21600,-13764
8842,0.0,0.0,0.0,1440,35368,21600,-13768
8843,0.0,0.0,0.0,1440,35372,21600,-13772
8844,0.0,0.0,0.0,1440,35376,21600,-13776
8845,1.0,1.0,1.0,1441,35380,21615,-13765
8846,0.0,0.0,0.0,1441,35384,21615,-13769
8847,0.0,1.0,0.6666666666666666,1441,35388,21615,-13773
8848,0.0,0.0,0.0,1441,35392,21615,-13777
8849,0.0,0.0,0.3333333333333333,1441,35396,21615,-13781
8850,0.0,0.0,0.0,1441,35400,21615,-13785
8851,0.0,0.0,0.0,1441,35404,21615,-13789
8852,0.0,0.0,0.0,1441,35408,21615,-13793
8853,0.0,0.0,0.0,1441,35412,21615,-13797
8854,0.0,1.0,0.8,1441,35416,21615,-13801
8855,0.0,0.0,0.0,1441,35420,21615,-13805
8856,0.0,0.0,0.0,1441,35424,21615,-13809
8857,0.0,0.0,0.0,1441,35428,21615,-13813
8858,0.0,0.0,0.0,1441,35432,21615,-13817
8859,1.0,1.0,1.0,1442,35436,21630,-13806
8860,0.0,0.0,0.0,1442,35440,21630,-13810
8861,1.0,1.0,0.6666666666666666,1443,35444,21645,-13799
8862,0.0,0.0,0.0,1443,35448,21645,-13803
8863,1.0,1.0,1.0,1444,35452,21660,-13792
8864,0.0,0.0,0.0,1444,35456,21660,-13796
8865,0.0,0.0,0.0,1444,35460,21660,-13800
8866,0.0,0.0,0.0,1444,35464,21660,-13804
8867,0.0,0.0,0.0,1444,35468,21660,-13808
8868,0.0,0.0,0.0,1444,35472,21660,-13812
8869,0.0,0.0,0.0,1444,35476,21660,-13816
8870,0.0,0.0,0.0,1444,35480,21660,-13820
8871,0.0,0.0,0.0,1444,35484,21660,-13824
8872,0.0,1.0,0.8,1444,35488,21660,-13828
8873,0.0,0.0,0.0,1444,35492,21660,-13832
8874,0.0,0.0,0.0,1444,35496,21660,-13836
8875,1.0,1.0,1.0,1445,35500,21675,-13825
8876,0.0,0.0,0.0,1445,35504,21675,-13829
8877,0.0,0.0,0.0,1445,35508,21675,-13833
8878,0.0,0.0,0.0,1445,35512,21675,-13837
8879,0.0,0.0,0.0,1445,35516,21675,-13841
8880,0.0,0.0,0.0,1445,35520,21675,-13845
8881,0.0,0.0,0.0,1445,35524,21675,-13849
8882,0.0,0.0,0.3333333333333333,1445,35528,21675,-13853
8883,0.0,0.0,0.0,1445,35532,21675,-13857
8884,1.0,1.0,1.0,1446,35536,21690,-13846
8885,0.0,0.0,0.0,1446,35540,21690,-13850
8886,1.0,1.0,1.0,1447,35544,21705,-13839
8887,0.0,0.0,0.0,1447,35548,21705,-13843
8888,0.0,0.0,0.0,1447,35552,21705,-13847
8889,0.0,0.0,0.0,1447,35556,21705,-13851
8890,0.0,0.0,0.0,1447,35560,21705,-13855
8891,1.0,1.0,1.0,1448,35564,21720,-13844
8892,0.0,0.0,0.0,1448,35568,21720,-13848
8893,0.0,0.0,0.0,1448,35572,21720,-13852
8894,0.0,0.0,0.4,1448,35576,21720,-13856
8895,1.0,1.0,0.6,1449,35580,21735,-13845
8896,0.0,0.0,0.0,1449,35584,21735,-13849
8897,0.0,0.0,0.0,1449,35588,21735,-13853
8898,0.0,0.0,0.0,1449,35592,21735,-13857
8899,0.0,0.0,0.0,1449,35596,21735,-13861
8900,0.0,0.0,0.0,1449,35600,21735,-13865
8901,0.0,0.0,0.0,1449,35604,21735,-13869
8902,0.0,0.0,0.0,1449,35608,21735,-13873
8903,0.0,0.0,0.0,1449,35612,21735,-13877
8904,0.0,0.0,0.0,1449,35616,21735,-13881
8905,0.0,0.0,0.0,1449,35620,21735,-13885
8906,0.0,0.0,0.0,1449,35624,21735,-13889
8907,0.0,0.0,0.0,1449,35628,21735,-13893
8908,1.0,1.0,1.0,1450,35632,21750,-13882
8909,0.0,0.0,0.0,1450,35636,21750,-13886
8910,0.0,0.0,0.0,1450,35640,21750,-13890
8911,0.0,0.0,0.0,1450,35644,21750,-13894
8912,1.0,1.0,1.0,1451,35648,21765,-13883
8913,0.0,0.0,0.0,1451,35652,21765,-13887
8914,1.0,1.0,1.0,1452,35656,21780,-13876
8915,0.0,0.0,0.0,1452,35660,21780,-13880
8916,0.0,0.0,0.0,1452,35664,21780,-13884
8917,0.0,0.0,0.0,1452,35668,21780,-13888
8918,1.0,1.0,1.0,1453,35672,21795,-13877
8919,1.0,1.0,1.0,1454,35676,21810,-13866
8920,0.0,0.0,0.0,1454,35680,21810,-13870
8921,0.0,0.0,0.0,1454,35684,21810,-13874
8922,0.0,0.0,0.0,1454,35688,21810,-13878
8923,0.0,0.0,0.0,1454,35692,21810,-13882
8924,0.0,0.0,0.0,1454,35696,21810,-13886
8925,0.0,0.0,0.0,1454,35700,21810,-13890
8926,1.0,1.0,1.0,1455,35704,21825,-13879
8927,0.0,0.0,0.0,1455,35708,21825,-13883
8928,0.0,0.0,0.0,1455,35712,21825,-13887
8929,0.0,0.0,0.0,1455,35716,21825,-13891
8930,1.0,1.0,1.0,1456,35720,21840,-13880
8931,0.0,1.0,0.6666666666666666,1456,35724,21840,-13884
8932,0.0,0.0,0.0,1456,35728,21840,-13888
8933,0.0,0.0,0.0,1456,35732,21840,-13892
8934,1.0,1.0,1.0,1457,35736,21855,-13881
8935,0.0,0.0,0.0,1457,35740,21855,-13885
8936,0.0,0.0,0.0,1457,35744,21855,-13889
8937,0.0,0.0,0.0,1457,35748,21855,-13893
8938,0.0,0.0,0.0,1457,35752,21855,-13897
8939,0.0,0.0,0.0,1457,35756,21855,-13901
8940,0.0,0.0,0.0,1457,35760,21855,-13905
8941,0.0,0.0,0.0,1457,35764,21855,-13909
8942,0.0,0.0,0.0,1457,35768,21855,-13913
8943,0.0,0.0,0.0,1457,35772,21855,-13917
8944,0.0,0.0,0.0,1457,35776,21855,-13921
8945,1.0,1.0,1.0,1458,35780,21870,-13910
8946,0.0,0.0,0.0,1458,35784,21870,-13914
8947,0.0,0.0,0.0,1458,35788,21870,-13918
8948,0.0,0.0,0.0,1458,35792,21870,-13922
8949,0.0,0.0,0.0,1458,35796,21870,-13926
8950,0.0,0.0,0.0,1458,35800,21870,-13930
8951,0.0,0.0,0.0,1458,35804,21870,-13934
8952,0.0,0.0,0.0,1458,35808,21870,-13938
8953,0.0,0.0,0.0,1458,35812,21870,-13942
8954,0.0,0.0,0.0,1458,35816,21870,-13946
8955,0.0,0.0,0.0,1458,35820,21870,-13950
8956,0.0,0.0,0.0,1458,35824,21870,-13954
8957,0.0,0.0,0.0,1458,35828,21870,-13958
8958,0.0,0.0,0.0,1458,35832,21870,-13962
8959,1.0,1.0,1.0,1459,35836,21885,-13951
8960,0.0,0.0,0.0,1459,35840,21885,-13955
8961,0.0,0.0,0.0,1459,35844,21885,-13959
8962,0.0,0.0,0.0,1459,35848,21885,-13963
8963,0.0,0.0,0.0,1459,35852,21885,-13967
8964,0.0,0.0,0.0,1459,35856,21885,-13971
8965,0.0,0.0,0.0,1459,35860,21885,-13975
8966,0.0,0.0,0.0,1459,35864,21885,-13979
8967,0.0,0.0,0.0,1459,35868,21885,-13983
8968,0.0,0.0,0.0,1459,35872,21885,-13987
8969,0.0,0.0,0.0,1459,35876,21885,-13991
8970,0.0,0.0,0.0,1459,35880,21885,-13995
8971,0.0,0.0,0.0,1459,35884,21885,-13999
8972,0.0,0.0,0.0,1459,35888,21885,-14003
8973,0.0,0.0,0.0,1459,35892,21885,-14007
8974,0.0,0.0,0.0,1459,35896,21885,-14011
8975,0.0,0.0,0.0,1459,35900,21885,-14015
8976,0.0,0.0,0.0,1459,35904,21885,-14019
8977,1.0,1.0,0.8,1460,35908,21900,-14008
8978,0.0,0.0,0.0,1460,35912,21900,-14012
8979,0.0,0.0,0.0,1460,35916,21900,-14016
8980,1.0,1.0,1.0,1461,35920,21915,-14005
8981,0.0,0.0,0.0,1461,35924,21915,-14009
8982,0.0,0.0,0.0,1461,35928,21915,-14013
8983,0.0,0.0,0.0,1461,35932,21915,-14017
8984,0.0,0.0,0.0,1461,35936,21915,-14021
8985,0.0,0.0,0.0,1461,35940,21915,-14025
8986,0.0,0.0,0.0,1461,35944,21915,-14029
8987,0.0,0.0,0.3333333333333333,1461,35948,21915,-14033
8988,0.0,0.0,0.0,1461,35952,21915,-14037
8989,0.0,0.0,0.0,1461,35956,21915,-14041
8990,0.0,0.0,0.0,1461,35960,21915,-14045
8991,0.0,0.0,0.0,1461,35964,21915,-14049
8992,1.0,1.0,0.75,1462,35968,21930,-14038
8993,0.0,0.0,0.0,1462,35972,21930,-14042
8994,0.0,0.0,0.0,1462,35976,21930,-14046
8995,0.0,0.0,0.0,1462,35980,21930,-14050
8996,0.0,0.0,0.0,1462,35984,21930,-14054
8997,0.0,0.0,0.0,1462,35988,21930,-14058
8998,0.0,0.0,0.0,1462,35992,21930,-14062
8999,0.0,0.0,0.0,1462,35996,21930,-14066
9000,0.0,0.0,0.0,1462,36000,21930,-14070
9001,1.0,0.0,0.5,1463,36004,21945,-14059
9002,0.0,0.0,0.0,1463,36008,21945,-14063
9003,1.0,1.0,1.0,1464,36012,21960,-14052
9004,0.0,0.0,0.0,1464,36016,21960,-14056
9005,0.0,0.0,0.0,1464,36020,21960,-14060
9006,0.0,0.0,0.0,1464,36024,21960,-14064
9007,0.0,0.0,0.0,1464,36028,21960,-14068
9008,0.0,0.0,0.0,1464,36032,21960,-14072
9009,0.0,0.0,0.0,1464,36036,21960,-14076
9010,0.0,0.0,0.0,1464,36040,21960,-14080
9011,1.0,1.0,1.0,1465,36044,21975,-14069
9012,0.0,0.0,0.0,1465,36048,21975,-14073
9013,0.0,0.0,0.0,1465,36052,21975,-14077
9014,0.0,0.0,0.0,1465,36056,21975,-14081
9015,0.0,0.0,0.0,1465,36060,21975,-14085
9016,0.0,0.0,0.0,1465,36064,21975,-14089
9017,1.0,1.0,1.0,1466,36068,21990,-14078
9018,0.0,0.0,0.0,1466,36072,21990,-14082
9019,0.0,0.0,0.0,1466,36076,21990,-14086
9020,1.0,1.0,1.0,1467,36080,22005,-14075
9021,1.0,1.0,0.6666666666666666,1468,36084,22020,-14064
9022,1.0,1.0,1.0,1469,36088,22035,-14053
9023,1.0,1.0,1.0,1470,36092,22050,-14042
9024,1.0,1.0,0.75,1471,36096,22065,-14031
9025,1.0,0.0,0.25,1472,36100,22080,-14020
9026,0.0,0.0,0.0,1472,36104,22080,-14024
9027,0.0,0.0,0.0,1472,36108,22080,-14028
9028,1.0,1.0,1.0,1473,36112,22095,-14017
9029,0.0,0.0,0.0,1473,36116,22095,-14021
9030,0.0,0.0,0.0,1473,36120,22095,-14025
9031,0.0,0.0,0.0,1473,36124,22095,-14029
9032,0.0,0.0,0.0,1473,36128,22095,-14033
9033,0.0,0.0,0.0,1473,36132,22095,-14037
9034,0.0,0.0,0.0,1473,36136,22095,-14041
9035,0.0,0.0,0.0,1473,36140,22095,-14045
9036,1.0,0.0,0.5,1474,36144,22110,-14034
9037,1.0,1.0,1.0,1475,36148,22125,-14023
9038,0.0,0.0,0.0,1475,36152,22125,-14027
9039,0.0,0.0,0.0,1475,36156,22125,-14031
9040,0.0,0.0,0.0,1475,36160,22125,-14035
9041,0.0,0.0,0.0,1475,36164,22125,-14039
9042,0.0,0.0,0.0,1475,36168,22125,-14043
9043,1.0,1.0,1.0,1476,36172,22140,-14032
9044,0.0,0.0,0.0,1476,36176,22140,-14036
9045,1.0,1.0,1.0,1477,36180,22155,-14025
9046,1.0,0.0,0.2,1478,36184,22170,-14014
9047,0.0,0.0,0.0,1478,36188,22170,-14018
9048,0.0,0.0,0.0,1478,36192,22170,-14022
9049,0.0,0.0,0.0,1478,36196,22170,-14026
9050,0.0,0.0,0.0,1478,36200,22170,-14030
9051,0.0,0.0,0.0,1478,36204,22170,-14034
9052,0.0,0.0,0.0,1478,36208,22170,-14038
9053,0.0,0.0,0.0,1478,36212,22170,-14042
9054,0.0,0.0,0.0,1478,36216,22170,-14046
9055,0.0,0.0,0.0,1478,36220,22170,-14050
9056,0.0,0.0,0.0,1478,36224,22170,-14054
9057,0.0,0.0,0.0,1478,36228,22170,-14058
9058,0.0,0.0,0.0,1478,36232,22170,-14062
9059,0.0,0.0,0.0,1478,36236,22170,-14066
9060,0.0,0.0,0.0,1478,36240,22170,-14070
9061,1.0,1.0,1.0,1479,36244,22185,-14059
9062,1.0,1.0,1.0,1480,36248,22200,-14048
9063,0.0,0.0,0.0,1480,36252,22200,-14052
9064,1.0,1.0,1.0,1481,36256,22215,-14041
9065,1.0,1.0,0.6666666666666666,1482,36260,22230,-14030
9066,0.0,0.0,0.0,1482,36264,22230,-14034
9067,1.0,1.0,1.0,1483,36268,22245,-14023
9068,0.0,0.0,0.0,1483,36272,22245,-14027
9069,0.0,0.0,0.0,1483,36276,22245,-14031
9070,1.0,1.0,0.6666666666666666,1484,36280,22260,-14020
9071,0.0,0.0,0.0,1484,36284,22260,-14024
9072,0.0,0.0,0.0,1484,36288,22260,-14028
9073,0.0,0.0,0.0,1484,36292,22260,-14032
9074,0.0,0.0,0.0,1484,36296,22260,-14036
9075,0.0,0.0,0.0,1484,36300,22260,-14040
9076,0.0,0.0,0.0,1484,36304,22260,-14044
9077,0.0,0.0,0.0,1484,36308,22260,-14048
9078,0.0,0.0,0.0,1484,36312,22260,-14052
9079,0.0,0.0,0.0,1484,36316,22260,-14056
9080,1.0,1.0,1.0,1485,36320,22275,-14045
9081,0.0,0.0,0.0,1485,36324,22275,-14049
9082,0.0,0.0,0.0,1485,36328,22275,-14053
9083,0.0,0.0,0.0,1485,36332,22275,-14057
9084,1.0,1.0,1.0,1486,36336,22290,-14046
9085,0.0,0.0,0.0,1486,36340,22290,-14050
9086,0.0,0.0,0.0,1486,36344,22290,-14054
9087,0.0,0.0,0.0,1486,36348,22290,-14058
9088,1.0,1.0,0.75,1487,36352,22305,-14047
9089,0.0,0.0,0.0,1487,36356,22305,-14051
9090,1.0,1.0,1.0,1488,36360,22320,-14040
9091,0.0,0.0,0.0,1488,36364,22320,-14044
9092,1.0,1.0,1.0,1489,36368,22335,-14033
9093,1.0,1.0,1.0,1490,36372,22350,-14022
9094,0.0,0.0,0.0,1490,36376,22350,-14026
9095,0.0,0.0,0.0,1490,36380,22350,-14030
9096,0.0,0.0,0.0,1490,36384,22350,-14034
9097,0.0,0.0,0.0,1490,36388,22350,-14038
9098,0.0,0.0,0.0,1490,36392,22350,-14042
9099,0.0,0.0,0.0,1490,36396,22350,-14046
9100,0.0,0.0,0.0,1490,36400,22350,-14050
9101,0.0,0.0,0.0,1490,36404,22350,-14054
9102,0.0,0.0,0.0,1490,36408,22350,-14058
9103,0.0,0.0,0.0,1490,36412,22350,-14062
9104,0.0,0.0,0.0,1490,36416,22350,-14066
9105,0.0,0.0,0.0,1490,36420,22350,-14070
9106,0.0,0.0,0.0,1490,36424,22350,-14074
9107,1.0,1.0,1.0,1491,36428,22365,-14063
9108,0.0,0.0,0.3333333333333333,1491,36432,22365,-14067
9109,1.0,1.0,1.0,1492,36436,22380,-14056
9110,0.0,0.0,0.0,1492,36440,22380,-14060
9111,1.0,1.0,1.0,1493,36444,22395,-14049
9112,1.0,1.0,1.0,1494,36448,22410,-14038
9113,0.0,0.0,0.0,1494,36452,22410,-14042
9114,0.0,1.0,0.6666666666666666,1494,36456,22410,-14046
9115,0.0,0.0,0.0,1494,36460,22410,-14050
9116,1.0,1.0,1.0,1495,36464,22425,-14039
9117,0.0,0.0,0.0,1495,36468,22425,-14043
9118,0.0,0.0,0.0,1495,36472,22425,-14047
9119,0.0,0.0,0.0,1495,36476,22425,-14051
9120,0.0,0.0,0.0,1495,36480,22425,-14055
9121,1.0,1.0,1.0,1496,36484,22440,-14044
9122,0.0,0.0,0.0,1496,36488,22440,-14048
9123,0.0,0.0,0.0,1496,36492,22440,-14052
9124,0.0,0.0,0.0,1496,36496,22440,-14056
9125,0.0,0.0,0.0,1496,36500,22440,-14060
9126,0.0,0.0,0.25,1496,36504,22440,-14064
9127,0.0,0.0,0.0,1496,36508,22440,-14068
9128,0.0,0.0,0.0,1496,36512,22440,-14072
9129,0.0,0.0,0.0,1496,36516,22440,-14076
9130,1.0,1.0,1.0,1497,36520,22455,-14065
9131,0.0,0.0,0.0,1497,36524,22455,-14069
9132,0.0,0.0,0.0,1497,36528,22455,-14073
9133,0.0,1.0,0.75,1497,36532,22455,-14077
9134,0.0,0.0,0.0,1497,36536,22455,-14081
9135,0.0,0.0,0.3333333333333333,1497,36540,22455,-14085
9136,1.0,1.0,0.6,1498,36544,22470,-14074
9137,0.0,0.0,0.0,1498,36548,22470,-14078
9138,0.0,0.0,0.0,1498,36552,22470,-14082
9139,1.0,1.0,1.0,1499,36556,22485,-14071
9140,0.0,0.0,0.0,1499,36560,22485,-14075
9141,0.0,0.0,0.0,1499,36564,22485,-14079
9142,0.0,0.0,0.4,1499,36568,22485,-14083
9143,0.0,0.0,0.0,1499,36572,22485,-14087
9144,0.0,0.0,0.0,1499,36576,22485,-14091
9145,0.0,0.0,0.0,1499,36580,22485,-14095
9146,0.0,0.0,0.0,1499,36584,22485,-14099
9147,0.0,0.0,0.0,1499,36588,22485,-14103
9148,0.0,0.0,0.0,1499,36592,22485,-14107
9149,0.0,0.0,0.0,1499,36596,22485,-14111
9150,0.0,0.0,0.3333333333333333,1499,36600,22485,-14115
9151,0.0,0.0,0.0,1499,36604,22485,-14119
9152,0.0,0.0,0.0,1499,36608,22485,-14123
9153,1.0,1.0,1.0,1500,36612,22500,-14112
9154,0.0,0.0,0.0,1500,36616,22500,-14116
9155,0.0,0.0,0.0,1500,36620,22500,-14120
9156,0.0,0.0,0.0,1500,36624,22500,-14124
9157,1.0,1.0,1.0,1501,36628,22515,-14113
9158,0.0,0.0,0.0,1501,36632,22515,-14117
9159,1.0,1.0,1.0,1502,36636,22530,-14106
9160,1.0,0.0,0.4,1503,36640,22545,-14095
9161,0.0,1.0,0.6666666666666666,1503,36644,22545,-14099
9162,0.0,0.0,0.0,1503,36648,22545,-14103
9163,0.0,0.0,0.0,1503,36652,22545,-14107
9164,0.0,0.0,0.0,1503,36656,22545,-14111
9165,0.0,0.0,0.0,1503,36660,22545,-14115
9166,0.0,0.0,0.0,1503,36664,22545,-14119
9167,0.0,0.0,0.0,1503,36668,22545,-14123
9168,0.0,0.0,0.0,1503,36672,22545,-14127
9169,0.0,0.0,0.0,1503,36676,22545,-14131
9170,0.0,0.0,0.0,1503,36680,22545,-14135
9171,0.0,0.0,0.0,1503,36684,22545,-14139
9172,0.0,0.0,0.0,1503,36688,22545,-14143
9173,1.0,1.0,1.0,1504,36692,22560,-14132
9174,0.0,0.0,0.0,1504,36696,22560,-14136
9175,0.0,0.0,0.25,1504,36700,22560,-14140
9176,0.0,1.0,0.6666666666666666,1504,36704,22560,-14144
9177,0.0,0.0,0.0,1504,36708,22560,-14148
9178,0.0,0.0,0.0,1504,36712,22560,-14152
9179,0.0,0.0,0.0,1504,36716,22560,-14156
9180,1.0,1.0,1.0,1505,36720,22575,-14145
9181,0.0,0.0,0.0,1505,36724,22575,-14149
9182,0.0,0.0,0.0,1505,36728,22575,-14153
9183,0.0,0.0,0.0,1505,36732,22575,-14157
9184,0.0,0.0,0.0,1505,36736,22575,-14161
9185,1.0,1.0,1.0,1506,36740,22590,-14150
9186,0.0,0.0,0.0,1506,36744,22590,-14154
9187,1.0,1.0,1.0,1507,36748,22605,-14143
9188,0.0,0.0,0.0,1507,36752,22605,-14147
9189,0.0,0.0,0.0,1507,36756,22605,-14151
9190,0.0,0.0,0.0,1507,36760,22605,-14155
9191,0.0,0.0,0.0,1507,36764,22605,-14159
9192,0.0,0.0,0.0,1507,36768,22605,-14163
9193,0.0,0.0,0.0,1507,36772,22605,-14167
9194,0.0,0.0,0.0,1507,36776,22605,-14171
9195,0.0,0.0,0.0,1507,36780,22605,-14175
9196,0.0,0.0,0.0,1507,36784,22605,-14179
9197,0.0,0.0,0.0,1507,36788,22605,-14183
9198,0.0,0.0,0.0,1507,36792,22605,-14187
9199,1.0,1.0,1.0,1508,36796,22620,-14176
9200,1.0,1.0,1.0,1509,36800,22635,-14165
9201,0.0,0.0,0.0,1509,36804,22635,-14169
9202,1.0,1.0,1.0,1510,36808,22650,-14158
9203,0.0,0.0,0.0,1510,36812,22650,-14162
9204,0.0,0.0,0.0,1510,36816,22650,-14166
9205,0.0,0.0,0.0,1510,36820,22650,-14170
9206,0.0,0.0,0.0,1510,36824,22650,-14174
9207,0.0,0.0,0.0,1510,36828,22650,-14178
9208,0.0,0.0,0.0,1510,36832,22650,-14182
9209,0.0,0.0,0.0,1510,36836,22650,-14186
9210,0.0,1.0,0.6666666666666666,1510,36840,22650,-14190
9211,0.0,0.0,0.0,1510,36844,22650,-14194
9212,1.0,1.0,1.0,1511,36848,22665,-14183
9213,0.0,0.0,0.0,1511,36852,22665,-14187
9214,0.0,1.0,0.6666666666666666,1511,36856,22665,-14191
9215,0.0,0.0,0.0,1511,36860,22665,-14195
9216,0.0,0.0,0.0,1511,36864,22665,-14199
9217,0.0,0.0,0.0,1511,36868,22665,-14203
9218,0.0,0.0,0.0,1511,36872,22665,-14207
9219,1.0,1.0,1.0,1512,36876,22680,-14196
9220,0.0,0.0,0.0,1512,36880,22680,-14200
9221,0.0,0.0,0.0,1512,36884,22680,-14204
9222,0.0,0.0,0.0,1512,36888,22680,-14208
9223,0.0,0.0,0.0,1512,36892,22680,-14212
9224,0.0,0.0,0.0,1512,36896,22680,-14216
9225,0.0,0.0,0.0,1512,36900,22680,-14220
9226,0.0,0.0,0.0,1512,36904,22680,-14224
9227,0.0,0.0,0.0,1512,36908,22680,-14228
9228,0.0,0.0,0.0,1512,36912,22680,-14232
9229,0.0,0.0,0.0,1512,36916,22680,-14236
9230,0.0,0.0,0.0,1512,36920,22680,-14240
9231,0.0,0.0,0.0,1512,36924,22680,-14244
9232,1.0,1.0,1.0,1513,36928,22695,-14233
9233,0.0,0.0,0.0,1513,36932,22695,-14237
9234,0.0,0.0,0.0,1513,36936,22695,-14241
9235,0.0,0.0,0.0,1513,36940,22695,-14245
9236,0.0,0.0,0.25,1513,36944,22695,-14249
9237,1.0,1.0,1.0,1514,36948,22710,-14238
9238,0.0,0.0,0.0,1514,36952,22710,-14242
9239,0.0,0.0,0.0,1514,36956,22710,-14246
9240,1.0,1.0,1.0,1515,36960,22725,-14235
9241,0.0,0.0,0.0,1515,36964,22725,-14239
9242,0.0,0.0,0.0,1515,36968,22725,-14243
9243,1.0,1.0,1.0,1516,36972,22740,-14232
9244,0.0,0.0,0.0,1516,36976,22740,-14236
9245,0.0,0.0,0.0,1516,36980,22740,-14240
9246,0.0,0.0,0.0,1516,36984,22740,-14244
9247,0.0,0.0,0.0,1516,36988,22740,-14248
9248,0.0,0.0,0.0,1516,36992,22740,-14252
9249,1.0,1.0,1.0,1517,36996,22755,-14241
9250,1.0,1.0,1.0,1518,37000,22770,-14230
9251,0.0,0.0,0.0,1518,37004,22770,-14234
9252,0.0,0.0,0.0,1518,37008,22770,-14238
9253,0.0,0.0,0.0,1518,37012,22770,-14242
9254,0.0,0.0,0.0,1518,37016,22770,-14246
9255,0.0,0.0,0.0,1518,37020,22770,-14250
9256,0.0,0.0,0.0,1518,37024,22770,-14254
9257,1.0,1.0,1.0,1519,37028,22785,-14243
9258,1.0,1.0,1.0,1520,37032,22800,-14232
9259,0.0,0.0,0.0,1520,37036,22800,-14236
9260,1.0,1.0,1.0,1521,37040,22815,-14225
9261,1.0,1.0,1.0,1522,37044,22830,-14214
9262,0.0,0.0,0.0,1522,37048,22830,-14218
9263,0.0,0.0,0.0,1522,37052,22830,-14222
9264,0.0,0.0,0.0,1522,37056,22830,-14226
9265,0.0,0.0,0.0,1522,37060,22830,-14230
9266,0.0,0.0,0.0,1522,37064,22830,-14234
9267,1.0,0.0,0.4,1523,37068,22845,-14223
9268,0.0,1.0,0.6666666666666666,1523,37072,22845,-14227
9269,0.0,0.0,0.2,1523,37076,22845,-14231
9270,0.0,0.0,0.2,1523,37080,22845,-14235
9271,0.0,0.0,0.0,1523,37084,22845,-14239
9272,0.0,0.0,0.0,1523,37088,22845,-14243
9273,0.0,0.0,0.0,1523,37092,22845,-14247
9274,0.0,0.0,0.0,1523,37096,22845,-14251
9275,0.0,0.0,0.0,1523,37100,22845,-14255
9276,0.0,0.0,0.0,1523,37104,22845,-14259
9277,0.0,0.0,0.0,1523,37108,22845,-14263
9278,1.0,1.0,1.0,1524,37112,22860,-14252
9279,0.0,0.0,0.0,1524,37116,22860,-14256
9280,0.0,0.0,0.0,1524,37120,22860,-14260
9281,0.0,0.0,0.0,1524,37124,22860,-14264
9282,0.0,0.0,0.0,1524,37128,22860,-14268
9283,1.0,1.0,1.0,1525,37132,22875,-14257
9284,0.0,0.0,0.0,1525,37136,22875,-14261
9285,0.0,0.0,0.0,1525,37140,22875,-14265
9286,0.0,1.0,0.6666666666666666,1525,37144,22875,-14269
9287,1.0,1.0,0.6666666666666666,1526,37148,22890,-14258
9288,0.0,0.0,0.0,1526,37152,22890,-14262
9289,0.0,0.0,0.0,1526,37156,22890,-14266
9290,0.0,0.0,0.0,1526,37160,22890,-14270
9291,0.0,0.0,0.0,1526,37164,22890,-14274
9292,0.0,0.0,0.0,1526,37168,22890,-14278
9293,1.0,1.0,1.0,1527,37172,22905,-14267
9294,1.0,1.0,0.6666666666666666,1528,37176,22920,-14256
9295,1.0,0.0,0.3333333333333333,1529,37180,22935,-14245
9296,0.0,0.0,0.0,1529,37184,22935,-14249
9297,0.0,0.0,0.0,1529,37188,22935,-14253
9298,0.0,0.0,0.0,1529,37192,22935,-14257
9299,0.0,0.0,0.0,1529,37196,22935,-14261
9300,0.0,0.0,0.0,1529,37200,22935,-14265
9301,0.0,0.0,0.0,1529,37204,22935,-14269
9302,0.0,0.0,0.0,1529,37208,22935,-14273
9303,1.0,1.0,1.0,1530,37212,22950,-14262
9304,0.0,0.0,0.0,1530,37216,22950,-14266
9305,0.0,0.0,0.0,1530,37220,22950,-14270
9306,1.0,1.0,1.0,1531,37224,22965,-14259
9307,0.0,0.0,0.0,1531,37228,22965,-14263
9308,1.0,1.0,0.6666666666666666,1532,37232,22980,-14252
9309,0.0,0.0,0.0,1532,37236,22980,-14256
9310,1.0,1.0,1.0,1533,37240,22995,-14245
9311,0.0,0.0,0.0,1533,37244,22995,-14249
9312,0.0,0.0,0.0,1533,37248,22995,-14253
9313,0.0,0.0,0.0,1533,37252,22995,-14257
9314,0.0,0.0,0.0,1533,37256,22995,-14261
9315,0.0,0.0,0.2,1533,37260,22995,-14265
9316,0.0,0.0,0.0,1533,37264,22995,-14269
9317,0.0,0.0,0.0,1533,37268,22995,-14273
9318,0.0,0.0,0.0,1533,37272,22995,-14277
9319,1.0,1.0,1.0,1534,37276,23010,-14266
9320,0.0,0.0,0.0,1534,37280,23010,-14270
9321,0.0,0.0,0.0,1534,37284,23010,-14274
9322,0.0,0.0,0.0,1534,37288,23010,-14278
9323,0.0,0.0,0.0,1534,37292,23010,-14282
9324,0.0,0.0,0.0,1534,37296,23010,-14286
9325,0.0,0.0,0.0,1534,37300,23010,-14290
9326,1.0,1.0,1.0,1535,37304,23025,-14279
9327,1.0,0.0,0.4,1536,37308,23040,-14268
9328,1.0,1.0,1.0,1537,37312,23055,-14257
9329,1.0,1.0,1.0,1538,37316,23070,-14246
9330,0.0,0.0,0.0,1538,37320,23070,-14250
9331,1.0,1.0,1.0,1539,37324,23085,-14239
9332,0.0,0.0,0.0,1539,37328,23085,-14243
9333,1.0,1.0,1.0,1540,37332,23100,-14232
9334,1.0,1.0,1.0,1541,37336,23115,-14221
9335,0.0,0.0,0.0,1541,37340,23115,-14225
9336,0.0,0.0,0.0,1541,37344,23115,-14229
9337,1.0,1.0,0.75,1542,37348,23130,-14218
9338,0.0,0.0,0.0,1542,37352,23130,-14222
9339,1.0,0.0,0.3333333333333333,1543,37356,23145,-14211
9340,1.0,1.0,1.0,1544,37360,23160,-14200
9341,1.0,1.0,1.0,1545,37364,23175,-14189
9342,0.0,0.0,0.0,1545,37368,23175,-14193
9343,0.0,0.0,0.0,1545,37372,23175,-14197
9344,1.0,1.0,1.0,1546,37376,23190,-14186
9345,0.0,0.0,0.0,1546,37380,23190,-14190
9346,0.0,0.0,0.0,1546,37384,23190,-14194
9347,0.0,0.0,0.0,1546,37388,23190,-14198
9348,1.0,1.0,1.0,1547,37392,23205,-14187
9349,0.0,0.0,0.0,1547,37396,23205,-14191
9350,1.0,0.0,0.25,1548,37400,23220,-14180
9351,0.0,0.0,0.0,1548,37404,23220,-14184
9352,0.0,0.0,0.0,1548,37408,23220,-14188
9353,0.0,0.0,0.0,1548,37412,23220,-14192
9354,0.0,0.0,0.0,1548,37416,23220,-14196
9355,0.0,0.0,0.0,1548,37420,23220,-14200
9356,0.0,0.0,0.0,1548,37424,23220,-14204
9357,0.0,0.0,0.0,1548,37428,23220,-14208
9358,0.0,0.0,0.0,1548,37432,23220,-14212
9359,0.0,0.0,0.0,1548,37436,23220,-14216
9360,0.0,0.0,0.0,1548,37440,23220,-14220
9361,0.0,0.0,0.0,1548,37444,23220,-14224
9362,0.0,0.0,0.0,1548,37448,23220,-14228
9363,0.0,0.0,0.0,1548,37452,23220,-14232
9364,0.0,0.0,0.0,1548,37456,23220,-14236
9365,0.0,0.0,0.0,1548,37460,23220,-14240
9366,0.0,0.0,0.0,1548,37464,23220,-14244
9367,0.0,0.0,0.0,1548,37468,23220,-14248
9368,0.0,0.0,0.0,1548,37472,23220,-14252
9369,0.0,0.0,0.0,1548,37476,23220,-14256
9370,0.0,0.0,0.0,1548,37480,23220,-14260
9371,0.0,0.0,0.0,1548,37484,23220,-14264
9372,1.0,1.0,1.0,1549,37488,23235,-14253
9373,0.0,0.0,0.0,1549,37492,23235,-14257
9374,0.0,0.0,0.0,1549,37496,23235,-14261
9375,0.0,0.0,0.0,1549,37500,23235,-14265
9376,0.0,0.0,0.5,1549,37504,23235,-14269
9377,0.0,0.0,0.0,1549,37508,23235,-14273
9378,1.0,1.0,1.0,1550,37512,23250,-14262
9379,0.0,0.0,0.0,1550,37516,23250,-14266
9380,0.0,0.0,0.0,1550,37520,23250,-14270
9381,0.0,0.0,0.0,1550,37524,23250,-14274
9382,0.0,0.0,0.0,1550,37528,23250,-14278
9383,0.0,0.0,0.0,1550,37532,23250,-14282
9384,0.0,0.0,0.0,1550,37536,23250,-14286
9385,0.0,0.0,0.5,1550,37540,23250,-14290
9386,0.0,0.0,0.0,1550,37544,23250,-14294
9387,0.0,0.0,0.0,1550,37548,23250,-14298
9388,0.0,0.0,0.0,1550,37552,23250,-14302
9389,0.0,0.0,0.0,1550,37556,23250,-14306
9390,0.0,0.0,0.0,1550,37560,23250,-14310
9391,1.0,1.0,1.0,1551,37564,23265,-14299
9392,0.0,0.0,0.0,1551,37568,23265,-14303
9393,0.0,0.0,0.0,1551,37572,23265,-14307
9394,0.0,0.0,0.25,1551,37576,23265,-14311
9395,1.0,0.0,0.5,1552,37580,23280,-14300
9396,0.0,0.0,0.0,1552,37584,23280,-14304
9397,0.0,0.0,0.0,1552,37588,23280,-14308
9398,0.0,0.0,0.0,1552,37592,23280,-14312
9399,1.0,1.0,1.0,1553,37596,23295,-14301
9400,0.0,0.0,0.0,1553,37600,23295,-14305
9401,0.0,0.0,0.0,1553,37604,23295,-14309
9402,0.0,0.0,0.0,1553,37608,23295,-14313
9403,0.0,0.0,0.0,1553,37612,23295,-14317
9404,1.0,1.0,1.0,1554,37616,23310,-14306
9405,1.0,1.0,1.0,1555,37620,23325,-14295
9406,1.0,1.0,1.0,1556,37624,23340,-14284
9407,1.0,1.0,1.0,1557,37628,23355,-14273
9408,0.0,0.0,0.0,1557,37632,23355,-14277
9409,0.0,0.0,0.0,1557,37636,23355,-14281
9410,0.0,0.0,0.0,1557,37640,23355,-14285
9411,1.0,1.0,1.0,1558,37644,23370,-14274
9412,1.0,1.0,1.0,1559,37648,23385,-14263
9413,0.0,0.0,0.0,1559,37652,23385,-14267
9414,1.0,1.0,1.0,1560,37656,23400,-14256
9415,0.0,0.0,0.0,1560,37660,23400,-14260
9416,1.0,1.0,1.0,1561,37664,23415,-14249
9417,1.0,1.0,1.0,1562,37668,23430,-14238
9418,0.0,0.0,0.0,1562,37672,23430,-14242
9419,1.0,1.0,1.0,1563,37676,23445,-14231
9420,0.0,0.0,0.0,1563,37680,23445,-14235
9421,0.0,0.0,0.0,1563,37684,23445,-14239
9422,0.0,0.0,0.0,1563,37688,23445,-14243
9423,0.0,0.0,0.0,1563,37692,23445,-14247
9424,0.0,0.0,0.0,1563,37696,23445,-14251
9425,0.0,0.0,0.0,1563,37700,23445,-14255
9426,0.0,0.0,0.0,1563,37704,23445,-14259
9427,1.0,1.0,1.0,1564,37708,23460,-14248
9428,0.0,0.0,0.0,1564,37712,23460,-14252
9429,1.0,0.0,0.3333333333333333,1565,37716,23475,-14241
9430,0.0,0.0,0.0,1565,37720,23475,-14245
9431,0.0,0.0,0.0,1565,37724,23475,-14249
9432,0.0,0.0,0.0,1565,37728,23475,-14253
9433,0.0,0.0,0.0,1565,37732,23475,-14257
9434,0.0,0.0,0.0,1565,37736,23475,-14261
9435,0.0,0.0,0.0,1565,37740,23475,-14265
9436,0.0,0.0,0.0,1565,37744,23475,-14269
9437,0.0,0.0,0.0,1565,37748,23475,-14273
9438,1.0,1.0,1.0,1566,37752,23490,-14262
9439,1.0,1.0,1.0,1567,37756,23505,-14251
9440,0.0,0.0,0.0,1567,37760,23505,-14255
9441,1.0,1.0,0.6666666666666666,1568,37764,23520,-14244
9442,0.0,0.0,0.0,1568,37768,23520,-14248
9443,0.0,0.0,0.0,1568,37772,23520,-14252
9444,0.0,0.0,0.0,1568,37776,23520,-14256
9445,0.0,0.0,0.0,1568,37780,23520,-14260
9446,0.0,0.0,0.0,1568,37784,23520,-14264
9447,1.0,1.0,1.0,1569,37788,23535,-14253
9448,0.0,0.0,0.0,1569,37792,23535,-14257
9449,0.0,0.0,0.0,1569,37796,23535,-14261
9450,0.0,0.0,0.0,1569,37800,23535,-14265
9451,0.0,0.0,0.0,1569,37804,23535,-14269
9452,0.0,0.0,0.0,1569,37808,23535,-14273
9453,0.0,0.0,0.0,1569,37812,23535,-14277
9454,0.0,0.0,0.0,1569,37816,23535,-14281
9455,0.0,0.0,0.0,1569,37820,23535,-14285
9456,0.0,0.0,0.0,1569,37824,23535,-14289
9457,0.0,0.0,0.0,1569,37828,23535,-14293
9458,0.0,0.0,0.0,1569,37832,23535,-14297
9459,0.0,0.0,0.0,1569,37836,23535,-14301
9460,0.0,0.0,0.0,1569,37840,23535,-14305
9461,0.0,0.0,0.0,1569,37844,23535,-14309
9462,0.0,0.0,0.0,1569,37848,23535,-14313
9463,1.0,0.0,0.4,1570,37852,23550,-14302
9464,0.0,0.0,0.0,1570,37856,23550,-14306
9465,1.0,1.0,1.0,1571,37860,23565,-14295
9466,0.0,0.0,0.0,1571,37864,23565,-14299
9467,0.0,0.0,0.0,1571,37868,23565,-14303
9468,0.0,0.0,0.0,1571,37872,23565,-14307
9469,0.0,0.0,0.3333333333333333,1571,37876,23565,-14311
9470,0.0,0.0,0.0,1571,37880,23565,-14315
9471,0.0,0.0,0.0,1571,37884,23565,-14319
9472,0.0,0.0,0.0,1571,37888,23565,-14323
9473,0.0,0.0,0.0,1571,37892,23565,-14327
9474,0.0,0.0,0.0,1571,37896,23565,-14331
9475,0.0,0.0,0.0,1571,37900,23565,-14335
9476,0.0,0.0,0.0,1571,37904,23565,-14339
9477,0.0,0.0,0.0,1571,37908,23565,-14343
9478,0.0,0.0,0.0,1571,37912,23565,-14347
9479,1.0,0.0,0.4,1572,37916,23580,-14336
9480,0.0,0.0,0.0,1572,37920,23580,-14340
9481,0.0,0.0,0.0,1572,37924,23580,-14344
9482,1.0,0.0,0.25,1573,37928,23595,-14333
9483,0.0,0.0,0.0,1573,37932,23595,-14337
9484,0.0,0.0,0.0,1573,37936,23595,-14341
9485,0.0,0.0,0.0,1573,37940,23595,-14345
9486,0.0,0.0,0.0,1573,37944,23595,-14349
9487,0.0,0.0,0.0,1573,37948,23595,-14353
9488,0.0,0.0,0.0,1573,37952,23595,-14357
9489,0.0,0.0,0.0,1573,37956,23595,-14361
9490,0.0,0.0,0.0,1573,37960,23595,-14365
9491,0.0,0.0,0.0,1573,37964,23595,-14369
9492,1.0,1.0,1.0,1574,37968,23610,-14358
9493,0.0,0.0,0.0,1574,37972,23610,-14362
9494,0.0,0.0,0.0,1574,37976,23610,-14366
9495,1.0,1.0,1.0,1575,37980,23625,-14355
9496,0.0,0.0,0.0,1575,37984,23625,-14359
9497,0.0,0.0,0.0,1575,37988,23625,-14363
9498,0.0,0.0,0.0,1575,37992,23625,-14367
9499,0.0,0.0,0.0,1575,37996,23625,-14371
9500,0.0,0.0,0.0,1575,38000,23625,-14375
9501,1.0,1.0,1.0,1576,38004,23640,-14364
9502,0.0,0.0,0.0,1576,38008,23640,-14368
9503,0.0,0.0,0.0,1576,38012,23640,-14372
9504,0.0,0.0,0.0,1576,38016,23640,-14376
9505,0.0,0.0,0.0,1576,38020,23640,-14380
9506,0.0,0.0,0.0,1576,38024,23640,-14384
9507,0.0,0.0,0.0,1576,38028,23640,-14388
9508,0.0,0.0,0.4,1576,38032,23640,-14392
9509,1.0,1.0,1.0,1577,38036,23655,-14381
9510,0.0,0.0,0.0,1577,38040,23655,-14385
9511,0.0,0.0,0.0,1577,38044,23655,-14389
9512,0.0,0.0,0.0,1577,38048,23655,-14393
9513,0.0,0.0,0.0,1577,38052,23655,-14397
9514,0.0,0.0,0.0,1577,38056,23655,-14401
9515,1.0,1.0,1.0,1578,38060,23670,-14390
9516,0.0,0.0,0.0,1578,38064,23670,-14394
9517,0.0,0.0,0.0,1578,38068,23670,-14398
9518,1.0,1.0,1.0,1579,38072,23685,-14387
9519,0.0,0.0,0.0,1579,38076,23685,-14391
9520,0.0,0.0,0.0,1579,38080,23685,-14395
9521,0.0,0.0,0.0,1579,38084,23685,-14399
9522,0.0,0.0,0.0,1579,38088,23685,-14403
9523,0.0,0.0,0.0,1579,38092,23685,-14407
9524,0.0,0.0,0.0,1579,38096,23685,-14411
9525,0.0,0.0,0.3333333333333333,1579,38100,23685,-14415
9526,0.0,0.0,0.0,1579,38104,23685,-14419
9527,0.0,0.0,0.0,1579,38108,23685,-14423
9528,0.0,0.0,0.0,1579,38112,23685,-14427
9529,0.0,0.0,0.0,1579,38116,23685,-14431
9530,0.0,0.0,0.0,1579,38120,23685,-14435
9531,0.0,0.0,0.5,1579,38124,23685,-14439
9532,0.0,0.0,0.3333333333333333,1579,38128,23685,-14443
9533,0.0,0.0,0.0,1579,38132,23685,-14447
9534,0.0,0.0,0.0,1579,38136,23685,-14451
9535,0.0,0.0,0.0,1579,38140,23685,-14455
9536,0.0,0.0,0.0,1579,38144,23685,-14459
9537,1.0,1.0,1.0,1580,38148,23700,-14448
9538,0.0,0.0,0.0,1580,38152,23700,-14452
9539,0.0,0.0,0.0,1580,38156,23700,-14456
9540,1.0,0.0,0.3333333333333333,1581,38160,23715,-14445
9541,0.0,0.0,0.0,1581,38164,23715,-14449
9542,1.0,1.0,1.0,1582,38168,23730,-14438
9543,0.0,0.0,0.0,1582,38172,23730,-14442
9544,0.0,0.0,0.0,1582,38176,23730,-14446
9545,0.0,0.0,0.0,1582,38180,23730,-14450
9546,0.0,0.0,0.0,1582,38184,23730,-14454
9547,0.0,0.0,0.0,1582,38188,23730,-14458
9548,1.0,1.0,1.0,1583,38192,23745,-14447
9549,0.0,0.0,0.0,1583,38196,23745,-14451
9550,0.0,0.0,0.0,1583,38200,23745,-14455
9551,0.0,0.0,0.0,1583,38204,23745,-14459
9552,1.0,1.0,0.6666666666666666,1584,38208,23760,-14448
9553,0.0,0.0,0.0,1584,38212,23760,-14452
9554,0.0,0.0,0.0,1584,38216,23760,-14456
9555,0.0,0.0,0.0,1584,38220,23760,-14460
9556,0.0,0.0,0.0,1584,38224,23760,-14464
9557,0.0,0.0,0.0,1584,38228,23760,-14468
9558,0.0,0.0,0.0,1584,38232,23760,-14472
9559,0.0,0.0,0.0,1584,38236,23760,-14476
9560,0.0,1.0,0.6,1584,38240,23760,-14480
9561,0.0,0.0,0.0,1584,38244,23760,-14484
9562,0.0,0.0,0.0,1584,38248,23760,-14488
9563,0.0,0.0,0.0,1584,38252,23760,-14492
9564,0.0,0.0,0.0,1584,38256,23760,-14496
9565,0.0,0.0,0.0,1584,38260,23760,-14500
9566,0.0,0.0,0.0,1584,38264,23760,-14504
9567,0.0,0.0,0.0,1584,38268,23760,-14508
9568,0.0,0.0,0.0,1584,38272,23760,-14512
9569,0.0,0.0,0.0,1584,38276,23760,-14516
9570,0.0,0.0,0.0,1584,38280,23760,-14520
9571,1.0,1.0,1.0,1585,38284,23775,-14509
9572,0.0,0.0,0.0,1585,38288,23775,-14513
9573,0.0,0.0,0.0,1585,38292,23775,-14517
9574,0.0,0.0,0.0,1585,38296,23775,-14521
9575,0.0,0.0,0.0,1585,38300,23775,-14525
9576,0.0,0.0,0.0,1585,38304,23775,-14529
9577,0.0,0.0,0.0,1585,38308,23775,-14533
9578,0.0,0.0,0.0,1585,38312,23775,-14537
9579,1.0,1.0,1.0,1586,38316,23790,-14526
9580,0.0,0.0,0.25,1586,38320,23790,-14530
9581,0.0,0.0,0.0,1586,38324,23790,-14534
9582,0.0,0.0,0.0,1586,38328,23790,-14538
9583,0.0,0.0,0.0,1586,38332,23790,-14542
9584,0.0,0.0,0.0,1586,38336,23790,-14546
9585,0.0,0.0,0.0,1586,38340,23790,-14550
9586,1.0,1.0,1.0,1587,38344,23805,-14539
9587,0.0,0.0,0.0,1587,38348,23805,-14543
9588,0.0,0.0,0.0,1587,38352,23805,-14547
9589,0.0,0.0,0.0,1587,38356,23805,-14551
9590,0.0,0.0,0.0,1587,38360,23805,-14555
9591,0.0,0.0,0.0,1587,38364,23805,-14559
9592,0.0,0.0,0.0,1587,38368,23805,-14563
9593,0.0,0.0,0.0,1587,38372,23805,-14567
9594,0.0,0.0,0.0,1587,38376,23805,-14571
9595,0.0,0.0,0.0,1587,38380,23805,-14575
9596,0.0,0.0,0.0,1587,38384,23805,-14579
9597,0.0,0.0,0.0,1587,38388,23805,-14583
9598,0.0,0.0,0.0,1587,38392,23805,-14587
9599,0.0,0.0,0.0,1587,38396,23805,-14591
9600,0.0,0.0,0.0,1587,38400,23805,-14595
9601,0.0,0.0,0.0,1587,38404,23805,-14599
9602,0.0,0.0,0.0,1587,38408,23805,-14603
9603,0.0,0.0,0.0,1587,38412,23805,-14607
9604,0.0,0.0,0.0,1587,38416,23805,-14611
9605,0.0,0.0,0.0,1587,38420,23805,-14615
9606,0.0,0.0,0.4,1587,38424,23805,-14619
9607,1.0,1.0,1.0,1588,38428,23820,-14608
9608,0.0,0.0,0.0,1588,38432,23820,-14612
9609,0.0,0.0,0.0,1588,38436,23820,-14616
9610,0.0,0.0,0.0,1588,38440,23820,-14620
9611,0.0,0.0,0.0,1588,38444,23820,-14624
9612,0.0,0.0,0.0,1588,38448,23820,-14628
9613,1.0,1.0,1.0,1589,38452,23835,-14617
9614,0.0,0.0,0.0,1589,38456,23835,-14621
9615,0.0,0.0,0.0,1589,38460,23835,-14625
9616,0.0,0.0,0.0,1589,38464,23835,-14629
9617,1.0,1.0,1.0,1590,38468,23850,-14618
9618,0.0,0.0,0.0,1590,38472,23850,-14622
9619,0.0,0.0,0.0,1590,38476,23850,-14626
9620,0.0,0.0,0.0,1590,38480,23850,-14630
9621,0.0,0.0,0.0,1590,38484,23850,-14634
9622,0.0,0.0,0.0,1590,38488,23850,-14638
9623,0.0,0.0,0.0,1590,38492,23850,-14642
9624,0.0,0.0,0.0,1590,38496,23850,-14646
9625,0.0,0.0,0.0,1590,38500,23850,-14650
9626,0.0,1.0,0.6,1590,38504,23850,-14654
9627,1.0,1.0,1.0,1591,38508,23865,-14643
9628,0.0,0.0,0.0,1591,38512,23865,-14647
9629,0.0,0.0,0.0,1591,38516,23865,-14651
9630,0.0,0.0,0.0,1591,38520,23865,-14655
9631,0.0,0.0,0.0,1591,38524,23865,-14659
9632,0.0,0.0,0.0,1591,38528,23865,-14663
9633,0.0,0.0,0.0,1591,38532,23865,-14667
9634,0.0,0.0,0.0,1591,38536,23865,-14671
9635,0.0,0.0,0.0,1591,38540,23865,-14675
9636,1.0,1.0,1.0,1592,38544,23880,-14664
9637,0.0,0.0,0.0,1592,38548,23880,-14668
9638,1.0,1.0,1.0,1593,38552,23895,-14657
9639,0.0,0.0,0.0,1593,38556,23895,-14661
9640,0.0,0.0,0.0,1593,38560,23895,-14665
9641,0.0,0.0,0.0,1593,38564,23895,-14669
9642,0.0,0.0,0.0,1593,38568,23895,-14673
9643,0.0,0.0,0.0,1593,38572,23895,-14677
9644,0.0,0.0,0.0,1593,38576,23895,-14681
9645,0.0,0.0,0.0,1593,38580,23895,-14685
9646,0.0,0.0,0.0,1593,38584,23895,-14689
9647,0.0,0.0,0.0,1593,38588,23895,-14693
9648,0.0,0.0,0.0,1593,38592,23895,-14697
9649,0.0,0.0,0.0,1593,38596,23895,-14701
9650,1.0,0.0,0.3333333333333333,1594,38600,23910,-14690
9651,0.0,0.0,0.0,1594,38604,23910,-14694
9652,0.0,0.0,0.4,1594,38608,23910,-14698
9653,0.0,0.0,0.0,1594,38612,23910,-14702
9654,1.0,1.0,1.0,1595,38616,23925,-14691
9655,0.0,0.0,0.0,1595,38620,23925,-14695
9656,0.0,0.0,0.0,1595,38624,23925,-14699
9657,0.0,0.0,0.0,1595,38628,23925,-14703
9658,1.0,1.0,1.0,1596,38632,23940,-14692
9659,0.0,0.0,0.0,1596,38636,23940,-14696
9660,0.0,0.0,0.0,1596,38640,23940,-14700
9661,0.0,0.0,0.0,1596,38644,23940,-14704
9662,0.0,0.0,0.0,1596,38648,23940,-14708
9663,0.0,0.0,0.0,1596,38652,23940,-14712
9664,0.0,0.0,0.0,1596,38656,23940,-14716
9665,0.0,0.0,0.0,1596,38660,23940,-14720
9666,0.0,0.0,0.0,1596,38664,23940,-14724
9667,1.0,1.0,1.0,1597,38668,23955,-14713
9668,1.0,1.0,1.0,1598,38672,23970,-14702
9669,1.0,0.0,0.3333333333333333,1599,38676,23985,-14691
9670,1.0,1.0,1.0,1600,38680,24000,-14680
9671,0.0,0.0,0.0,1600,38684,24000,-14684
9672,1.0,1.0,1.0,1601,38688,24015,-14673
9673,0.0,0.0,0.0,1601,38692,24015,-14677
9674,0.0,0.0,0.0,1601,38696,24015,-14681
9675,0.0,0.0,0.0,1601,38700,24015,-14685
9676,0.0,0.0,0.0,1601,38704,24015,-14689
9677,0.0,0.0,0.0,1601,38708,24015,-14693
9678,0.0,0.0,0.0,1601,38712,24015,-14697
9679,0.0,0.0,0.0,1601,38716,24015,-14701
9680,0.0,0.0,0.0,1601,38720,24015,-14705
9681,1.0,1.0,1.0,1602,38724,24030,-14694
9682,0.0,0.0,0.0,1602,38728,24030,-14698
9683,0.0,0.0,0.0,1602,38732,24030,-14702
9684,0.0,0.0,0.0,1602,38736,24030,-14706
9685,0.0,0.0,0.0,1602,38740,24030,-14710
9686,0.0,0.0,0.0,1602,38744,24030,-14714
9687,1.0,1.0,1.0,1603,38748,24045,-14703
9688,0.0,0.0,0.0,1603,38752,24045,-14707
9689,0.0,0.0,0.0,1603,38756,24045,-14711
9690,0.0,0.0,0.0,1603,38760,24045,-14715
9691,0.0,0.0,0.0,1603,38764,24045,-14719
9692,0.0,0.0,0.0,1603,38768,24045,-14723
9693,0.0,0.0,0.0,1603,38772,24045,-14727
9694,0.0,0.0,0.0,1603,38776,24045,-14731
9695,0.0,0.0,0.0,1603,38780,24045,-14735
9696,0.0,0.0,0.0,1603,38784,24045,-14739
9697,1.0,1.0,1.0,1604,38788,24060,-14728
9698,0.0,0.0,0.0,1604,38792,24060,-14732
9699,0.0,0.0,0.0,1604,38796,24060,-14736
9700,0.0,0.0,0.0,1604,38800,24060,-14740
9701,0.0,0.0,0.0,1604,38804,24060,-14744
9702,0.0,0.0,0.3333333333333333,1604,38808,24060,-14748
9703,1.0,1.0,1.0,1605,38812,24075,-14737
9704,0.0,0.0,0.0,1605,38816,24075,-14741
9705,0.0,0.0,0.0,1605,38820,24075,-14745
9706,0.0,0.0,0.0,1605,38824,24075,-14749
9707,0.0,0.0,0.0,1605,38828,24075,-14753
9708,0.0,0.0,0.4,1605,38832,24075,-14757
9709,0.0,0.0,0.0,1605,38836,24075,-14761
9710,0.0,0.0,0.0,1605,38840,24075,-14765
9711,0.0,0.0,0.0,1605,38844,24075,-14769
9712,0.0,0.0,0.0,1605,38848,24075,-14773
9713,0.0,0.0,0.0,1605,38852,24075,-14777
9714,0.0,0.0,0.0,1605,38856,24075,-14781
9715,0.0,0.0,0.0,1605,38860,24075,-14785
9716,0.0,0.0,0.0,1605,38864,24075,-14789
9717,0.0,0.0,0.0,1605,38868,24075,-14793
9718,0.0,0.0,0.0,1605,38872,24075,-14797
9719,1.0,1.0,1.0,1606,38876,24090,-14786
9720,0.0,0.0,0.0,1606,38880,24090,-14790
9721,0.0,0.0,0.0,1606,38884,24090,-14794
9722,0.0,0.0,0.0,1606,38888,24090,-14798
9723,0.0,0.0,0.0,1606,38892,24090,-14802
9724,0.0,0.0,0.0,1606,38896,24090,-14806
9725,0.0,0.0,0.0,1606,38900,24090,-14810
9726,0.0,0.0,0.0,1606,38904,24090,-14814
9727,0.0,0.0,0.0,1606,38908,24090,-14818
9728,0.0,0.0,0.0,1606,38912,24090,-14822
9729,0.0,0.0,0.0,1606,38916,24090,-14826
9730,0.0,0.0,0.0,1606,38920,24090,-14830
9731,0.0,0.0,0.0,1606,38924,24090,-14834
9732,0.0,0.0,0.0,1606,38928,24090,-14838
9733,0.0,0.0,0.0,1606,38932,24090,-14842
9734,0.0,0.0,0.0,1606,38936,24090,-14846
9735,0.0,0.0,0.0,1606,38940,24090,-14850
9736,0.0,0.0,0.0,1606,38944,24090,-14854
9737,0.0,0.0,0.0,1606,38948,24090,-14858
9738,0.0,0.0,0.0,1606,38952,24090,-14862
9739,0.0,0.0,0.0,1606,38956,24090,-14866
9740,0.0,0.0,0.0,1606,38960,24090,-14870
9741,1.0,1.0,0.6666666666666666,1607,38964,24105,-14859
9742,1.0,1.0,1.0,1608,38968,24120,-14848
9743,1.0,1.0,1.0,1609,38972,24135,-14837
9744,0.0,0.0,0.0,1609,38976,24135,-14841
9745,0.0,0.0,0.0,1609,38980,24135,-14845
9746,0.0,0.0,0.0,1609,38984,24135,-14849
9747,0.0,0.0,0.0,1609,38988,24135,-14853
9748,0.0,0.0,0.0,1609,38992,24135,-14857
9749,0.0,0.0,0.4,1609,38996,24135,-14861
9750,0.0,0.0,0.0,1609,39000,24135,-14865
9751,0.0,0.0,0.0,1609,39004,24135,-14869
9752,0.0,0.0,0.0,1609,39008,24135,-14873
9753,0.0,1.0,0.6666666666666666,1609,39012,24135,-14877
9754,0.0,0.0,0.0,1609,39016,24135,-14881
9755,1.0,1.0,1.0,1610,39020,24150,-14870
9756,0.0,0.0,0.0,1610,39024,24150,-14874
9757,0.0,0.0,0.0,1610,39028,24150,-14878
9758,0.0,0.0,0.4,1610,39032,24150,-14882
9759,0.0,0.0,0.0,1610,39036,24150,-14886
9760,0.0,0.0,0.0,1610,39040,24150,-14890
9761,0.0,0.0,0.0,1610,39044,24150,-14894
9762,1.0,0.0,0.3333333333333333,1611,39048,24165,-14883
9763,0.0,0.0,0.0,1611,39052,24165,-14887
9764,0.0,0.0,0.0,1611,39056,24165,-14891
9765,0.0,0.0,0.0,1611,39060,24165,-14895
9766,0.0,0.0,0.0,1611,39064,24165,-14899
9767,0.0,0.0,0.25,1611,39068,24165,-14903
9768,0.0,0.0,0.0,1611,39072,24165,-14907
9769,0.0,0.0,0.0,1611,39076,24165,-14911
9770,0.0,0.0,0.0,1611,39080,24165,-14915
9771,0.0,0.0,0.0,1611,39084,24165,-14919
9772,0.0,0.0,0.0,1611,39088,24165,-14923
9773,0.0,0.0,0.0,1611,39092,24165,-14927
9774,0.0,0.0,0.0,1611,39096,24165,-14931
9775,0.0,0.0,0.0,1611,39100,24165,-14935
9776,0.0,0.0,0.0,1611,39104,24165,-14939
9777,0.0,0.0,0.0,1611,39108,24165,-14943
9778,1.0,1.0,1.0,1612,39112,24180,-14932
9779,0.0,0.0,0.0,1612,39116,24180,-14936
9780,0.0,0.0,0.0,1612,39120,24180,-14940
9781,0.0,0.0,0.0,1612,39124,24180,-14944
9782,1.0,1.0,1.0,1613,39128,24195,-14933
9783,1.0,1.0,1.0,1614,39132,24210,-14922
9784,0.0,0.0,0.3333333333333333,1614,39136,24210,-14926
9785,1.0,1.0,1.0,1615,39140,24225,-14915
9786,0.0,0.0,0.0,1615,39144,24225,-14919
9787,0.0,1.0,0.6666666666666666,1615,39148,24225,-14923
9788,0.0,0.0,0.3333333333333333,1615,39152,24225,-14927
9789,0.0,0.0,0.0,1615,39156,24225,-14931
9790,0.0,0.0,0.0,1615,39160,24225,-14935
9791,1.0,1.0,0.75,1616,39164,24240,-14924
9792,0.0,0.0,0.0,1616,39168,24240,-14928
9793,0.0,0.0,0.0,1616,39172,24240,-14932
9794,0.0,0.0,0.0,1616,39176,24240,-14936
9795,0.0,0.0,0.0,1616,39180,24240,-14940
9796,0.0,0.0,0.0,1616,39184,24240,-14944
9797,0.0,0.0,0.0,1616,39188,24240,-14948
9798,1.0,1.0,0.6666666666666666,1617,39192,24255,-14937
9799,1.0,1.0,1.0,1618,39196,24270,-14926
9800,0.0,0.0,0.0,1618,39200,24270,-14930
9801,0.0,0.0,0.0,1618,39204,24270,-14934
9802,0.0,0.0,0.0,1618,39208,24270,-14938
9803,0.0,0.0,0.0,1618,39212,24270,-14942
9804,0.0,0.0,0.0,1618,39216,24270,-14946
9805,0.0,0.0,0.0,1618,39220,24270,-14950
9806,0.0,0.0,0.0,1618,39224,24270,-14954
9807,0.0,0.0,0.0,1618,39228,24270,-14958
9808,0.0,0.0,0.0,1618,39232,24270,-14962
9809,0.0,0.0,0.0,1618,39236,24270,-14966
9810,0.0,0.0,0.0,1618,39240,24270,-14970
9811,0.0,0.0,0.0,1618,39244,24270,-14974
9812,0.0,0.0,0.0,1618,39248,24270,-14978
9813,0.0,0.0,0.0,1618,39252,24270,-14982
9814,0.0,0.0,0.0,1618,39256,24270,-14986
9815,1.0,1.0,0.8,1619,39260,24285,-14975
9816,0.0,0.0,0.0,1619,39264,24285,-14979
9817,0.0,0.0,0.0,1619,39268,24285,-14983
9818,1.0,1.0,1.0,1620,39272,24300,-14972
9819,0.0,0.0,0.0,1620,39276,24300,-14976
9820,0.0,0.0,0.0,1620,39280,24300,-14980
9821,0.0,0.0,0.0,1620,39284,24300,-14984
9822,1.0,1.0,1.0,1621,39288,24315,-14973
9823,0.0,0.0,0.0,1621,39292,24315,-14977
9824,0.0,0.0,0.0,1621,39296,24315,-14981
9825,0.0,0.0,0.0,1621,39300,24315,-14985
9826,0.0,0.0,0.0,1621,39304,24315,-14989
9827,1.0,1.0,1.0,1622,39308,24330,-14978
9828,0.0,0.0,0.0,1622,39312,24330,-14982
9829,0.0,0.0,0.0,1622,39316,24330,-14986
9830,0.0,0.0,0.0,1622,39320,24330,-14990
9831,0.0,0.0,0.25,1622,39324,24330,-14994
9832,0.0,0.0,0.0,1622,39328,24330,-14998
9833,0.0,0.0,0.0,1622,39332,24330,-15002
9834,0.0,0.0,0.0,1622,39336,24330,-15006
9835,0.0,0.0,0.0,1622,39340,24330,-15010
9836,1.0,1.0,0.6666666666666666,1623,39344,24345,-14999
9837,0.0,0.0,0.0,1623,39348,24345,-15003
9838,0.0,0.0,0.0,1623,39352,24345,-15007
9839,0.0,0.0,0.0,1623,39356,24345,-15011
9840,0.0,0.0,0.4,1623,39360,24345,-15015
9841,0.0,0.0,0.0,1623,39364,24345,-15019
9842,0.0,0.0,0.0,1623,39368,24345,-15023
9843,0.0,0.0,0.0,1623,39372,24345,-15027
9844,0.0,0.0,0.0,1623,39376,24345,-15031
9845,1.0,1.0,1.0,1624,39380,24360,-15020
9846,0.0,0.0,0.0,1624,39384,24360,-15024
9847,0.0,0.0,0.0,1624,39388,24360,-15028
9848,0.0,0.0,0.0,1624,39392,24360,-15032
9849,0.0,0.0,0.0,1624,39396,24360,-15036
9850,0.0,0.0,0.0,1624,39400,24360,-15040
9851,0.0,0.0,0.0,1624,39404,24360,-15044
9852,0.0,0.0,0.0,1624,39408,24360,-15048
9853,1.0,1.0,1.0,1625,39412,24375,-15037
9854,0.0,0.0,0.0,1625,39416,24375,-15041
9855,0.0,1.0,0.6666666666666666,1625,39420,24375,-15045
9856,0.0,0.0,0.0,1625,39424,24375,-15049
9857,0.0,0.0,0.0,1625,39428,24375,-15053
9858,0.0,0.0,0.0,1625,39432,24375,-15057
9859,0.0,0.0,0.0,1625,39436,24375,-15061
9860,0.0,0.0,0.0,1625,39440,24375,-15065
9861,1.0,1.0,1.0,1626,39444,24390,-15054
9862,0.0,0.0,0.0,1626,39448,24390,-15058
9863,0.0,0.0,0.0,1626,39452,24390,-15062
9864,0.0,0.0,0.0,1626,39456,24390,-15066
9865,1.0,1.0,0.75,1627,39460,24405,-15055
9866,0.0,0.0,0.0,1627,39464,24405,-15059
9867,1.0,1.0,1.0,1628,39468,24420,-15048
9868,0.0,0.0,0.0,1628,39472,24420,-15052
9869,0.0,0.0,0.0,1628,39476,24420,-15056
9870,1.0,1.0,1.0,1629,39480,24435,-15045
9871,0.0,0.0,0.0,1629,39484,24435,-15049
9872,1.0,1.0,1.0,1630,39488,24450,-15038
9873,0.0,0.0,0.0,1630,39492,24450,-15042
9874,0.0,0.0,0.0,1630,39496,24450,-15046
9875,0.0,0.0,0.0,1630,39500,24450,-15050
9876,0.0,0.0,0.0,1630,39504,24450,-15054
9877,0.0,0.0,0.0,1630,39508,24450,-15058
9878,1.0,1.0,1.0,1631,39512,24465,-15047
9879,1.0,1.0,1.0,1632,39516,24480,-15036
9880,1.0,1.0,1.0,1633,39520,24495,-15025
9881,1.0,1.0,1.0,1634,39524,24510,-15014
9882,1.0,1.0,1.0,1635,39528,24525,-15003
9883,0.0,0.0,0.0,1635,39532,24525,-15007
9884,1.0,0.0,0.5,1636,39536,24540,-14996
9885,1.0,1.0,1.0,1637,39540,24555,-14985
9886,0.0,0.0,0.0,1637,39544,24555,-14989
9887,0.0,0.0,0.0,1637,39548,24555,-14993
9888,1.0,1.0,1.0,1638,39552,24570,-14982
9889,0.0,0.0,0.0,1638,39556,24570,-14986
9890,0.0,0.0,0.0,1638,39560,24570,-14990
9891,0.0,0.0,0.0,1638,39564,24570,-14994
9892,1.0,1.0,1.0,1639,39568,24585,-14983
9893,0.0,0.0,0.0,1639,39572,24585,-14987
9894,0.0,0.0,0.0,1639,39576,24585,-14991
9895,0.0,0.0,0.0,1639,39580,24585,-14995
9896,0.0,0.0,0.0,1639,39584,24585,-14999
9897,0.0,0.0,0.0,1639,39588,24585,-15003
9898,0.0,0.0,0.0,1639,39592,24585,-15007
9899,0.0,0.0,0.0,1639,39596,24585,-15011
9900,0.0,0.0,0.0,1639,39600,24585,-15015
9901,0.0,0.0,0.0,1639,39604,24585,-15019
9902,0.0,0.0,0.0,1639,39608,24585,-15023
9903,0.0,0.0,0.0,1639,39612,24585,-15027
9904,0.0,0.0,0.0,1639,39616,24585,-15031
9905,0.0,0.0,0.0,1639,39620,24585,-15035
9906,0.0,0.0,0.0,1639,39624,24585,-15039
9907,1.0,0.0,0.3333333333333333,1640,39628,24600,-15028
9908,0.0,0.0,0.0,1640,39632,24600,-15032
9909,0.0,0.0,0.0,1640,39636,24600,-15036
9910,0.0,0.0,0.0,1640,39640,24600,-15040
9911,0.0,0.0,0.0,1640,39644,24600,-15044
9912,1.0,1.0,1.0,1641,39648,24615,-15033
9913,0.0,0.0,0.0,1641,39652,24615,-15037
9914,0.0,0.0,0.0,1641,39656,24615,-15041
9915,0.0,0.0,0.0,1641,39660,24615,-15045
9916,0.0,0.0,0.0,1641,39664,24615,-15049
9917,1.0,1.0,0.6,1642,39668,24630,-15038
9918,1.0,1.0,1.0,1643,39672,24645,-15027
9919,0.0,0.0,0.0,1643,39676,24645,-15031
9920,0.0,0.0,0.0,1643,39680,24645,-15035
9921,0.0,0.0,0.0,1643,39684,24645,-15039
9922,0.0,0.0,0.0,1643,39688,24645,-15043
9923,1.0,1.0,1.0,1644,39692,24660,-15032
9924,0.0,0.0,0.0,1644,39696,24660,-15036
9925,0.0,0.0,0.0,1644,39700,24660,-15040
9926,1.0,1.0,0.6666666666666666,1645,39704,24675,-15029
9927,0.0,0.0,0.0,1645,39708,24675,-15033
9928,0.0,0.0,0.0,1645,39712,24675,-15037
9929,1.0,1.0,0.6,1646,39716,24690,-15026
9930,0.0,0.0,0.3333333333333333,1646,39720,24690,-15030
9931,0.0,0.0,0.0,1646,39724,24690,-15034
9932,0.0,0.0,0.2,1646,39728,24690,-15038
9933,0.0,0.0,0.0,1646,39732,24690,-15042
9934,0.0,0.0,0.0,1646,39736,24690,-15046
9935,0.0,0.0,0.0,1646,39740,24690,-15050
9936,0.0,0.0,0.0,1646,39744,24690,-15054
9937,0.0,0.0,0.0,1646,39748,24690,-15058
9938,0.0,0.0,0.0,1646,39752,24690,-15062
9939,0.0,0.0,0.0,1646,39756,24690,-15066
9940,1.0,1.0,1.0,1647,39760,24705,-15055
9941,0.0,0.0,0.0,1647,39764,24705,-15059
9942,0.0,0.0,0.0,1647,39768,24705,-15063
9943,0.0,0.0,0.0,1647,39772,24705,-15067
9944,0.0,0.0,0.0,1647,39776,24705,-15071
9945,0.0,0.0,0.0,1647,39780,24705,-15075
9946,0.0,0.0,0.0,1647,39784,24705,-15079
9947,0.0,0.0,0.0,1647,39788,24705,-15083
9948,0.0,0.0,0.0,1647,39792,24705,-15087
9949,0.0,0.0,0.0,1647,39796,24705,-15091
9950,1.0,1.0,1.0,1648,39800,24720,-15080
9951,0.0,0.0,0.0,1648,39804,24720,-15084
9952,0.0,0.0,0.0,1648,39808,24720,-15088
9953,0.0,0.0,0.0,1648,39812,24720,-15092
9954,1.0,1.0,1.0,1649,39816,24735,-15081
9955,0.0,0.0,0.0,1649,39820,24735,-15085
9956,0.0,0.0,0.0,1649,39824,24735,-15089
9957,0.0,0.0,0.0,1649,39828,24735,-15093
9958,0.0,1.0,0.75,1649,39832,24735,-15097
9959,0.0,0.0,0.0,1649,39836,24735,-15101
9960,0.0,0.0,0.0,1649,39840,24735,-15105
9961,0.0,0.0,0.0,1649,39844,24735,-15109
9962,0.0,0.0,0.0,1649,39848,24735,-15113
9963,0.0,0.0,0.0,1649,39852,24735,-15117
9964,0.0,0.0,0.0,1649,39856,24735,-15121
9965,0.0,0.0,0.0,1649,39860,24735,-15125
9966,0.0,0.0,0.0,1649,39864,24735,-15129
9967,1.0,0.0,0.5,1650,39868,24750,-15118
9968,0.0,1.0,0.6666666666666666,1650,39872,24750,-15122
9969,0.0,0.0,0.0,1650,39876,24750,-15126
9970,0.0,0.0,0.0,1650,39880,24750,-15130
9971,0.0,0.0,0.0,1650,39884,24750,-15134
9972,0.0,0.0,0.3333333333333333,1650,39888,24750,-15138
9973,0.0,0.0,0.0,1650,39892,24750,-15142
9974,0.0,0.0,0.0,1650,39896,24750,-15146
9975,0.0,0.0,0.0,1650,39900,24750,-15150
9976,0.0,0.0,0.0,1650,39904,24750,-15154
9977,0.0,0.0,0.0,1650,39908,24750,-15158
9978,0.0,0.0,0.0,1650,39912,24750,-15162
9979,0.0,0.0,0.0,1650,39916,24750,-15166
9980,1.0,1.0,1.0,1651,39920,24765,-15155
9981,0.0,0.0,0.0,1651,39924,24765,-15159
9982,1.0,0.0,0.3333333333333333,1652,39928,24780,-15148
9983,1.0,1.0,1.0,1653,39932,24795,-15137
9984,1.0,1.0,1.0,1654,39936,24810,-15126
9985,0.0,0.0,0.0,1654,39940,24810,-15130
9986,0.0,0.0,0.0,1654,39944,24810,-15134
9987,0.0,0.0,0.0,1654,39948,24810,-15138
9988,0.0,0.0,0.0,1654,39952,24810,-15142
9989,0.0,0.0,0.0,1654,39956,24810,-15146
9990,1.0,1.0,1.0,1655,39960,24825,-15135
9991,0.0,0.0,0.0,1655,39964,24825,-15139
9992,0.0,0.0,0.0,1655,39968,24825,-15143
9993,0.0,0.0,0.0,1655,39972,24825,-15147
9994,0.0,0.0,0.0,1655,39976,24825,-15151
9995,0.0,1.0,0.6666666666666666,1655,39980,24825,-15155
9996,0.0,0.0,0.0,1655,39984,24825,-15159
9997,0.0,0.0,0.0,1655,39988,24825,-15163
9998,0.0,0.0,0.0,1655,39992,24825,-15167
9999,0.0,0.0,0.0,1655,39996,24825,-15171
10000,0.0,0.0,0.0,1655,40000,24825,-15175
10001,0.0,0.0,0.0,1655,40004,24825,-15179
10002,0.0,0.0,0.0,1655,40008,24825,-15183
10003,1.0,1.0,1.0,1656,40012,24840,-15172
10004,1.0,0.0,0.3333333333333333,1657,40016,24855,-15161
10005,1.0,1.0,1.0,1658,40020,24870,-15150
10006,0.0,0.0,0.0,1658,40024,24870,-15154
10007,0.0,0.0,0.0,1658,40028,24870,-15158
10008,0.0,0.0,0.0,1658,40032,24870,-15162
10009,0.0,0.0,0.0,1658,40036,24870,-15166
10010,0.0,0.0,0.3333333333333333,1658,40040,24870,-15170
10011,0.0,0.0,0.0,1658,40044,24870,-15174
10012,1.0,1.0,1.0,1659,40048,24885,-15163
10013,0.0,0.0,0.0,1659,40052,24885,-15167
10014,0.0,0.0,0.0,1659,40056,24885,-15171
10015,1.0,1.0,1.0,1660,40060,24900,-15160
10016,1.0,1.0,1.0,1661,40064,24915,-15149
10017,0.0,0.0,0.0,1661,40068,24915,-15153
10018,1.0,1.0,0.6666666666666666,1662,40072,24930,-15142
10019,0.0,0.0,0.0,1662,40076,24930,-15146
10020,0.0,0.0,0.0,1662,40080,24930,-15150
10021,0.0,0.0,0.0,1662,40084,24930,-15154
10022,0.0,0.0,0.0,1662,40088,24930,-15158
10023,0.0,0.0,0.0,1662,40092,24930,-15162
10024,0.0,0.0,0.0,1662,40096,24930,-15166
10025,1.0,1.0,0.8,1663,40100,24945,-15155
10026,0.0,0.0,0.0,1663,40104,24945,-15159
10027,0.0,0.0,0.0,1663,40108,24945,-15163
10028,0.0,0.0,0.0,1663,40112,24945,-15167
10029,0.0,0.0,0.0,1663,40116,24945,-15171
10030,1.0,1.0,0.6,1664,40120,24960,-15160
10031,0.0,0.0,0.0,1664,40124,24960,-15164
10032,0.0,0.0,0.0,1664,40128,24960,-15168
10033,0.0,0.0,0.0,1664,40132,24960,-15172
10034,0.0,0.0,0.0,1664,40136,24960,-15176
10035,0.0,0.0,0.0,1664,40140,24960,-15180
10036,1.0,1.0,1.0,1665,40144,24975,-15169
10037,0.0,0.0,0.0,1665,40148,24975,-15173
10038,0.0,0.0,0.0,1665,40152,24975,-15177
10039,0.0,0.0,0.0,1665,40156,24975,-15181
10040,1.0,1.0,0.75,1666,40160,24990,-15170
10041,1.0,1.0,1.0,1667,40164,25005,-15159
10042,0.0,0.0,0.0,1667,40168,25005,-15163
10043,0.0,0.0,0.0,1667,40172,25005,-15167
10044,0.0,0.0,0.0,1667,40176,25005,-15171
10045,0.0,0.0,0.0,1667,40180,25005,-15175
10046,0.0,1.0,0.8,1667,40184,25005,-15179
10047,0.0,0.0,0.0,1667,40188,25005,-15183
10048,0.0,0.0,0.0,1667,40192,25005,-15187
10049,1.0,1.0,0.6666666666666666,1668,40196,25020,-15176
10050,0.0,0.0,0.0,1668,40200,25020,-15180
10051,0.0,0.0,0.0,1668,40204,25020,-15184
10052,0.0,0.0,0.0,1668,40208,25020,-15188
10053,0.0,0.0,0.0,1668,40212,25020,-15192
10054,0.0,0.0,0.0,1668,40216,25020,-15196
10055,0.0,0.0,0.0,1668,40220,25020,-15200
10056,0.0,0.0,0.0,1668,40224,25020,-15204
10057,0.0,0.0,0.0,1668,40228,25020,-15208
10058,0.0,0.0,0.0,1668,40232,25020,-15212
10059,0.0,0.0,0.0,1668,40236,25020,-15216
10060,0.0,0.0,0.0,1668,40240,25020,-15220
10061,0.0,0.0,0.0,1668,40244,25020,-15224
10062,0.0,0.0,0.0,1668,40248,25020,-15228
10063,0.0,0.0,0.0,1668,40252,25020,-15232
10064,0.0,0.0,0.0,1668,40256,25020,-15236
10065,0.0,0.0,0.0,1668,40260,25020,-15240
10066,0.0,0.0,0.0,1668,40264,25020,-15244
10067,0.0,0.0,0.0,1668,40268,25020,-15248
10068,0.0,0.0,0.0,1668,40272,25020,-15252
10069,0.0,0.0,0.0,1668,40276,25020,-15256
10070,0.0,0.0,0.0,1668,40280,25020,-15260
10071,0.0,0.0,0.0,1668,40284,25020,-15264
10072,0.0,0.0,0.0,1668,40288,25020,-15268
10073,0.0,0.0,0.0,1668,40292,25020,-15272
10074,0.0,0.0,0.0,1668,40296,25020,-15276
10075,0.0,0.0,0.0,1668,40300,25020,-15280
10076,0.0,0.0,0.0,1668,40304,25020,-15284
10077,1.0,1.0,0.8,1669,40308,25035,-15273
10078,1.0,0.0,0.5,1670,40312,25050,-15262
10079,0.0,0.0,0.0,1670,40316,25050,-15266
10080,0.0,0.0,0.0,1670,40320,25050,-15270
10081,0.0,0.0,0.0,1670,40324,25050,-15274
10082,0.0,0.0,0.0,1670,40328,25050,-15278
10083,0.0,0.0,0.0,1670,40332,25050,-15282
10084,0.0,0.0,0.0,1670,40336,25050,-15286
10085,0.0,0.0,0.0,1670,40340,25050,-15290
10086,0.0,0.0,0.0,1670,40344,25050,-15294
10087,0.0,0.0,0.0,1670,40348,25050,-15298
10088,0.0,0.0,0.0,1670,40352,25050,-15302
10089,0.0,0.0,0.25,1670,40356,25050,-15306
10090,0.0,0.0,0.0,1670,40360,25050,-15310
10091,1.0,1.0,0.75,1671,40364,25065,-15299
10092,0.0,0.0,0.0,1671,40368,25065,-15303
10093,0.0,0.0,0.0,1671,40372,25065,-15307
10094,0.0,0.0,0.0,1671,40376,25065,-15311
10095,0.0,0.0,0.0,1671,40380,25065,-15315
10096,0.0,0.0,0.0,1671,40384,25065,-15319
10097,0.0,0.0,0.0,1671,40388,25065,-15323
10098,0.0,0.0,0.0,1671,40392,25065,-15327
10099,0.0,0.0,0.0,1671,40396,25065,-15331
10100,0.0,0.0,0.0,1671,40400,25065,-15335
10101,0.0,0.0,0.0,1671,40404,25065,-15339
10102,0.0,0.0,0.0,1671,40408,25065,-15343
10103,0.0,0.0,0.0,1671,40412,25065,-15347
10104,0.0,0.0,0.0,1671,40416,25065,-15351
10105,1.0,1.0,1.0,1672,40420,25080,-15340
10106,0.0,0.0,0.0,1672,40424,25080,-15344
10107,0.0,0.0,0.0,1672,40428,25080,-15348
10108,0.0,0.0,0.0,1672,40432,25080,-15352
10109,0.0,0.0,0.0,1672,40436,25080,-15356
10110,1.0,1.0,0.6666666666666666,1673,40440,25095,-15345
10111,1.0,1.0,0.75,1674,40444,25110,-15334
10112,0.0,0.0,0.0,1674,40448,25110,-15338
10113,1.0,1.0,0.6666666666666666,1675,40452,25125,-15327
10114,0.0,0.0,0.0,1675,40456,25125,-15331
10115,0.0,0.0,0.0,1675,40460,25125,-15335
10116,0.0,0.0,0.0,1675,40464,25125,-15339
10117,0.0,0.0,0.0,1675,40468,25125,-15343
10118,0.0,0.0,0.0,1675,40472,25125,-15347
10119,0.0,0.0,0.0,1675,40476,25125,-15351
10120,0.0,0.0,0.0,1675,40480,25125,-15355
10121,0.0,0.0,0.0,1675,40484,25125,-15359
10122,0.0,0.0,0.0,1675,40488,25125,-15363
10123,1.0,1.0,1.0,1676,40492,25140,-15352
10124,0.0,0.0,0.0,1676,40496,25140,-15356
10125,0.0,1.0,0.6,1676,40500,25140,-15360
10126,0.0,0.0,0.0,1676,40504,25140,-15364
10127,1.0,1.0,1.0,1677,40508,25155,-15353
10128,0.0,0.0,0.0,1677,40512,25155,-15357
10129,1.0,1.0,1.0,1678,40516,25170,-15346
10130,0.0,0.0,0.0,1678,40520,25170,-15350
10131,0.0,0.0,0.0,1678,40524,25170,-15354
10132,0.0,0.0,0.0,1678,40528,25170,-15358
10133,0.0,0.0,0.0,1678,40532,25170,-15362
10134,0.0,0.0,0.0,1678,40536,25170,-15366
10135,0.0,0.0,0.0,1678,40540,25170,-15370
10136,0.0,0.0,0.0,1678,40544,25170,-15374
10137,0.0,0.0,0.0,1678,40548,25170,-15378
10138,0.0,0.0,0.0,1678,40552,25170,-15382
10139,1.0,1.0,0.6666666666666666,1679,40556,25185,-15371
10140,1.0,1.0,1.0,1680,40560,25200,-15360
10141,0.0,0.0,0.0,1680,40564,25200,-15364
10142,0.0,0.0,0.0,1680,40568,25200,-15368
10143,1.0,1.0,0.8,1681,40572,25215,-15357
10144,1.0,1.0,1.0,1682,40576,25230,-15346
10145,0.0,0.0,0.0,1682,40580,25230,-15350
10146,0.0,0.0,0.0,1682,40584,25230,-15354
10147,0.0,0.0,0.0,1682,40588,25230,-15358
10148,0.0,0.0,0.0,1682,40592,25230,-15362
10149,0.0,0.0,0.0,1682,40596,25230,-15366
10150,0.0,0.0,0.0,1682,40600,25230,-15370
10151,0.0,0.0,0.0,1682,40604,25230,-15374
10152,1.0,1.0,1.0,1683,40608,25245,-15363
10153,0.0,0.0,0.0,1683,40612,25245,-15367
10154,1.0,1.0,1.0,1684,40616,25260,-15356
10155,0.0,0.0,0.0,1684,40620,25260,-15360
10156,0.0,0.0,0.0,1684,40624,25260,-15364
10157,0.0,0.0,0.0,1684,40628,25260,-15368
10158,0.0,0.0,0.0,1684,40632,25260,-15372
10159,0.0,0.0,0.0,1684,40636,25260,-15376
10160,0.0,0.0,0.0,1684,40640,25260,-15380
10161,0.0,0.0,0.0,1684,40644,25260,-15384
10162,0.0,0.0,0.0,1684,40648,25260,-15388
10163,1.0,1.0,1.0,1685,40652,25275,-15377
10164,0.0,0.0,0.0,1685,40656,25275,-15381
10165,0.0,0.0,0.0,1685,40660,25275,-15385
10166,0.0,0.0,0.0,1685,40664,25275,-15389
10167,0.0,0.0,0.0,1685,40668,25275,-15393
10168,0.0,0.0,0.0,1685,40672,25275,-15397
10169,0.0,0.0,0.0,1685,40676,25275,-15401
10170,0.0,0.0,0.0,1685,40680,25275,-15405
10171,0.0,0.0,0.0,1685,40684,25275,-15409
10172,0.0,0.0,0.0,1685,40688,25275,-15413
10173,0.0,0.0,0.0,1685,40692,25275,-15417
10174,1.0,1.0,1.0,1686,40696,25290,-15406
10175,0.0,0.0,0.0,1686,40700,25290,-15410
10176,0.0,0.0,0.0,1686,40704,25290,-15414
10177,0.0,0.0,0.0,1686,40708,25290,-15418
10178,0.0,0.0,0.0,1686,40712,25290,-15422
10179,0.0,0.0,0.0,1686,40716,25290,-15426
10180,0.0,0.0,0.0,1686,40720,25290,-15430
10181,0.0,0.0,0.0,1686,40724,25290,-15434
10182,1.0,1.0,1.0,1687,40728,25305,-15423
10183,0.0,0.0,0.0,1687,40732,25305,-15427
10184,1.0,1.0,1.0,1688,40736,25320,-15416
10185,0.0,0.0,0.25,1688,40740,25320,-15420
10186,0.0,0.0,0.0,1688,40744,25320,-15424
10187,0.0,0.0,0.0,1688,40748,25320,-15428
10188,1.0,1.0,1.0,1689,40752,25335,-15417
10189,1.0,0.0,0.3333333333333333,1690,40756,25350,-15406
10190,0.0,0.0,0.0,1690,40760,25350,-15410
10191,1.0,1.0,1.0,1691,40764,25365,-15399
10192,0.0,0.0,0.0,1691,40768,25365,-15403
10193,0.0,0.0,0.0,1691,40772,25365,-15407
10194,1.0,1.0,1.0,1692,40776,25380,-15396
10195,0.0,0.0,0.0,1692,40780,25380,-15400
10196,0.0,0.0,0.0,1692,40784,25380,-15404
10197,0.0,0.0,0.0,1692,40788,25380,-15408
10198,0.0,0.0,0.0,1692,40792,25380,-15412
10199,1.0,1.0,1.0,1693,40796,25395,-15401
10200,0.0,0.0,0.0,1693,40800,25395,-15405
10201,0.0,0.0,0.0,1693,40804,25395,-15409
10202,0.0,0.0,0.0,1693,40808,25395,-15413
10203,0.0,0.0,0.0,1693,40812,25395,-15417
10204,0.0,0.0,0.0,1693,40816,25395,-15421
10205,0.0,0.0,0.0,1693,40820,25395,-15425
10206,0.0,0.0,0.0,1693,40824,25395,-15429
10207,1.0,0.0,0.3333333333333333,1694,40828,25410,-15418
10208,1.0,0.0,0.25,1695,40832,25425,-15407
10209,0.0,0.0,0.0,1695,40836,25425,-15411
10210,0.0,0.0,0.0,1695,40840,25425,-15415
10211,1.0,1.0,1.0,1696,40844,25440,-15404
10212,0.0,0.0,0.0,1696,40848,25440,-15408
10213,1.0,1.0,1.0,1697,40852,25455,-15397
10214,0.0,0.0,0.0,1697,40856,25455,-15401
10215,0.0,0.0,0.0,1697,40860,25455,-15405
10216,0.0,0.0,0.0,1697,40864,25455,-15409
10217,0.0,0.0,0.0,1697,40868,25455,-15413
10218,0.0,0.0,0.0,1697,40872,25455,-15417
10219,0.0,0.0,0.3333333333333333,1697,40876,25455,-15421
10220,0.0,0.0,0.0,1697,40880,25455,-15425
10221,0.0,0.0,0.0,1697,40884,25455,-15429
10222,0.0,0.0,0.0,1697,40888,25455,-15433
10223,0.0,0.0,0.0,1697,40892,25455,-15437
10224,0.0,0.0,0.0,1697,40896,25455,-15441
10225,0.0,0.0,0.0,1697,40900,25455,-15445
10226,0.0,0.0,0.0,1697,40904,25455,-15449
10227,0.0,0.0,0.0,1697,40908,25455,-15453
10228,0.0,0.0,0.0,1697,40912,25455,-15457
10229,0.0,0.0,0.0,1697,40916,25455,-15461
10230,0.0,0.0,0.0,1697,40920,25455,-15465
10231,0.0,0.0,0.0,1697,40924,25455,-15469
10232,0.0,0.0,0.0,1697,40928,25455,-15473
10233,0.0,0.0,0.0,1697,40932,25455,-15477
10234,1.0,1.0,1.0,1698,40936,25470,-15466
10235,0.0,0.0,0.0,1698,40940,25470,-15470
10236,0.0,0.0,0.0,1698,40944,25470,-15474
10237,0.0,0.0,0.0,1698,40948,25470,-15478
10238,0.0,0.0,0.0,1698,40952,25470,-15482
10239,0.0,0.0,0.0,1698,40956,25470,-15486
10240,1.0,1.0,1.0,1699,40960,25485,-15475
10241,0.0,0.0,0.0,1699,40964,25485,-15479
10242,0.0,0.0,0.0,1699,40968,25485,-15483
10243,0.0,0.0,0.0,1699,40972,25485,-15487
10244,0.0,0.0,0.3333333333333333,1699,40976,25485,-15491
10245,1.0,1.0,1.0,1700,40980,25500,-15480
10246,0.0,0.0,0.0,1700,40984,25500,-15484
10247,0.0,0.0,0.0,1700,40988,25500,-15488
10248,0.0,1.0,0.6666666666666666,1700,40992,25500,-15492
10249,0.0,0.0,0.0,1700,40996,25500,-15496
10250,1.0,0.0,0.5,1701,41000,25515,-15485
10251,1.0,1.0,1.0,1702,41004,25530,-15474
10252,1.0,1.0,0.8,1703,41008,25545,-15463
10253,0.0,0.0,0.0,1703,41012,25545,-15467
10254,0.0,0.0,0.0,1703,41016,25545,-15471
10255,0.0,0.0,0.0,1703,41020,25545,-15475
10256,0.0,0.0,0.0,1703,41024,25545,-15479
10257,1.0,1.0,1.0,1704,41028,25560,-15468
10258,0.0,0.0,0.0,1704,41032,25560,-15472
10259,0.0,0.0,0.0,1704,41036,25560,-15476
10260,1.0,1.0,1.0,1705,41040,25575,-15465
10261,0.0,0.0,0.0,1705,41044,25575,-15469
10262,0.0,0.0,0.0,1705,41048,25575,-15473
10263,0.0,0.0,0.0,1705,41052,25575,-15477
10264,0.0,0.0,0.0,1705,41056,25575,-15481
10265,0.0,0.0,0.0,1705,41060,25575,-15485
10266,0.0,0.0,0.0,1705,41064,25575,-15489
10267,0.0,0.0,0.0,1705,41068,25575,-15493
10268,0.0,0.0,0.0,1705,41072,25575,-15497
10269,0.0,0.0,0.0,1705,41076,25575,-15501
10270,0.0,0.0,0.0,1705,41080,25575,-15505
10271,0.0,0.0,0.0,1705,41084,25575,-15509
10272,0.0,0.0,0.0,1705,41088,25575,-15513
10273,0.0,0.0,0.0,1705,41092,25575,-15517
10274,0.0,0.0,0.0,1705,41096,25575,-15521
10275,0.0,0.0,0.0,1705,41100,25575,-15525
10276,0.0,0.0,0.0,1705,41104,25575,-15529
10277,1.0,1.0,0.6666666666666666,1706,41108,25590,-15518
10278,0.0,1.0,0.6666666666666666,1706,41112,25590,-15522
10279,0.0,0.0,0.0,1706,41116,25590,-15526
10280,0.0,0.0,0.0,1706,41120,25590,-15530
10281,0.0,0.0,0.0,1706,41124,25590,-15534
10282,0.0,0.0,0.0,1706,41128,25590,-15538
10283,0.0,1.0,0.75,1706,41132,25590,-15542
10284,0.0,0.0,0.0,1706,41136,25590,-15546
10285,0.0,0.0,0.0,1706,41140,25590,-15550
10286,0.0,0.0,0.0,1706,41144,25590,-15554
10287,0.0,0.0,0.0,1706,41148,25590,-15558
10288,0.0,0.0,0.0,1706,41152,25590,-15562
10289,0.0,0.0,0.0,1706,41156,25590,-15566
10290,0.0,0.0,0.0,1706,41160,25590,-15570
10291,0.0,0.0,0.0,1706,41164,25590,-15574
10292,0.0,0.0,0.0,1706,41168,25590,-15578
10293,1.0,0.0,0.3333333333333333,1707,41172,25605,-15567
10294,0.0,0.0,0.0,1707,41176,25605,-15571
10295,0.0,0.0,0.0,1707,41180,25605,-15575
10296,0.0,0.0,0.4,1707,41184,25605,-15579
10297,0.0,0.0,0.0,1707,41188,25605,-15583
10298,0.0,0.0,0.0,1707,41192,25605,-15587
10299,0.0,0.0,0.0,1707,41196,25605,-15591
10300,0.0,0.0,0.0,1707,41200,25605,-15595
10301,0.0,0.0,0.0,1707,41204,25605,-15599
10302,0.0,0.0,0.0,1707,41208,25605,-15603
10303,0.0,0.0,0.0,1707,41212,25605,-15607
10304,1.0,1.0,0.6666666666666666,1708,41216,25620,-15596
10305,0.0,0.0,0.0,1708,41220,25620,-15600
10306,1.0,1.0,0.6666666666666666,1709,41224,25635,-15589
10307,0.0,0.0,0.0,1709,41228,25635,-15593
10308,0.0,0.0,0.0,1709,41232,25635,-15597
10309,0.0,0.0,0.0,1709,41236,25635,-15601
10310,0.0,0.0,0.0,1709,41240,25635,-15605
10311,0.0,0.0,0.0,1709,41244,25635,-15609
10312,1.0,1.0,1.0,1710,41248,25650,-15598
10313,0.0,0.0,0.0,1710,41252,25650,-15602
10314,0.0,0.0,0.0,1710,41256,25650,-15606
10315,0.0,0.0,0.0,1710,41260,25650,-15610
10316,0.0,0.0,0.0,1710,41264,25650,-15614
10317,1.0,1.0,1.0,1711,41268,25665,-15603
10318,0.0,0.0,0.0,1711,41272,25665,-15607
10319,1.0,1.0,1.0,1712,41276,25680,-15596
10320,0.0,0.0,0.0,1712,41280,25680,-15600
10321,0.0,0.0,0.0,1712,41284,25680,-15604
10322,0.0,0.0,0.0,1712,41288,25680,-15608
10323,0.0,0.0,0.0,1712,41292,25680,-15612
10324,0.0,0.0,0.0,1712,41296,25680,-15616
10325,0.0,0.0,0.0,1712,41300,25680,-15620
10326,0.0,0.0,0.0,1712,41304,25680,-15624
10327,0.0,0.0,0.0,1712,41308,25680,-15628
10328,1.0,1.0,1.0,1713,41312,25695,-15617
10329,0.0,0.0,0.0,1713,41316,25695,-15621
10330,0.0,0.0,0.0,1713,41320,25695,-15625
10331,0.0,0.0,0.0,1713,41324,25695,-15629
10332,0.0,0.0,0.0,1713,41328,25695,-15633
10333,0.0,0.0,0.0,1713,41332,25695,-15637
10334,0.0,0.0,0.0,1713,41336,25695,-15641
10335,0.0,1.0,0.6666666666666666,1713,41340,25695,-15645
10336,0.0,0.0,0.0,1713,41344,25695,-15649
10337,0.0,0.0,0.0,1713,41348,25695,-15653
10338,0.0,0.0,0.0,1713,41352,25695,-15657
10339,0.0,0.0,0.0,1713,41356,25695,-15661
10340,0.0,0.0,0.0,1713,41360,25695,-15665
10341,0.0,0.0,0.0,1713,41364,25695,-15669
10342,0.0,0.0,0.0,1713,41368,25695,-15673
10343,0.0,0.0,0.0,1713,41372,25695,-15677
10344,0.0,0.0,0.0,1713,41376,25695,-15681
10345,0.0,0.0,0.0,1713,41380,25695,-15685
10346,0.0,0.0,0.0,1713,41384,25695,-15689
10347,0.0,0.0,0.0,1713,41388,25695,-15693
10348,0.0,0.0,0.0,1713,41392,25695,-15697
10349,1.0,1.0,1.0,1714,41396,25710,-15686
10350,0.0,0.0,0.0,1714,41400,25710,-15690
10351,0.0,0.0,0.0,1714,41404,25710,-15694
10352,0.0,0.0,0.0,1714,41408,25710,-15698
10353,0.0,0.0,0.0,1714,41412,25710,-15702
10354,0.0,0.0,0.0,1714,41416,25710,-15706
10355,0.0,0.0,0.0,1714,41420,25710,-15710
10356,0.0,0.0,0.0,1714,41424,25710,-15714
10357,0.0,0.0,0.0,1714,41428,25710,-15718
10358,1.0,1.0,1.0,1715,41432,25725,-15707
10359,0.0,0.0,0.0,1715,41436,25725,-15711
10360,0.0,0.0,0.0,1715,41440,25725,-15715
10361,0.0,0.0,0.0,1715,41444,25725,-15719
10362,0.0,0.0,0.0,1715,41448,25725,-15723
10363,0.0,0.0,0.0,1715,41452,25725,-15727
10364,0.0,0.0,0.0,1715,41456,25725,-15731
10365,0.0,0.0,0.0,1715,41460,25725,-15735
10366,0.0,0.0,0.0,1715,41464,25725,-15739
10367,0.0,0.0,0.0,1715,41468,25725,-15743
10368,1.0,1.0,0.6666666666666666,1716,41472,25740,-15732
10369,0.0,0.0,0.0,1716,41476,25740,-15736
10370,0.0,1.0,0.6666666666666666,1716,41480,25740,-15740
10371,1.0,1.0,1.0,1717,41484,25755,-15729
10372,1.0,1.0,1.0,1718,41488,25770,-15718
10373,0.0,0.0,0.0,1718,41492,25770,-15722
10374,0.0,0.0,0.3333333333333333,1718,41496,25770,-15726
10375,1.0,1.0,1.0,1719,41500,25785,-15715
10376,0.0,0.0,0.0,1719,41504,25785,-15719
10377,1.0,1.0,1.0,1720,41508,25800,-15708
10378,1.0,1.0,1.0,1721,41512,25815,-15697
10379,0.0,0.0,0.0,1721,41516,25815,-15701
10380,0.0,0.0,0.0,1721,41520,25815,-15705
10381,0.0,0.0,0.0,1721,41524,25815,-15709
10382,0.0,0.0,0.0,1721,41528,25815,-15713
10383,0.0,0.0,0.0,1721,41532,25815,-15717
10384,0.0,0.0,0.0,1721,41536,25815,-15721
10385,0.0,0.0,0.0,1721,41540,25815,-15725
10386,0.0,0.0,0.0,1721,41544,25815,-15729
10387,0.0,0.0,0.0,1721,41548,25815,-15733
10388,0.0,0.0,0.3333333333333333,1721,41552,25815,-15737
10389,0.0,0.0,0.0,1721,41556,25815,-15741
10390,1.0,1.0,1.0,1722,41560,25830,-15730
10391,0.0,0.0,0.0,1722,41564,25830,-15734
10392,0.0,0.0,0.0,1722,41568,25830,-15738
10393,0.0,0.0,0.0,1722,41572,25830,-15742
10394,1.0,1.0,1.0,1723,41576,25845,-15731
10395,0.0,0.0,0.0,1723,41580,25845,-15735
10396,1.0,1.0,1.0,1724,41584,25860,-15724
10397,0.0,0.0,0.0,1724,41588,25860,-15728
10398,1.0,1.0,1.0,1725,41592,25875,-15717
10399,0.0,0.0,0.0,1725,41596,25875,-15721
10400,0.0,0.0,0.0,1725,41600,25875,-15725
10401,1.0,1.0,1.0,1726,41604,25890,-15714
10402,0.0,0.0,0.0,1726,41608,25890,-15718
10403,0.0,0.0,0.0,1726,41612,25890,-15722
10404,0.0,0.0,0.0,1726,41616,25890,-15726
10405,0.0,0.0,0.0,1726,41620,25890,-15730
10406,0.0,0.0,0.0,1726,41624,25890,-15734
10407,0.0,0.0,0.0,1726,41628,25890,-15738
10408,0.0,0.0,0.0,1726,41632,25890,-15742
10409,0.0,0.0,0.0,1726,41636,25890,-15746
10410,1.0,0.0,0.25,1727,41640,25905,-15735
10411,0.0,0.0,0.0,1727,41644,25905,-15739
10412,0.0,0.0,0.0,1727,41648,25905,-15743
10413,0.0,0.0,0.4,1727,41652,25905,-15747
10414,0.0,0.0,0.0,1727,41656,25905,-15751
10415,0.0,0.0,0.3333333333333333,1727,41660,25905,-15755
10416,0.0,0.0,0.0,1727,41664,25905,-15759
10417,1.0,0.0,0.3333333333333333,1728,41668,25920,-15748
10418,1.0,1.0,0.75,1729,41672,25935,-15737
10419,1.0,1.0,1.0,1730,41676,25950,-15726
10420,0.0,0.0,0.0,1730,41680,25950,-15730
10421,0.0,0.0,0.0,1730,41684,25950,-15734
10422,0.0,0.0,0.0,1730,41688,25950,-15738
10423,1.0,1.0,0.6666666666666666,1731,41692,25965,-15727
10424,1.0,0.0,0.25,1732,41696,25980,-15716
10425,1.0,1.0,1.0,1733,41700,25995,-15705
10426,0.0,0.0,0.0,1733,41704,25995,-15709
10427,0.0,0.0,0.0,1733,41708,25995,-15713
10428,0.0,0.0,0.0,1733,41712,25995,-15717
10429,1.0,1.0,0.6666666666666666,1734,41716,26010,-15706
10430,1.0,1.0,1.0,1735,41720,26025,-15695
10431,0.0,0.0,0.0,1735,41724,26025,-15699
10432,0.0,0.0,0.0,1735,41728,26025,-15703
10433,0.0,0.0,0.0,1735,41732,26025,-15707
10434,0.0,0.0,0.0,1735,41736,26025,-15711
10435,1.0,1.0,1.0,1736,41740,26040,-15700
10436,0.0,0.0,0.0,1736,41744,26040,-15704
10437,0.0,0.0,0.0,1736,41748,26040,-15708
10438,1.0,1.0,1.0,1737,41752,26055,-15697
10439,0.0,0.0,0.0,1737,41756,26055,-15701
10440,0.0,0.0,0.0,1737,41760,26055,-15705
10441,0.0,0.0,0.0,1737,41764,26055,-15709
10442,0.0,0.0,0.0,1737,41768,26055,-15713
10443,0.0,0.0,0.0,1737,41772,26055,-15717
10444,0.0,0.0,0.0,1737,41776,26055,-15721
10445,1.0,1.0,1.0,1738,41780,26070,-15710
10446,0.0,0.0,0.0,1738,41784,26070,-15714
10447,0.0,0.0,0.0,1738,41788,26070,-15718
10448,0.0,0.0,0.0,1738,41792,26070,-15722
10449,0.0,0.0,0.0,1738,41796,26070,-15726
10450,0.0,0.0,0.0,1738,41800,26070,-15730
10451,0.0,0.0,0.0,1738,41804,26070,-15734
10452,1.0,1.0,1.0,1739,41808,26085,-15723
10453,0.0,0.0,0.0,1739,41812,26085,-15727
10454,0.0,0.0,0.0,1739,41816,26085,-15731
10455,0.0,0.0,0.0,1739,41820,26085,-15735
10456,0.0,0.0,0.0,1739,41824,26085,-15739
10457,1.0,1.0,0.75,1740,41828,26100,-15728
10458,0.0,0.0,0.0,1740,41832,26100,-15732
10459,0.0,0.0,0.0,1740,41836,26100,-15736
10460,0.0,0.0,0.0,1740,41840,26100,-15740
10461,0.0,0.0,0.3333333333333333,1740,41844,26100,-15744
10462,0.0,0.0,0.0,1740,41848,26100,-15748
10463,0.0,0.0,0.5,1740,41852,26100,-15752
10464,0.0,0.0,0.0,1740,41856,26100,-15756
10465,0.0,0.0,0.0,1740,41860,26100,-15760
10466,0.0,0.0,0.0,1740,41864,26100,-15764
10467,0.0,0.0,0.0,1740,41868,26100,-15768
10468,0.0,0.0,0.0,1740,41872,26100,-15772
10469,0.0,0.0,0.0,1740,41876,26100,-15776
10470,0.0,0.0,0.0,1740,41880,26100,-15780
10471,0.0,0.0,0.0,1740,41884,26100,-15784
10472,0.0,0.0,0.0,1740,41888,26100,-15788
10473,0.0,0.0,0.0,1740,41892,26100,-15792
10474,1.0,1.0,0.6666666666666666,1741,41896,26115,-15781
10475,0.0,0.0,0.0,1741,41900,26115,-15785
10476,0.0,0.0,0.0,1741,41904,26115,-15789
10477,1.0,1.0,1.0,1742,41908,26130,-15778
10478,0.0,1.0,0.6666666666666666,1742,41912,26130,-15782
10479,0.0,0.0,0.0,1742,41916,26130,-15786
10480,0.0,0.0,0.0,1742,41920,26130,-15790
10481,1.0,1.0,1.0,1743,41924,26145,-15779
10482,0.0,0.0,0.0,1743,41928,26145,-15783
10483,0.0,0.0,0.0,1743,41932,26145,-15787
10484,0.0,0.0,0.0,1743,41936,26145,-15791
10485,0.0,0.0,0.0,1743,41940,26145,-15795
10486,0.0,0.0,0.0,1743,41944,26145,-15799
10487,1.0,1.0,0.8,1744,41948,26160,-15788
10488,1.0,1.0,1.0,1745,41952,26175,-15777
10489,0.0,0.0,0.0,1745,41956,26175,-15781
10490,0.0,0.0,0.0,1745,41960,26175,-15785
10491,0.0,0.0,0.0,1745,41964,26175,-15789
10492,0.0,0.0,0.0,1745,41968,26175,-15793
10493,0.0,0.0,0.3333333333333333,1745,41972,26175,-15797
10494,0.0,0.0,0.0,1745,41976,26175,-15801
10495,0.0,0.0,0.0,1745,41980,26175,-15805
10496,0.0,0.0,0.0,1745,41984,26175,-15809
10497,0.0,0.0,0.0,1745,41988,26175,-15813
10498,1.0,0.0,0.4,1746,41992,26190,-15802
10499,0.0,0.0,0.0,1746,41996,26190,-15806
10500,0.0,0.0,0.0,1746,42000,26190,-15810
10501,0.0,0.0,0.0,1746,42004,26190,-15814
10502,1.0,1.0,1.0,1747,42008,26205,-15803
10503,0.0,0.0,0.0,1747,42012,26205,-15807
10504,0.0,0.0,0.0,1747,42016,26205,-15811
10505,0.0,0.0,0.0,1747,42020,26205,-15815
10506,0.0,0.0,0.0,1747,42024,26205,-15819
10507,0.0,0.0,0.0,1747,42028,26205,-15823
10508,0.0,0.0,0.0,1747,42032,26205,-15827
10509,0.0,0.0,0.0,1747,42036,26205,-15831
10510,0.0,0.0,0.0,1747,42040,26205,-15835
10511,0.0,0.0,0.0,1747,42044,26205,-15839
10512,0.0,0.0,0.0,1747,42048,26205,-15843
10513,0.0,0.0,0.0,1747,42052,26205,-15847
10514,0.0,0.0,0.0,1747,42056,26205,-15851
10515,0.0,0.0,0.0,1747,42060,26205,-15855
10516,0.0,0.0,0.0,1747,42064,26205,-15859
10517,0.0,0.0,0.0,1747,42068,26205,-15863
10518,0.0,0.0,0.0,1747,42072,26205,-15867
10519,0.0,0.0,0.0,1747,42076,26205,-15871
10520,0.0,0.0,0.0,1747,42080,26205,-15875
10521,0.0,0.0,0.0,1747,42084,26205,-15879
10522,0.0,0.0,0.0,1747,42088,26205,-15883
10523,0.0,0.0,0.3333333333333333,1747,42092,26205,-15887
10524,0.0,0.0,0.0,1747,42096,26205,-15891
10525,0.0,0.0,0.0,1747,42100,26205,-15895
10526,0.0,0.0,0.0,1747,42104,26205,-15899
10527,0.0,0.0,0.0,1747,42108,26205,-15903
10528,0.0,0.0,0.0,1747,42112,26205,-15907
10529,0.0,0.0,0.0,1747,42116,26205,-15911
10530,1.0,1.0,1.0,1748,42120,26220,-15900
10531,0.0,0.0,0.0,1748,42124,26220,-15904
10532,0.0,0.0,0.0,1748,42128,26220,-15908
10533,0.0,0.0,0.0,1748,42132,26220,-15912
10534,0.0,0.0,0.0,1748,42136,26220,-15916
10535,0.0,0.0,0.0,1748,42140,26220,-15920
10536,0.0,0.0,0.0,1748,42144,26220,-15924
10537,0.0,0.0,0.0,1748,42148,26220,-15928
10538,1.0,1.0,0.6666666666666666,1749,42152,26235,-15917
10539,0.0,0.0,0.0,1749,42156,26235,-15921
10540,0.0,0.0,0.0,1749,42160,26235,-15925
10541,0.0,0.0,0.0,1749,42164,26235,-15929
10542,0.0,0.0,0.0,1749,42168,26235,-15933
10543,0.0,0.0,0.0,1749,42172,26235,-15937
10544,1.0,1.0,1.0,1750,42176,26250,-15926
10545,0.0,0.0,0.3333333333333333,1750,42180,26250,-15930
10546,0.0,0.0,0.0,1750,42184,26250,-15934
10547,1.0,0.0,0.3333333333333333,1751,42188,26265,-15923
10548,0.0,0.0,0.0,1751,42192,26265,-15927
10549,0.0,0.0,0.3333333333333333,1751,42196,26265,-15931
10550,0.0,0.0,0.0,1751,42200,26265,-15935
10551,0.0,0.0,0.0,1751,42204,26265,-15939
10552,0.0,0.0,0.0,1751,42208,26265,-15943
10553,0.0,0.0,0.0,1751,42212,26265,-15947
10554,0.0,0.0,0.0,1751,42216,26265,-15951
10555,0.0,0.0,0.0,1751,42220,26265,-15955
10556,0.0,0.0,0.0,1751,42224,26265,-15959
10557,0.0,0.0,0.0,1751,42228,26265,-15963
10558,0.0,0.0,0.0,1751,42232,26265,-15967
10559,0.0,0.0,0.0,1751,42236,26265,-15971
10560,0.0,0.0,0.0,1751,42240,26265,-15975
10561,0.0,0.0,0.0,1751,42244,26265,-15979
10562,0.0,0.0,0.0,1751,42248,26265,-15983
10563,0.0,0.0,0.0,1751,42252,26265,-15987
10564,0.0,0.0,0.0,1751,42256,26265,-15991
10565,0.0,0.0,0.0,1751,42260,26265,-15995
10566,0.0,0.0,0.0,1751,42264,26265,-15999
10567,0.0,0.0,0.0,1751,42268,26265,-16003
10568,0.0,0.0,0.0,1751,42272,26265,-16007
10569,0.0,0.0,0.0,1751,42276,26265,-16011
10570,0.0,0.0,0.0,1751,42280,26265,-16015
10571,0.0,0.0,0.0,1751,42284,26265,-16019
10572,0.0,1.0,0.6666666666666666,1751,42288,26265,-16023
10573,0.0,0.0,0.0,1751,42292,26265,-16027
10574,1.0,0.0,0.3333333333333333,1752,42296,26280,-16016
10575,1.0,1.0,1.0,1753,42300,26295,-16005
10576,1.0,1.0,0.6666666666666666,1754,42304,26310,-15994
10577,0.0,0.0,0.0,1754,42308,26310,-15998
10578,0.0,0.0,0.0,1754,42312,26310,-16002
10579,0.0,0.0,0.0,1754,42316,26310,-16006
10580,0.0,0.0,0.0,1754,42320,26310,-16010
10581,0.0,0.0,0.0,1754,42324,26310,-16014
10582,1.0,1.0,0.6666666666666666,1755,42328,26325,-16003
10583,0.0,0.0,0.0,1755,42332,26325,-16007
10584,1.0,1.0,1.0,1756,42336,26340,-15996
10585,0.0,0.0,0.0,1756,42340,26340,-16000
10586,0.0,0.0,0.0,1756,42344,26340,-16004
10587,0.0,0.0,0.0,1756,42348,26340,-16008
10588,0.0,0.0,0.0,1756,42352,26340,-16012
10589,0.0,0.0,0.0,1756,42356,26340,-16016
10590,0.0,0.0,0.0,1756,42360,26340,-16020
10591,1.0,1.0,1.0,1757,42364,26355,-16009
10592,0.0,0.0,0.0,1757,42368,26355,-16013
10593,0.0,1.0,0.6666666666666666,1757,42372,26355,-16017
10594,0.0,0.0,0.0,1757,42376,26355,-16021
10595,0.0,0.0,0.0,1757,42380,26355,-16025
10596,1.0,1.0,1.0,1758,42384,26370,-16014
10597,0.0,0.0,0.0,1758,42388,26370,-16018
10598,0.0,0.0,0.0,1758,42392,26370,-16022
10599,0.0,0.0,0.0,1758,42396,26370,-16026
10600,0.0,0.0,0.0,1758,42400,26370,-16030
10601,0.0,0.0,0.0,1758,42404,26370,-16034
10602,0.0,0.0,0.0,1758,42408,26370,-16038
10603,0.0,0.0,0.0,1758,42412,26370,-16042
10604,0.0,0.0,0.3333333333333333,1758,42416,26370,-16046
10605,0.0,0.0,0.0,1758,42420,26370,-16050
10606,0.0,0.0,0.0,1758,42424,26370,-16054
10607,0.0,0.0,0.3333333333333333,1758,42428,26370,-16058
10608,1.0,1.0,1.0,1759,42432,26385,-16047
10609,0.0,0.0,0.0,1759,42436,26385,-16051
10610,0.0,0.0,0.0,1759,42440,26385,-16055
10611,0.0,0.0,0.0,1759,42444,26385,-16059
10612,0.0,0.0,0.0,1759,42448,26385,-16063
10613,0.0,0.0,0.0,1759,42452,26385,-16067
10614,0.0,0.0,0.0,1759,42456,26385,-16071
10615,0.0,0.0,0.0,1759,42460,26385,-16075
10616,0.0,0.0,0.0,1759,42464,26385,-16079
10617,0.0,0.0,0.0,1759,42468,26385,-16083
10618,0.0,0.0,0.0,1759,42472,26385,-16087
10619,0.0,0.0,0.0,1759,42476,26385,-16091
10620,0.0,0.0,0.0,1759,42480,26385,-16095
10621,0.0,0.0,0.0,1759,42484,26385,-16099
10622,0.0,0.0,0.0,1759,42488,26385,-16103
10623,0.0,0.0,0.0,1759,42492,26385,-16107
10624,0.0,0.0,0.0,1759,42496,26385,-16111
10625,0.0,0.0,0.3333333333333333,1759,42500,26385,-16115
10626,0.0,0.0,0.0,1759,42504,26385,-16119
10627,0.0,0.0,0.0,1759,42508,26385,-16123
10628,0.0,0.0,0.0,1759,42512,26385,-16127
10629,0.0,0.0,0.0,1759,42516,26385,-16131
10630,0.0,0.0,0.0,1759,42520,26385,-16135
10631,0.0,0.0,0.0,1759,42524,26385,-16139
10632,0.0,0.0,0.0,1759,42528,26385,-16143
10633,0.0,0.0,0.0,1759,42532,26385,-16147
10634,0.0,0.0,0.0,1759,42536,26385,-16151
10635,0.0,0.0,0.0,1759,42540,26385,-16155
10636,1.0,1.0,1.0,1760,42544,26400,-16144
10637,1.0,1.0,1.0,1761,42548,26415,-16133
10638,0.0,0.0,0.0,1761,42552,26415,-16137
10639,1.0,1.0,0.8,1762,42556,26430,-16126
10640,0.0,0.0,0.0,1762,42560,26430,-16130
10641,0.0,1.0,0.6666666666666666,1762,42564,26430,-16134
10642,0.0,0.0,0.0,1762,42568,26430,-16138
10643,0.0,0.0,0.0,1762,42572,26430,-16142
10644,0.0,1.0,0.6,1762,42576,26430,-16146
10645,0.0,0.0,0.0,1762,42580,26430,-16150
10646,1.0,1.0,1.0,1763,42584,26445,-16139
10647,1.0,0.0,0.3333333333333333,1764,42588,26460,-16128
10648,0.0,0.0,0.0,1764,42592,26460,-16132
10649,0.0,0.0,0.4,1764,42596,26460,-16136
10650,0.0,0.0,0.0,1764,42600,26460,-16140
10651,0.0,0.0,0.0,1764,42604,26460,-16144
10652,0.0,0.0,0.0,1764,42608,26460,-16148
10653,0.0,0.0,0.0,1764,42612,26460,-16152
10654,0.0,0.0,0.0,1764,42616,26460,-16156
10655,0.0,0.0,0.0,1764,42620,26460,-16160
10656,0.0,0.0,0.0,1764,42624,26460,-16164
10657,0.0,0.0,0.0,1764,42628,26460,-16168
10658,0.0,0.0,0.0,1764,42632,26460,-16172
10659,0.0,0.0,0.0,1764,42636,26460,-16176
10660,0.0,0.0,0.0,1764,42640,26460,-16180
10661,0.0,0.0,0.2,1764,42644,26460,-16184
10662,1.0,1.0,1.0,1765,42648,26475,-16173
10663,0.0,0.0,0.0,1765,42652,26475,-16177
10664,0.0,0.0,0.0,1765,42656,26475,-16181
10665,0.0,0.0,0.0,1765,42660,26475,-16185
10666,1.0,1.0,1.0,1766,42664,26490,-16174
10667,0.0,0.0,0.0,1766,42668,26490,-16178
10668,0.0,0.0,0.0,1766,42672,26490,-16182
10669,0.0,0.0,0.0,1766,42676,26490,-16186
10670,0.0,0.0,0.0,1766,42680,26490,-16190
10671,0.0,0.0,0.0,1766,42684,26490,-16194
10672,0.0,0.0,0.3333333333333333,1766,42688,26490,-16198
10673,1.0,1.0,1.0,1767,42692,26505,-16187
10674,0.0,0.0,0.0,1767,42696,26505,-16191
10675,0.0,0.0,0.0,1767,42700,26505,-16195
10676,0.0,0.0,0.3333333333333333,1767,42704,26505,-16199
10677,0.0,0.0,0.0,1767,42708,26505,-16203
10678,0.0,0.0,0.0,1767,42712,26505,-16207
10679,0.0,0.0,0.0,1767,42716,26505,-16211
10680,1.0,1.0,1.0,1768,42720,26520,-16200
10681,0.0,0.0,0.0,1768,42724,26520,-16204
10682,1.0,0.0,0.5,1769,42728,26535,-16193
10683,0.0,0.0,0.0,1769,42732,26535,-16197
10684,0.0,0.0,0.0,1769,42736,26535,-16201
10685,1.0,1.0,1.0,1770,42740,26550,-16190
10686,0.0,0.0,0.0,1770,42744,26550,-16194
10687,0.0,0.0,0.0,1770,42748,26550,-16198
10688,0.0,0.0,0.0,1770,42752,26550,-16202
10689,0.0,0.0,0.0,1770,42756,26550,-16206
10690,0.0,0.0,0.0,1770,42760,26550,-16210
10691,0.0,0.0,0.0,1770,42764,26550,-16214
10692,0.0,0.0,0.0,1770,42768,26550,-16218
10693,0.0,0.0,0.0,1770,42772,26550,-16222
10694,0.0,0.0,0.0,1770,42776,26550,-16226
10695,0.0,0.0,0.0,1770,42780,26550,-16230
10696,0.0,0.0,0.0,1770,42784,26550,-16234
10697,0.0,0.0,0.0,1770,42788,26550,-16238
10698,0.0,0.0,0.0,1770,42792,26550,-16242
10699,1.0,1.0,1.0,1771,42796,26565,-16231
10700,0.0,0.0,0.0,1771,42800,26565,-16235
10701,0.0,0.0,0.0,1771,42804,26565,-16239
10702,1.0,1.0,1.0,1772,42808,26580,-16228
10703,0.0,0.0,0.25,1772,42812,26580,-16232
10704,1.0,1.0,1.0,1773,42816,26595,-16221
10705,1.0,1.0,0.6666666666666666,1774,42820,26610,-16210
10706,0.0,0.0,0.0,1774,42824,26610,-16214
10707,0.0,0.0,0.0,1774,42828,26610,-16218
10708,0.0,0.0,0.0,1774,42832,26610,-16222
10709,0.0,0.0,0.0,1774,42836,26610,-16226
10710,1.0,1.0,1.0,1775,42840,26625,-16215
10711,0.0,0.0,0.0,1775,42844,26625,-16219
10712,0.0,0.0,0.0,1775,42848,26625,-16223
10713,0.0,0.0,0.0,1775,42852,26625,-16227
10714,1.0,1.0,1.0,1776,42856,26640,-16216
10715,1.0,1.0,1.0,1777,42860,26655,-16205
10716,0.0,0.0,0.0,1777,42864,26655,-16209
10717,0.0,0.0,0.0,1777,42868,26655,-16213
10718,0.0,0.0,0.0,1777,42872,26655,-16217
10719,0.0,0.0,0.0,1777,42876,26655,-16221
10720,0.0,0.0,0.0,1777,42880,26655,-16225
10721,1.0,0.0,0.5,1778,42884,26670,-16214
10722,0.0,0.0,0.0,1778,42888,26670,-16218
10723,0.0,0.0,0.0,1778,42892,26670,-16222
10724,1.0,1.0,1.0,1779,42896,26685,-16211
10725,0.0,0.0,0.0,1779,42900,26685,-16215
10726,0.0,0.0,0.0,1779,42904,26685,-16219
10727,0.0,0.0,0.0,1779,42908,26685,-16223
10728,0.0,0.0,0.0,1779,42912,26685,-16227
10729,0.0,0.0,0.0,1779,42916,26685,-16231
10730,1.0,1.0,1.0,1780,42920,26700,-16220
10731,0.0,0.0,0.0,1780,42924,26700,-16224
10732,0.0,0.0,0.0,1780,42928,26700,-16228
10733,0.0,0.0,0.0,1780,42932,26700,-16232
10734,0.0,0.0,0.0,1780,42936,26700,-16236
10735,0.0,0.0,0.0,1780,42940,26700,-16240
10736,0.0,0.0,0.0,1780,42944,26700,-16244
10737,0.0,0.0,0.0,1780,42948,26700,-16248
10738,0.0,0.0,0.0,1780,42952,26700,-16252
10739,0.0,0.0,0.0,1780,42956,26700,-16256
10740,0.0,0.0,0.0,1780,42960,26700,-16260
10741,0.0,0.0,0.0,1780,42964,26700,-16264
10742,0.0,0.0,0.0,1780,42968,26700,-16268
10743,0.0,0.0,0.0,1780,42972,26700,-16272
10744,0.0,0.0,0.0,1780,42976,26700,-16276
10745,0.0,0.0,0.0,1780,42980,26700,-16280
10746,0.0,0.0,0.0,1780,42984,26700,-16284
10747,0.0,0.0,0.0,1780,42988,26700,-16288
10748,0.0,0.0,0.0,1780,42992,26700,-16292
10749,0.0,0.0,0.0,1780,42996,26700,-16296
10750,1.0,1.0,1.0,1781,43000,26715,-16285
10751,0.0,0.0,0.0,1781,43004,26715,-16289
10752,0.0,0.0,0.0,1781,43008,26715,-16293
10753,0.0,0.0,0.0,1781,43012,26715,-16297
10754,0.0,1.0,0.6666666666666666,1781,43016,26715,-16301
10755,0.0,0.0,0.0,1781,43020,26715,-16305
10756,0.0,0.0,0.0,1781,43024,26715,-16309
10757,0.0,0.0,0.0,1781,43028,26715,-16313
10758,1.0,1.0,1.0,1782,43032,26730,-16302
10759,0.0,0.0,0.0,1782,43036,26730,-16306
10760,0.0,0.0,0.0,1782,43040,26730,-16310
10761,1.0,1.0,1.0,1783,43044,26745,-16299
10762,0.0,0.0,0.0,1783,43048,26745,-16303
10763,0.0,0.0,0.0,1783,43052,26745,-16307
10764,0.0,0.0,0.0,1783,43056,26745,-16311
10765,0.0,0.0,0.0,1783,43060,26745,-16315
10766,0.0,0.0,0.0,1783,43064,26745,-16319
10767,0.0,0.0,0.0,1783,43068,26745,-16323
10768,1.0,1.0,1.0,1784,43072,26760,-16312
10769,0.0,0.0,0.0,1784,43076,26760,-16316
10770,0.0,0.0,0.0,1784,43080,26760,-16320
10771,1.0,1.0,1.0,1785,43084,26775,-16309
10772,0.0,0.0,0.0,1785,43088,26775,-16313
10773,0.0,0.0,0.0,1785,43092,26775,-16317
10774,1.0,1.0,1.0,1786,43096,26790,-16306
10775,0.0,0.0,0.0,1786,43100,26790,-16310
10776,0.0,0.0,0.0,1786,43104,26790,-16314
10777,0.0,0.0,0.0,1786,43108,26790,-16318
10778,0.0,0.0,0.0,1786,43112,26790,-16322
10779,0.0,0.0,0.0,1786,43116,26790,-16326
10780,0.0,0.0,0.0,1786,43120,26790,-16330
10781,1.0,1.0,0.8,1787,43124,26805,-16319
10782,1.0,1.0,1.0,1788,43128,26820,-16308
10783,1.0,1.0,1.0,1789,43132,26835,-16297
10784,0.0,0.0,0.3333333333333333,1789,43136,26835,-16301
10785,0.0,0.0,0.0,1789,43140,26835,-16305
10786,0.0,0.0,0.0,1789,43144,26835,-16309
10787,1.0,1.0,1.0,1790,43148,26850,-16298
10788,0.0,0.0,0.0,1790,43152,26850,-16302
10789,0.0,0.0,0.0,1790,43156,26850,-16306
10790,0.0,0.0,0.0,1790,43160,26850,-16310
10791,0.0,0.0,0.0,1790,43164,26850,-16314
10792,0.0,0.0,0.0,1790,43168,26850,-16318
10793,1.0,1.0,1.0,1791,43172,26865,-16307
10794,0.0,0.0,0.0,1791,43176,26865,-16311
10795,0.0,0.0,0.0,1791,43180,26865,-16315
10796,0.0,0.0,0.0,1791,43184,26865,-16319
10797,0.0,0.0,0.0,1791,43188,26865,-16323
10798,0.0,0.0,0.0,1791,43192,26865,-16327
10799,0.0,0.0,0.0,1791,43196,26865,-16331
10800,1.0,0.0,0.3333333333333333,1792,43200,26880,-16320
10801,0.0,0.0,0.0,1792,43204,26880,-16324
10802,0.0,0.0,0.0,1792,43208,26880,-16328
10803,0.0,0.0,0.0,1792,43212,26880,-16332
10804,0.0,0.0,0.0,1792,43216,26880,-16336
10805,0.0,0.0,0.0,1792,43220,26880,-16340
10806,1.0,1.0,1.0,1793,43224,26895,-16329
10807,0.0,0.0,0.0,1793,43228,26895,-16333
10808,0.0,0.0,0.0,1793,43232,26895,-16337
10809,0.0,0.0,0.0,1793,43236,26895,-16341
10810,0.0,0.0,0.2,1793,43240,26895,-16345
10811,0.0,0.0,0.0,1793,43244,26895,-16349
10812,0.0,0.0,0.0,1793,43248,26895,-16353
10813,0.0,0.0,0.0,1793,43252,26895,-16357
10814,0.0,0.0,0.0,1793,43256,26895,-16361
10815,0.0,0.0,0.3333333333333333,1793,43260,26895,-16365
10816,0.0,0.0,0.0,1793,43264,26895,-16369
10817,0.0,0.0,0.0,1793,43268,26895,-16373
10818,0.0,0.0,0.0,1793,43272,26895,-16377
10819,1.0,1.0,1.0,1794,43276,26910,-16366
10820,1.0,0.0,0.4,1795,43280,26925,-16355
10821,1.0,1.0,0.75,1796,43284,26940,-16344
10822,0.0,0.0,0.0,1796,43288,26940,-16348
10823,0.0,0.0,0.0,1796,43292,26940,-16352
10824,0.0,0.0,0.0,1796,43296,26940,-16356
10825,1.0,1.0,1.0,1797,43300,26955,-16345
10826,0.0,0.0,0.0,1797,43304,26955,-16349
10827,0.0,0.0,0.0,1797,43308,26955,-16353
10828,0.0,0.0,0.0,1797,43312,26955,-16357
10829,0.0,0.0,0.0,1797,43316,26955,-16361
10830,0.0,0.0,0.0,1797,43320,26955,-16365
10831,0.0,0.0,0.0,1797,43324,26955,-16369
10832,0.0,0.0,0.0,1797,43328,26955,-16373
10833,0.0,0.0,0.0,1797,43332,26955,-16377
10834,0.0,0.0,0.0,1797,43336,26955,-16381
10835,0.0,0.0,0.0,1797,43340,26955,-16385
10836,0.0,0.0,0.0,1797,43344,26955,-16389
10837,0.0,0.0,0.0,1797,43348,26955,-16393
10838,0.0,0.0,0.0,1797,43352,26955,-16397
10839,0.0,0.0,0.0,1797,43356,26955,-16401
10840,1.0,1.0,1.0,1798,43360,26970,-16390
10841,1.0,0.0,0.3333333333333333,1799,43364,26985,-16379
10842,0.0,0.0,0.0,1799,43368,26985,-16383
10843,0.0,0.0,0.0,1799,43372,26985,-16387
10844,0.0,0.0,0.0,1799,43376,26985,-16391
10845,1.0,1.0,0.6666666666666666,1800,43380,27000,-16380
10846,0.0,0.0,0.0,1800,43384,27000,-16384
10847,0.0,0.0,0.0,1800,43388,27000,-16388
10848,1.0,1.0,1.0,1801,43392,27015,-16377
10849,0.0,0.0,0.0,1801,43396,27015,-16381
10850,0.0,0.0,0.0,1801,43400,27015,-16385
10851,0.0,0.0,0.0,1801,43404,27015,-16389
10852,0.0,0.0,0.0,1801,43408,27015,-16393
10853,0.0,0.0,0.0,1801,43412,27015,-16397
10854,0.0,0.0,0.0,1801,43416,27015,-16401
10855,0.0,0.0,0.0,1801,43420,27015,-16405
10856,1.0,1.0,1.0,1802,43424,27030,-16394
10857,0.0,0.0,0.0,1802,43428,27030,-16398
10858,0.0,0.0,0.0,1802,43432,27030,-16402
10859,0.0,0.0,0.0,1802,43436,27030,-16406
10860,0.0,0.0,0.0,1802,43440,27030,-16410
10861,0.0,0.0,0.0,1802,43444,27030,-16414
10862,0.0,0.0,0.0,1802,43448,27030,-16418
10863,0.0,0.0,0.0,1802,43452,27030,-16422
10864,0.0,0.0,0.0,1802,43456,27030,-16426
10865,0.0,0.0,0.0,1802,43460,27030,-16430
10866,0.0,0.0,0.0,1802,43464,27030,-16434
10867,0.0,0.0,0.0,1802,43468,27030,-16438
10868,0.0,0.0,0.0,1802,43472,27030,-16442
10869,0.0,0.0,0.0,1802,43476,27030,-16446
10870,0.0,0.0,0.4,1802,43480,27030,-16450
10871,1.0,1.0,1.0,1803,43484,27045,-16439
10872,0.0,0.0,0.0,1803,43488,27045,-16443
10873,0.0,0.0,0.0,1803,43492,27045,-16447
10874,0.0,0.0,0.0,1803,43496,27045,-16451
10875,0.0,0.0,0.0,1803,43500,27045,-16455
10876,0.0,0.0,0.0,1803,43504,27045,-16459
10877,1.0,1.0,1.0,1804,43508,27060,-16448
10878,0.0,0.0,0.0,1804,43512,27060,-16452
10879,0.0,0.0,0.0,1804,43516,27060,-16456
10880,0.0,0.0,0.0,1804,43520,27060,-16460
10881,1.0,0.0,0.3333333333333333,1805,43524,27075,-16449
10882,0.0,0.0,0.0,1805,43528,27075,-16453
10883,0.0,0.0,0.0,1805,43532,27075,-16457
10884,0.0,0.0,0.0,1805,43536,27075,-16461
10885,0.0,0.0,0.0,1805,43540,27075,-16465
10886,0.0,0.0,0.0,1805,43544,27075,-16469
10887,1.0,1.0,0.6666666666666666,1806,43548,27090,-16458
10888,0.0,0.0,0.0,1806,43552,27090,-16462
10889,1.0,1.0,1.0,1807,43556,27105,-16451
10890,0.0,0.0,0.0,1807,43560,27105,-16455
10891,0.0,0.0,0.0,1807,43564,27105,-16459
10892,0.0,0.0,0.0,1807,43568,27105,-16463
10893,0.0,0.0,0.0,1807,43572,27105,-16467
10894,0.0,0.0,0.0,1807,43576,27105,-16471
10895,1.0,1.0,1.0,1808,43580,27120,-16460
10896,0.0,0.0,0.0,1808,43584,27120,-16464
10897,0.0,0.0,0.0,1808,43588,27120,-16468
10898,0.0,0.0,0.0,1808,43592,27120,-16472
10899,0.0,0.0,0.0,1808,43596,27120,-16476
10900,0.0,0.0,0.0,1808,43600,27120,-16480
10901,0.0,0.0,0.0,1808,43604,27120,-16484
10902,0.0,0.0,0.0,1808,43608,27120,-16488
10903,1.0,1.0,1.0,1809,43612,27135,-16477
10904,0.0,0.0,0.0,1809,43616,27135,-16481
10905,0.0,0.0,0.0,1809,43620,27135,-16485
10906,0.0,1.0,0.6666666666666666,1809,43624,27135,-16489
10907,0.0,0.0,0.0,1809,43628,27135,-16493
10908,1.0,1.0,0.6666666666666666,1810,43632,27150,-16482
10909,0.0,0.0,0.0,1810,43636,27150,-16486
10910,1.0,1.0,1.0,1811,43640,27165,-16475
10911,0.0,0.0,0.0,1811,43644,27165,-16479
10912,0.0,0.0,0.0,1811,43648,27165,-16483
10913,0.0,0.0,0.0,1811,43652,27165,-16487
10914,0.0,0.0,0.0,1811,43656,27165,-16491
10915,0.0,0.0,0.0,1811,43660,27165,-16495
10916,0.0,0.0,0.0,1811,43664,27165,-16499
10917,0.0,0.0,0.0,1811,43668,27165,-16503
10918,0.0,0.0,0.0,1811,43672,27165,-16507
10919,1.0,1.0,1.0,1812,43676,27180,-16496
10920,0.0,0.0,0.3333333333333333,1812,43680,27180,-16500
10921,0.0,0.0,0.0,1812,43684,27180,-16504
10922,0.0,0.0,0.0,1812,43688,27180,-16508
10923,0.0,0.0,0.0,1812,43692,27180,-16512
10924,0.0,0.0,0.0,1812,43696,27180,-16516
10925,1.0,1.0,1.0,1813,43700,27195,-16505
10926,0.0,0.0,0.0,1813,43704,27195,-16509
10927,0.0,0.0,0.0,1813,43708,27195,-16513
10928,0.0,0.0,0.0,1813,43712,27195,-16517
10929,0.0,0.0,0.0,1813,43716,27195,-16521
10930,0.0,0.0,0.0,1813,43720,27195,-16525
10931,0.0,0.0,0.0,1813,43724,27195,-16529
10932,0.0,0.0,0.0,1813,43728,27195,-16533
10933,0.0,0.0,0.0,1813,43732,27195,-16537
10934,0.0,0.0,0.0,1813,43736,27195,-16541
10935,0.0,0.0,0.0,1813,43740,27195,-16545
10936,0.0,0.0,0.0,1813,43744,27195,-16549
10937,0.0,0.0,0.0,1813,43748,27195,-16553
10938,0.0,0.0,0.0,1813,43752,27195,-16557
10939,0.0,0.0,0.0,1813,43756,27195,-16561
10940,1.0,1.0,1.0,1814,43760,27210,-16550
10941,0.0,0.0,0.0,1814,43764,27210,-16554
10942,0.0,0.0,0.0,1814,43768,27210,-16558
10943,0.0,0.0,0.0,1814,43772,27210,-16562
10944,0.0,0.0,0.0,1814,43776,27210,-16566
10945,0.0,0.0,0.0,1814,43780,27210,-16570
10946,0.0,0.0,0.0,1814,43784,27210,-16574
10947,0.0,0.0,0.0,1814,43788,27210,-16578
10948,0.0,0.0,0.0,1814,43792,27210,-16582
10949,1.0,1.0,1.0,1815,43796,27225,-16571
10950,0.0,0.0,0.0,1815,43800,27225,-16575
10951,1.0,1.0,1.0,1816,43804,27240,-16564
10952,0.0,0.0,0.0,1816,43808,27240,-16568
10953,0.0,0.0,0.0,1816,43812,27240,-16572
10954,0.0,0.0,0.0,1816,43816,27240,-16576
10955,0.0,0.0,0.0,1816,43820,27240,-16580
10956,0.0,0.0,0.0,1816,43824,27240,-16584
10957,0.0,0.0,0.0,1816,43828,27240,-16588
10958,0.0,0.0,0.0,1816,43832,27240,-16592
10959,0.0,0.0,0.0,1816,43836,27240,-16596
10960,0.0,0.0,0.3333333333333333,1816,43840,27240,-16600
10961,0.0,0.0,0.0,1816,43844,27240,-16604
10962,0.0,0.0,0.0,1816,43848,27240,-16608
10963,1.0,1.0,0.75,1817,43852,27255,-16597
10964,0.0,0.0,0.0,1817,43856,27255,-16601
10965,0.0,0.0,0.0,1817,43860,27255,-16605
10966,1.0,1.0,1.0,1818,43864,27270,-16594
10967,0.0,0.0,0.0,1818,43868,27270,-16598
10968,1.0,0.0,0.3333333333333333,1819,43872,27285,-16587
10969,0.0,0.0,0.0,1819,43876,27285,-16591
10970,0.0,0.0,0.0,1819,43880,27285,-16595
10971,1.0,1.0,0.6666666666666666,1820,43884,27300,-16584
10972,0.0,0.0,0.0,1820,43888,27300,-16588
10973,0.0,0.0,0.0,1820,43892,27300,-16592
10974,0.0,0.0,0.0,1820,43896,27300,-16596
10975,0.0,0.0,0.0,1820,43900,27300,-16600
10976,0.0,0.0,0.0,1820,43904,27300,-16604
10977,1.0,1.0,0.8,1821,43908,27315,-16593
10978,0.0,0.0,0.0,1821,43912,27315,-16597
10979,0.0,0.0,0.0,1821,43916,27315,-16601
10980,1.0,1.0,1.0,1822,43920,27330,-16590
10981,0.0,0.0,0.0,1822,43924,27330,-16594
10982,1.0,1.0,1.0,1823,43928,27345,-16583
10983,0.0,0.0,0.0,1823,43932,27345,-16587
10984,0.0,0.0,0.0,1823,43936,27345,-16591
10985,0.0,0.0,0.0,1823,43940,27345,-16595
10986,0.0,0.0,0.0,1823,43944,27345,-16599
10987,0.0,0.0,0.0,1823,43948,27345,-16603
10988,0.0,0.0,0.0,1823,43952,27345,-16607
10989,0.0,0.0,0.0,1823,43956,27345,-16611
10990,0.0,0.0,0.0,1823,43960,27345,-16615
10991,1.0,1.0,0.8,1824,43964,27360,-16604
10992,0.0,0.0,0.0,1824,43968,27360,-16608
10993,0.0,0.0,0.0,1824,43972,27360,-16612
10994,0.0,0.0,0.0,1824,43976,27360,-16616
10995,0.0,0.0,0.0,1824,43980,27360,-16620
10996,0.0,0.0,0.0,1824,43984,27360,-16624
10997,0.0,0.0,0.0,1824,43988,27360,-16628
10998,0.0,0.0,0.0,1824,43992,27360,-16632
10999,0.0,0.0,0.0,1824,43996,27360,-16636
11000,1.0,1.0,1.0,1825,44000,27375,-16625
11001,0.0,0.0,0.0,1825,44004,27375,-16629
11002,0.0,0.0,0.0,1825,44008,27375,-16633
11003,0.0,0.0,0.0,1825,44012,27375,-16637
11004,0.0,0.0,0.0,1825,44016,27375,-16641
11005,1.0,1.0,1.0,1826,44020,27390,-16630
11006,0.0,0.0,0.0,1826,44024,27390,-16634
11007,0.0,0.0,0.0,1826,44028,27390,-16638
11008,1.0,1.0,1.0,1827,44032,27405,-16627
11009,0.0,0.0,0.0,1827,44036,27405,-16631
11010,0.0,0.0,0.0,1827,44040,27405,-16635
11011,0.0,0.0,0.0,1827,44044,27405,-16639
11012,0.0,0.0,0.0,1827,44048,27405,-16643
11013,0.0,0.0,0.0,1827,44052,27405,-16647
11014,0.0,0.0,0.0,1827,44056,27405,-16651
11015,0.0,0.0,0.0,1827,44060,27405,-16655
11016,1.0,1.0,1.0,1828,44064,27420,-16644
11017,0.0,0.0,0.0,1828,44068,27420,-16648
11018,0.0,0.0,0.0,1828,44072,27420,-16652
11019,0.0,0.0,0.0,1828,44076,27420,-16656
11020,0.0,0.0,0.0,1828,44080,27420,-16660
11021,0.0,0.0,0.0,1828,44084,27420,-16664
11022,1.0,1.0,1.0,1829,44088,27435,-16653
11023,0.0,0.0,0.0,1829,44092,27435,-16657
11024,0.0,0.0,0.0,1829,44096,27435,-16661
11025,0.0,0.0,0.0,1829,44100,27435,-16665
11026,0.0,0.0,0.0,1829,44104,27435,-16669
11027,0.0,0.0,0.0,1829,44108,27435,-16673
11028,0.0,0.0,0.0,1829,44112,27435,-16677
11029,0.0,0.0,0.0,1829,44116,27435,-16681
11030,0.0,0.0,0.0,1829,44120,27435,-16685
11031,0.0,0.0,0.0,1829,44124,27435,-16689
11032,0.0,0.0,0.0,1829,44128,27435,-16693
11033,1.0,1.0,1.0,1830,44132,27450,-16682
11034,0.0,0.0,0.0,1830,44136,27450,-16686
11035,1.0,1.0,1.0,1831,44140,27465,-16675
11036,0.0,0.0,0.0,1831,44144,27465,-16679
11037,0.0,0.0,0.0,1831,44148,27465,-16683
11038,0.0,0.0,0.0,1831,44152,27465,-16687
11039,0.0,0.0,0.0,1831,44156,27465,-16691
11040,0.0,0.0,0.0,1831,44160,27465,-16695
11041,0.0,0.0,0.0,1831,44164,27465,-16699
11042,0.0,0.0,0.0,1831,44168,27465,-16703
11043,0.0,0.0,0.0,1831,44172,27465,-16707
11044,0.0,0.0,0.25,1831,44176,27465,-16711
11045,0.0,0.0,0.0,1831,44180,27465,-16715
11046,0.0,0.0,0.0,1831,44184,27465,-16719
11047,1.0,1.0,1.0,1832,44188,27480,-16708
11048,1.0,1.0,1.0,1833,44192,27495,-16697
11049,0.0,0.0,0.0,1833,44196,27495,-16701
11050,0.0,0.0,0.0,1833,44200,27495,-16705
11051,0.0,0.0,0.0,1833,44204,27495,-16709
11052,1.0,1.0,1.0,1834,44208,27510,-16698
11053,0.0,0.0,0.0,1834,44212,27510,-16702
11054,1.0,1.0,1.0,1835,44216,27525,-16691
11055,0.0,0.0,0.0,1835,44220,27525,-16695
11056,1.0,1.0,0.8,1836,44224,27540,-16684
11057,0.0,0.0,0.0,1836,44228,27540,-16688
11058,0.0,0.0,0.0,1836,44232,27540,-16692
11059,0.0,0.0,0.0,1836,44236,27540,-16696
11060,0.0,0.0,0.0,1836,44240,27540,-16700
11061,1.0,1.0,0.6666666666666666,1837,44244,27555,-16689
11062,0.0,0.0,0.0,1837,44248,27555,-16693
11063,0.0,0.0,0.0,1837,44252,27555,-16697
11064,0.0,0.0,0.0,1837,44256,27555,-16701
11065,1.0,0.0,0.3333333333333333,1838,44260,27570,-16690
11066,0.0,0.0,0.0,1838,44264,27570,-16694
11067,0.0,0.0,0.0,1838,44268,27570,-16698
11068,0.0,0.0,0.0,1838,44272,27570,-16702
11069,0.0,0.0,0.0,1838,44276,27570,-16706
11070,0.0,0.0,0.0,1838,44280,27570,-16710
11071,0.0,0.0,0.0,1838,44284,27570,-16714
11072,0.0,0.0,0.0,1838,44288,27570,-16718
11073,1.0,1.0,0.8,1839,44292,27585,-16707
11074,0.0,0.0,0.0,1839,44296,27585,-16711
11075,0.0,0.0,0.0,1839,44300,27585,-16715
11076,0.0,0.0,0.0,1839,44304,27585,-16719
11077,0.0,0.0,0.0,1839,44308,27585,-16723
11078,0.0,0.0,0.0,1839,44312,27585,-16727
11079,0.0,0.0,0.0,1839,44316,27585,-16731
11080,0.0,0.0,0.4,1839,44320,27585,-16735
11081,0.0,0.0,0.0,1839,44324,27585,-16739
11082,1.0,1.0,1.0,1840,44328,27600,-16728
11083,0.0,0.0,0.0,1840,44332,27600,-16732
11084,0.0,0.0,0.0,1840,44336,27600,-16736
11085,1.0,1.0,1.0,1841,44340,27615,-16725
11086,1.0,1.0,1.0,1842,44344,27630,-16714
11087,0.0,0.0,0.0,1842,44348,27630,-16718
11088,0.0,0.0,0.0,1842,44352,27630,-16722
11089,0.0,0.0,0.0,1842,44356,27630,-16726
11090,0.0,0.0,0.0,1842,44360,27630,-16730
11091,0.0,0.0,0.0,1842,44364,27630,-16734
11092,0.0,0.0,0.0,1842,44368,27630,-16738
11093,0.0,0.0,0.0,1842,44372,27630,-16742
11094,0.0,0.0,0.0,1842,44376,27630,-16746
11095,0.0,0.0,0.0,1842,44380,27630,-16750
11096,0.0,0.0,0.0,1842,44384,27630,-16754
11097,1.0,1.0,1.0,1843,44388,27645,-16743
11098,0.0,0.0,0.0,1843,44392,27645,-16747
11099,0.0,0.0,0.0,1843,44396,27645,-16751
11100,0.0,0.0,0.0,1843,44400,27645,-16755
11101,1.0,1.0,1.0,1844,44404,27660,-16744
11102,0.0,0.0,0.0,1844,44408,27660,-16748
11103,0.0,0.0,0.0,1844,44412,27660,-16752
11104,0.0,0.0,0.0,1844,44416,27660,-16756
11105,0.0,0.0,0.3333333333333333,1844,44420,27660,-16760
11106,0.0,0.0,0.0,1844,44424,27660,-16764
11107,0.0,0.0,0.0,1844,44428,27660,-16768
11108,0.0,0.0,0.0,1844,44432,27660,-16772
11109,0.0,0.0,0.0,1844,44436,27660,-16776
11110,0.0,0.0,0.0,1844,44440,27660,-16780
11111,0.0,0.0,0.0,1844,44444,27660,-16784
11112,0.0,0.0,0.0,1844,44448,27660,-16788
11113,0.0,0.0,0.0,1844,44452,27660,-16792
11114,0.0,0.0,0.0,1844,44456,27660,-16796
11115,0.0,0.0,0.0,1844,44460,27660,-16800
11116,0.0,0.0,0.0,1844,44464,27660,-16804
11117,0.0,0.0,0.0,1844,44468,27660,-16808
11118,0.0,0.0,0.0,1844,44472,27660,-16812
11119,0.0,0.0,0.0,1844,44476,27660,-16816
11120,0.0,0.0,0.0,1844,44480,27660,-16820
11121,0.0,0.0,0.0,1844,44484,27660,-16824
11122,1.0,1.0,0.75,1845,44488,27675,-16813
11123,0.0,0.0,0.0,1845,44492,27675,-16817
11124,0.0,0.0,0.0,1845,44496,27675,-16821
11125,0.0,0.0,0.0,1845,44500,27675,-16825
11126,0.0,0.0,0.0,1845,44504,27675,-16829
11127,0.0,0.0,0.0,1845,44508,27675,-16833
11128,0.0,0.0,0.0,1845,44512,27675,-16837
11129,0.0,0.0,0.0,1845,44516,27675,-16841
11130,0.0,0.0,0.0,1845,44520,27675,-16845
11131,1.0,1.0,1.0,1846,44524,27690,-16834
11132,0.0,0.0,0.0,1846,44528,27690,-16838
11133,0.0,0.0,0.0,1846,44532,27690,-16842
11134,0.0,0.0,0.0,1846,44536,27690,-16846
11135,0.0,0.0,0.0,1846,44540,27690,-16850
11136,0.0,0.0,0.0,1846,44544,27690,-16854
11137,0.0,0.0,0.0,1846,44548,27690,-16858
11138,0.0,0.0,0.0,1846,44552,27690,-16862
11139,0.0,0.0,0.0,1846,44556,27690,-16866
11140,1.0,1.0,1.0,1847,44560,27705,-16855
11141,0.0,0.0,0.2,1847,44564,27705,-16859
11142,0.0,1.0,0.75,1847,44568,27705,-16863
11143,0.0,0.0,0.0,1847,44572,27705,-16867
11144,0.0,0.0,0.0,1847,44576,27705,-16871
11145,0.0,0.0,0.0,1847,44580,27705,-16875
11146,1.0,1.0,1.0,1848,44584,27720,-16864
11147,1.0,1.0,1.0,1849,44588,27735,-16853
11148,0.0,0.0,0.0,1849,44592,27735,-16857
11149,0.0,0.0,0.0,1849,44596,27735,-16861
11150,0.0,0.0,0.0,1849,44600,27735,-16865
11151,0.0,0.0,0.0,1849,44604,27735,-16869
11152,0.0,0.0,0.0,1849,44608,27735,-16873
11153,1.0,1.0,0.6666666666666666,1850,44612,27750,-16862
11154,0.0,0.0,0.0,1850,44616,27750,-16866
11155,1.0,1.0,1.0,1851,44620,27765,-16855
11156,0.0,0.0,0.0,1851,44624,27765,-16859
11157,0.0,0.0,0.0,1851,44628,27765,-16863
11158,0.0,0.0,0.0,1851,44632,27765,-16867
11159,0.0,0.0,0.0,1851,44636,27765,-16871
11160,0.0,0.0,0.0,1851,44640,27765,-16875
11161,0.0,0.0,0.0,1851,44644,27765,-16879
11162,0.0,0.0,0.0,1851,44648,27765,-16883
11163,0.0,0.0,0.0,1851,44652,27765,-16887
11164,1.0,1.0,1.0,1852,44656,27780,-16876
11165,1.0,1.0,1.0,1853,44660,27795,-16865
11166,0.0,0.0,0.0,1853,44664,27795,-16869
11167,0.0,0.0,0.0,1853,44668,27795,-16873
11168,1.0,1.0,1.0,1854,44672,27810,-16862
11169,0.0,0.0,0.0,1854,44676,27810,-16866
11170,0.0,0.0,0.0,1854,44680,27810,-16870
11171,0.0,0.0,0.0,1854,44684,27810,-16874
11172,0.0,0.0,0.0,1854,44688,27810,-16878
11173,1.0,1.0,1.0,1855,44692,27825,-16867
11174,1.0,1.0,0.6666666666666666,1856,44696,27840,-16856
11175,0.0,0.0,0.0,1856,44700,27840,-16860
11176,0.0,0.0,0.0,1856,44704,27840,-16864
11177,0.0,0.0,0.25,1856,44708,27840,-16868
11178,0.0,0.0,0.0,1856,44712,27840,-16872
11179,1.0,1.0,1.0,1857,44716,27855,-16861
11180,0.0,0.0,0.0,1857,44720,27855,-16865
11181,0.0,0.0,0.0,1857,44724,27855,-16869
11182,1.0,0.0,0.5,1858,44728,27870,-16858
11183,0.0,0.0,0.0,1858,44732,27870,-16862
11184,0.0,0.0,0.0,1858,44736,27870,-16866
11185,1.0,1.0,1.0,1859,44740,27885,-16855
11186,0.0,0.0,0.0,1859,44744,27885,-16859
11187,1.0,1.0,0.8,1860,44748,27900,-16848
11188,1.0,1.0,1.0,1861,44752,27915,-16837
11189,1.0,1.0,0.6666666666666666,1862,44756,27930,-16826
11190,0.0,0.0,0.0,1862,44760,27930,-16830
11191,0.0,0.0,0.0,1862,44764,27930,-16834
11192,0.0,0.0,0.0,1862,44768,27930,-16838
11193,0.0,0.0,0.0,1862,44772,27930,-16842
11194,0.0,0.0,0.0,1862,44776,27930,-16846
11195,0.0,0.0,0.0,1862,44780,27930,-16850
11196,0.0,0.0,0.4,1862,44784,27930,-16854
11197,0.0,0.0,0.0,1862,44788,27930,-16858
11198,0.0,0.0,0.0,1862,44792,27930,-16862
11199,1.0,1.0,1.0,1863,44796,27945,-16851
11200,0.0,0.0,0.3333333333333333,1863,44800,27945,-16855
11201,0.0,0.0,0.0,1863,44804,27945,-16859
11202,1.0,0.0,0.5,1864,44808,27960,-16848
11203,1.0,0.0,0.3333333333333333,1865,44812,27975,-16837
11204,1.0,1.0,1.0,1866,44816,27990,-16826
11205,0.0,0.0,0.0,1866,44820,27990,-16830
11206,0.0,0.0,0.0,1866,44824,27990,-16834
11207,1.0,1.0,1.0,1867,44828,28005,-16823
11208,0.0,0.0,0.0,1867,44832,28005,-16827
11209,0.0,0.0,0.0,1867,44836,28005,-16831
11210,0.0,0.0,0.0,1867,44840,28005,-16835
11211,0.0,0.0,0.0,1867,44844,28005,-16839
11212,0.0,0.0,0.0,1867,44848,28005,-16843
11213,0.0,0.0,0.0,1867,44852,28005,-16847
11214,0.0,0.0,0.0,1867,44856,28005,-16851
11215,0.0,0.0,0.0,1867,44860,28005,-16855
11216,0.0,0.0,0.0,1867,44864,28005,-16859
11217,0.0,0.0,0.0,1867,44868,28005,-16863
11218,0.0,0.0,0.0,1867,44872,28005,-16867
11219,0.0,0.0,0.0,1867,44876,28005,-16871
11220,0.0,0.0,0.5,1867,44880,28005,-16875
11221,1.0,0.0,0.25,1868,44884,28020,-16864
11222,0.0,0.0,0.0,1868,44888,28020,-16868
11223,0.0,0.0,0.0,1868,44892,28020,-16872
11224,0.0,0.0,0.0,1868,44896,28020,-16876
11225,0.0,0.0,0.0,1868,44900,28020,-16880
11226,1.0,1.0,1.0,1869,44904,28035,-16869
11227,0.0,0.0,0.0,1869,44908,28035,-16873
11228,0.0,0.0,0.0,1869,44912,28035,-16877
11229,1.0,1.0,1.0,1870,44916,28050,-16866
11230,1.0,1.0,1.0,1871,44920,28065,-16855
11231,0.0,0.0,0.0,1871,44924,28065,-16859
11232,0.0,0.0,0.0,1871,44928,28065,-16863
11233,0.0,0.0,0.0,1871,44932,28065,-16867
11234,0.0,0.0,0.0,1871,44936,28065,-16871
11235,1.0,1.0,1.0,1872,44940,28080,-16860
11236,0.0,0.0,0.0,1872,44944,28080,-16864
11237,0.0,0.0,0.0,1872,44948,28080,-16868
11238,0.0,0.0,0.0,1872,44952,28080,-16872
11239,0.0,0.0,0.0,1872,44956,28080,-16876
11240,0.0,0.0,0.0,1872,44960,28080,-16880
11241,0.0,0.0,0.0,1872,44964,28080,-16884
11242,0.0,0.0,0.0,1872,44968,28080,-16888
11243,0.0,0.0,0.0,1872,44972,28080,-16892
11244,0.0,0.0,0.0,1872,44976,28080,-16896
11245,1.0,1.0,0.6,1873,44980,28095,-16885
11246,1.0,1.0,1.0,1874,44984,28110,-16874
11247,0.0,0.0,0.0,1874,44988,28110,-16878
11248,0.0,0.0,0.0,1874,44992,28110,-16882
11249,0.0,0.0,0.3333333333333333,1874,44996,28110,-16886
11250,0.0,0.0,0.0,1874,45000,28110,-16890
11251,0.0,0.0,0.0,1874,45004,28110,-16894
11252,0.0,0.0,0.0,1874,45008,28110,-16898
11253,0.0,0.0,0.0,1874,45012,28110,-16902
11254,0.0,0.0,0.0,1874,45016,28110,-16906
11255,0.0,0.0,0.0,1874,45020,28110,-16910
11256,0.0,0.0,0.0,1874,45024,28110,-16914
11257,0.0,0.0,0.0,1874,45028,28110,-16918
11258,1.0,1.0,1.0,1875,45032,28125,-16907
11259,0.0,0.0,0.0,1875,45036,28125,-16911
11260,0.0,0.0,0.0,1875,45040,28125,-16915
11261,0.0,0.0,0.0,1875,45044,28125,-16919
11262,1.0,1.0,1.0,1876,45048,28140,-16908
11263,0.0,0.0,0.3333333333333333,1876,45052,28140,-16912
11264,0.0,0.0,0.0,1876,45056,28140,-16916
11265,1.0,1.0,1.0,1877,45060,28155,-16905
11266,0.0,0.0,0.0,1877,45064,28155,-16909
11267,0.0,0.0,0.0,1877,45068,28155,-16913
11268,1.0,0.0,0.4,1878,45072,28170,-16902
11269,0.0,0.0,0.0,1878,45076,28170,-16906
11270,1.0,1.0,1.0,1879,45080,28185,-16895
11271,0.0,0.0,0.0,1879,45084,28185,-16899
11272,1.0,1.0,1.0,1880,45088,28200,-16888
11273,0.0,0.0,0.0,1880,45092,28200,-16892
11274,0.0,0.0,0.0,1880,45096,28200,-16896
11275,0.0,0.0,0.0,1880,45100,28200,-16900
11276,0.0,0.0,0.0,1880,45104,28200,-16904
11277,1.0,0.0,0.3333333333333333,1881,45108,28215,-16893
11278,1.0,0.0,0.3333333333333333,1882,45112,28230,-16882
11279,0.0,0.0,0.0,1882,45116,28230,-16886
11280,0.0,0.0,0.0,1882,45120,28230,-16890
11281,1.0,1.0,1.0,1883,45124,28245,-16879
11282,0.0,0.0,0.0,1883,45128,28245,-16883
11283,0.0,0.0,0.0,1883,45132,28245,-16887
11284,0.0,0.0,0.0,1883,45136,28245,-16891
11285,0.0,0.0,0.0,1883,45140,28245,-16895
11286,0.0,0.0,0.0,1883,45144,28245,-16899
11287,0.0,0.0,0.0,1883,45148,28245,-16903
11288,0.0,0.0,0.0,1883,45152,28245,-16907
11289,0.0,0.0,0.0,1883,45156,28245,-16911
11290,0.0,0.0,0.0,1883,45160,28245,-16915
11291,0.0,0.0,0.25,1883,45164,28245,-16919
11292,1.0,1.0,0.75,1884,45168,28260,-16908
11293,0.0,0.0,0.0,1884,45172,28260,-16912
11294,0.0,0.0,0.0,1884,45176,28260,-16916
11295,0.0,0.0,0.0,1884,45180,28260,-16920
11296,1.0,1.0,1.0,1885,45184,28275,-16909
11297,1.0,1.0,1.0,1886,45188,28290,-16898
11298,0.0,0.0,0.0,1886,45192,28290,-16902
11299,0.0,0.0,0.0,1886,45196,28290,-16906
11300,0.0,0.0,0.0,1886,45200,28290,-16910
11301,0.0,0.0,0.0,1886,45204,28290,-16914
11302,0.0,0.0,0.0,1886,45208,28290,-16918
11303,1.0,1.0,1.0,1887,45212,28305,-16907
11304,0.0,0.0,0.0,1887,45216,28305,-16911
11305,1.0,1.0,1.0,1888,45220,28320,-16900
11306,0.0,0.0,0.0,1888,45224,28320,-16904
11307,0.0,0.0,0.0,1888,45228,28320,-16908
11308,0.0,0.0,0.0,1888,45232,28320,-16912
11309,0.0,0.0,0.0,1888,45236,28320,-16916
11310,0.0,0.0,0.0,1888,45240,28320,-16920
11311,0.0,0.0,0.0,1888,45244,28320,-16924
11312,0.0,0.0,0.0,1888,45248,28320,-16928
11313,0.0,0.0,0.0,1888,45252,28320,-16932
11314,0.0,0.0,0.0,1888,45256,28320,-16936
11315,0.0,0.0,0.0,1888,45260,28320,-16940
11316,0.0,0.0,0.0,1888,45264,28320,-16944
11317,0.0,0.0,0.0,1888,45268,28320,-16948
11318,0.0,0.0,0.0,1888,45272,28320,-16952
11319,0.0,0.0,0.0,1888,45276,28320,-16956
11320,0.0,0.0,0.0,1888,45280,28320,-16960
11321,0.0,0.0,0.0,1888,45284,28320,-16964
11322,0.0,0.0,0.0,1888,45288,28320,-16968
11323,0.0,0.0,0.0,1888,45292,28320,-16972
11324,0.0,0.0,0.0,1888,45296,28320,-16976
11325,0.0,0.0,0.0,1888,45300,28320,-16980
11326,0.0,0.0,0.0,1888,45304,28320,-16984
11327,1.0,1.0,1.0,1889,45308,28335,-16973
11328,0.0,0.0,0.0,1889,45312,28335,-16977
11329,0.0,0.0,0.0,1889,45316,28335,-16981
11330,0.0,0.0,0.0,1889,45320,28335,-16985
11331,0.0,0.0,0.0,1889,45324,28335,-16989
11332,0.0,0.0,0.0,1889,45328,28335,-16993
11333,0.0,0.0,0.0,1889,45332,28335,-16997
11334,0.0,0.0,0.0,1889,45336,28335,-17001
11335,1.0,1.0,1.0,1890,45340,28350,-16990
11336,0.0,0.0,0.0,1890,45344,28350,-16994
11337,1.0,1.0,1.0,1891,45348,28365,-16983
11338,0.0,0.0,0.0,1891,45352,28365,-16987
11339,0.0,0.0,0.0,1891,45356,28365,-16991
11340,0.0,0.0,0.0,1891,45360,28365,-16995
11341,0.0,0.0,0.0,1891,45364,28365,-16999
11342,0.0,0.0,0.0,1891,45368,28365,-17003
11343,1.0,1.0,1.0,1892,45372,28380,-16992
11344,0.0,0.0,0.0,1892,45376,28380,-16996
11345,0.0,1.0,0.75,1892,45380,28380,-17000
11346,0.0,0.0,0.0,1892,45384,28380,-17004
11347,0.0,0.0,0.0,1892,45388,28380,-17008
11348,0.0,0.0,0.0,1892,45392,28380,-17012
11349,0.0,0.0,0.0,1892,45396,28380,-17016
11350,0.0,0.0,0.0,1892,45400,28380,-17020
11351,1.0,1.0,1.0,1893,45404,28395,-17009
11352,1.0,1.0,1.0,1894,45408,28410,-16998
11353,1.0,0.0,0.5,1895,45412,28425,-16987
11354,0.0,0.0,0.0,1895,45416,28425,-16991
11355,0.0,0.0,0.0,1895,45420,28425,-16995
11356,1.0,1.0,1.0,1896,45424,28440,-16984
11357,0.0,0.0,0.0,1896,45428,28440,-16988
11358,0.0,0.0,0.0,1896,45432,28440,-16992
11359,1.0,1.0,1.0,1897,45436,28455,-16981
11360,1.0,0.0,0.5,1898,45440,28470,-16970
11361,0.0,0.0,0.0,1898,45444,28470,-16974
11362,0.0,0.0,0.0,1898,45448,28470,-16978
11363,0.0,0.0,0.0,1898,45452,28470,-16982
11364,0.0,0.0,0.0,1898,45456,28470,-16986
11365,0.0,1.0,0.6666666666666666,1898,45460,28470,-16990
11366,1.0,1.0,1.0,1899,45464,28485,-16979
11367,1.0,1.0,1.0,1900,45468,28500,-16968
11368,0.0,0.0,0.4,1900,45472,28500,-16972
11369,0.0,0.0,0.3333333333333333,1900,45476,28500,-16976
11370,0.0,0.0,0.0,1900,45480,28500,-16980
11371,0.0,0.0,0.0,1900,45484,28500,-16984
11372,0.0,0.0,0.3333333333333333,1900,45488,28500,-16988
11373,1.0,1.0,1.0,1901,45492,28515,-16977
11374,1.0,1.0,0.75,1902,45496,28530,-16966
11375,0.0,0.0,0.0,1902,45500,28530,-16970
11376,0.0,0.0,0.0,1902,45504,28530,-16974
11377,0.0,0.0,0.0,1902,45508,28530,-16978
11378,0.0,0.0,0.0,1902,45512,28530,-16982
11379,0.0,0.0,0.0,1902,45516,28530,-16986
11380,1.0,1.0,1.0,1903,45520,28545,-16975
11381,0.0,0.0,0.0,1903,45524,28545,-16979
11382,0.0,0.0,0.0,1903,45528,28545,-16983
11383,0.0,0.0,0.25,1903,45532,28545,-16987
11384,1.0,1.0,0.8,1904,45536,28560,-16976
11385,1.0,1.0,1.0,1905,45540,28575,-16965
11386,1.0,1.0,1.0,1906,45544,28590,-16954
11387,1.0,1.0,0.6,1907,45548,28605,-16943
11388,0.0,0.0,0.0,1907,45552,28605,-16947
11389,1.0,1.0,1.0,1908,45556,28620,-16936
11390,0.0,0.0,0.0,1908,45560,28620,-16940
11391,0.0,0.0,0.0,1908,45564,28620,-16944
11392,1.0,1.0,1.0,1909,45568,28635,-16933
11393,0.0,0.0,0.0,1909,45572,28635,-16937
11394,0.0,0.0,0.0,1909,45576,28635,-16941
11395,0.0,0.0,0.0,1909,45580,28635,-16945
11396,0.0,0.0,0.0,1909,45584,28635,-16949
11397,1.0,1.0,0.6,1910,45588,28650,-16938
11398,1.0,1.0,0.8,1911,45592,28665,-16927
11399,1.0,1.0,0.75,1912,45596,28680,-16916
11400,0.0,0.0,0.0,1912,45600,28680,-16920
11401,0.0,0.0,0.0,1912,45604,28680,-16924
11402,0.0,0.0,0.0,1912,45608,28680,-16928
11403,0.0,0.0,0.0,1912,45612,28680,-16932
11404,0.0,0.0,0.0,1912,45616,28680,-16936
11405,0.0,0.0,0.0,1912,45620,28680,-16940
11406,0.0,0.0,0.0,1912,45624,28680,-16944
11407,0.0,0.0,0.0,1912,45628,28680,-16948
11408,0.0,0.0,0.0,1912,45632,28680,-16952
11409,0.0,0.0,0.0,1912,45636,28680,-16956
11410,1.0,1.0,1.0,1913,45640,28695,-16945
11411,0.0,0.0,0.0,1913,45644,28695,-16949
11412,0.0,0.0,0.0,1913,45648,28695,-16953
11413,1.0,0.0,0.4,1914,45652,28710,-16942
11414,0.0,0.0,0.0,1914,45656,28710,-16946
11415,0.0,0.0,0.0,1914,45660,28710,-16950
11416,1.0,1.0,1.0,1915,45664,28725,-16939
11417,1.0,1.0,1.0,1916,45668,28740,-16928
11418,0.0,0.0,0.0,1916,45672,28740,-16932
11419,0.0,0.0,0.0,1916,45676,28740,-16936
11420,0.0,0.0,0.0,1916,45680,28740,-16940
11421,0.0,0.0,0.0,1916,45684,28740,-16944
11422,0.0,0.0,0.0,1916,45688,28740,-16948
11423,0.0,0.0,0.0,1916,45692,28740,-16952
11424,0.0,0.0,0.0,1916,45696,28740,-16956
11425,0.0,0.0,0.0,1916,45700,28740,-16960
11426,0.0,0.0,0.0,1916,45704,28740,-16964
11427,0.0,0.0,0.0,1916,45708,28740,-16968
11428,0.0,0.0,0.0,1916,45712,28740,-16972
11429,0.0,0.0,0.0,1916,45716,28740,-16976
11430,0.0,0.0,0.0,1916,45720,28740,-16980
11431,1.0,1.0,1.0,1917,45724,28755,-16969
11432,0.0,0.0,0.0,1917,45728,28755,-16973
11433,0.0,0.0,0.0,1917,45732,28755,-16977
11434,0.0,0.0,0.0,1917,45736,28755,-16981
11435,0.0,0.0,0.0,1917,45740,28755,-16985
11436,0.0,0.0,0.0,1917,45744,28755,-16989
11437,0.0,0.0,0.0,1917,45748,28755,-16993
11438,0.0,0.0,0.0,1917,45752,28755,-16997
11439,1.0,1.0,1.0,1918,45756,28770,-16986
11440,0.0,0.0,0.0,1918,45760,28770,-16990
11441,0.0,0.0,0.0,1918,45764,28770,-16994
11442,0.0,0.0,0.0,1918,45768,28770,-16998
11443,0.0,0.0,0.0,1918,45772,28770,-17002
11444,0.0,0.0,0.0,1918,45776,28770,-17006
11445,0.0,0.0,0.0,1918,45780,28770,-17010
11446,0.0,0.0,0.0,1918,45784,28770,-17014
11447,0.0,0.0,0.0,1918,45788,28770,-17018
11448,0.0,0.0,0.0,1918,45792,28770,-17022
11449,0.0,0.0,0.4,1918,45796,28770,-17026
11450,0.0,0.0,0.0,1918,45800,28770,-17030
11451,0.0,0.0,0.0,1918,45804,28770,-17034
11452,0.0,0.0,0.0,1918,45808,28770,-17038
11453,0.0,0.0,0.0,1918,45812,28770,-17042
11454,0.0,0.0,0.0,1918,45816,28770,-17046
11455,0.0,0.0,0.0,1918,45820,28770,-17050
11456,1.0,1.0,1.0,1919,45824,28785,-17039
11457,1.0,1.0,1.0,1920,45828,28800,-17028
11458,0.0,0.0,0.0,1920,45832,28800,-17032
11459,0.0,0.0,0.0,1920,45836,28800,-17036
11460,0.0,0.0,0.0,1920,45840,28800,-17040
11461,0.0,0.0,0.0,1920,45844,28800,-17044
11462,0.0,1.0,0.6,1920,45848,28800,-17048
11463,0.0,0.0,0.0,1920,45852,28800,-17052
11464,0.0,0.0,0.0,1920,45856,28800,-17056
11465,0.0,0.0,0.0,1920,45860,28800,-17060
11466,0.0,0.0,0.0,1920,45864,28800,-17064
11467,0.0,0.0,0.0,1920,45868,28800,-17068
11468,0.0,0.0,0.0,1920,45872,28800,-17072
11469,0.0,0.0,0.3333333333333333,1920,45876,28800,-17076
11470,1.0,1.0,0.6,1921,45880,28815,-17065
11471,0.0,0.0,0.0,1921,45884,28815,-17069
11472,0.0,0.0,0.0,1921,45888,28815,-17073
11473,0.0,0.0,0.0,1921,45892,28815,-17077
11474,0.0,0.0,0.0,1921,45896,28815,-17081
11475,0.0,0.0,0.0,1921,45900,28815,-17085
11476,1.0,1.0,1.0,1922,45904,28830,-17074
11477,0.0,0.0,0.4,1922,45908,28830,-17078
11478,0.0,0.0,0.0,1922,45912,28830,-17082
11479,0.0,0.0,0.3333333333333333,1922,45916,28830,-17086
11480,0.0,0.0,0.0,1922,45920,28830,-17090
11481,0.0,0.0,0.0,1922,45924,28830,-17094
11482,1.0,1.0,1.0,1923,45928,28845,-17083
11483,0.0,0.0,0.0,1923,45932,28845,-17087
11484,0.0,0.0,0.0,1923,45936,28845,-17091
11485,0.0,0.0,0.0,1923,45940,28845,-17095
11486,0.0,0.0,0.0,1923,45944,28845,-17099
11487,0.0,0.0,0.0,1923,45948,28845,-17103
11488,1.0,1.0,1.0,1924,45952,28860,-17092
11489,0.0,0.0,0.0,1924,45956,28860,-17096
11490,0.0,0.0,0.0,1924,45960,28860,-17100
11491,0.0,0.0,0.0,1924,45964,28860,-17104
11492,0.0,0.0,0.0,1924,45968,28860,-17108
11493,0.0,0.0,0.0,1924,45972,28860,-17112
11494,1.0,1.0,0.6,1925,45976,28875,-17101
11495,0.0,0.0,0.0,1925,45980,28875,-17105
11496,0.0,0.0,0.0,1925,45984,28875,-17109
11497,0.0,0.0,0.0,1925,45988,28875,-17113
11498,0.0,0.0,0.0,1925,45992,28875,-17117
11499,0.0,0.0,0.0,1925,45996,28875,-17121
11500,1.0,1.0,1.0,1926,46000,28890,-17110
11501,1.0,0.0,0.4,1927,46004,28905,-17099
11502,0.0,0.0,0.0,1927,46008,28905,-17103
11503,0.0,1.0,0.6666666666666666,1927,46012,28905,-17107
11504,0.0,0.0,0.0,1927,46016,28905,-17111
11505,0.0,0.0,0.0,1927,46020,28905,-17115
11506,0.0,0.0,0.0,1927,46024,28905,-17119
11507,0.0,0.0,0.0,1927,46028,28905,-17123
11508,0.0,0.0,0.0,1927,46032,28905,-17127
11509,0.0,0.0,0.0,1927,46036,28905,-17131
11510,0.0,0.0,0.0,1927,46040,28905,-17135
11511,0.0,0.0,0.0,1927,46044,28905,-17139
11512,0.0,0.0,0.0,1927,46048,28905,-17143
11513,1.0,1.0,1.0,1928,46052,28920,-17132
11514,0.0,0.0,0.0,1928,46056,28920,-17136
11515,1.0,1.0,1.0,1929,46060,28935,-17125
11516,0.0,0.0,0.0,1929,46064,28935,-17129
11517,0.0,0.0,0.0,1929,46068,28935,-17133
11518,0.0,0.0,0.0,1929,46072,28935,-17137
11519,0.0,0.0,0.0,1929,46076,28935,-17141
11520,0.0,1.0,0.6,1929,46080,28935,-17145
11521,0.0,0.0,0.0,1929,46084,28935,-17149
11522,1.0,1.0,1.0,1930,46088,28950,-17138
11523,0.0,0.0,0.0,1930,46092,28950,-17142
11524,0.0,0.0,0.0,1930,46096,28950,-17146
11525,0.0,0.0,0.0,1930,46100,28950,-17150
11526,1.0,0.0,0.3333333333333333,1931,46104,28965,-17139
11527,1.0,0.0,0.3333333333333333,1932,46108,28980,-17128
11528,0.0,0.0,0.0,1932,46112,28980,-17132
11529,0.0,0.0,0.0,1932,46116,28980,-17136
11530,0.0,0.0,0.0,1932,46120,28980,-17140
11531,0.0,0.0,0.0,1932,46124,28980,-17144
11532,0.0,0.0,0.0,1932,46128,28980,-17148
11533,0.0,0.0,0.0,1932,46132,28980,-17152
11534,0.0,0.0,0.0,1932,46136,28980,-17156
11535,1.0,1.0,1.0,1933,46140,28995,-17145
11536,0.0,0.0,0.0,1933,46144,28995,-17149
11537,0.0,0.0,0.0,1933,46148,28995,-17153
11538,0.0,0.0,0.0,1933,46152,28995,-17157
11539,0.0,0.0,0.0,1933,46156,28995,-17161
11540,0.0,0.0,0.0,1933,46160,28995,-17165
11541,1.0,1.0,1.0,1934,46164,29010,-17154
11542,0.0,0.0,0.0,1934,46168,29010,-17158
11543,0.0,0.0,0.0,1934,46172,29010,-17162
11544,0.0,0.0,0.0,1934,46176,29010,-17166
11545,0.0,0.0,0.0,1934,46180,29010,-17170
11546,0.0,0.0,0.0,1934,46184,29010,-17174
11547,0.0,1.0,0.6,1934,46188,29010,-17178
11548,0.0,0.0,0.0,1934,46192,29010,-17182
11549,0.0,0.0,0.0,1934,46196,29010,-17186
11550,0.0,0.0,0.0,1934,46200,29010,-17190
11551,0.0,0.0,0.0,1934,46204,29010,-17194
11552,1.0,0.0,0.3333333333333333,1935,46208,29025,-17183
11553,1.0,1.0,0.6666666666666666,1936,46212,29040,-17172
11554,0.0,0.0,0.0,1936,46216,29040,-17176
11555,0.0,0.0,0.0,1936,46220,29040,-17180
11556,0.0,0.0,0.0,1936,46224,29040,-17184
11557,0.0,0.0,0.0,1936,46228,29040,-17188
11558,0.0,0.0,0.0,1936,46232,29040,-17192
11559,0.0,0.0,0.0,1936,46236,29040,-17196
11560,0.0,0.0,0.0,1936,46240,29040,-17200
11561,0.0,0.0,0.0,1936,46244,29040,-17204
11562,0.0,0.0,0.0,1936,46248,29040,-17208
11563,1.0,1.0,1.0,1937,46252,29055,-17197
11564,0.0,0.0,0.0,1937,46256,29055,-17201
11565,1.0,1.0,1.0,1938,46260,29070,-17190
11566,0.0,0.0,0.0,1938,46264,29070,-17194
11567,0.0,0.0,0.0,1938,46268,29070,-17198
11568,0.0,0.0,0.0,1938,46272,29070,-17202
11569,0.0,0.0,0.0,1938,46276,29070,-17206
11570,1.0,1.0,1.0,1939,46280,29085,-17195
11571,1.0,1.0,1.0,1940,46284,29100,-17184
11572,0.0,0.0,0.0,1940,46288,29100,-17188
11573,0.0,0.0,0.0,1940,46292,29100,-17192
11574,0.0,0.0,0.0,1940,46296,29100,-17196
11575,1.0,0.0,0.5,1941,46300,29115,-17185
11576,0.0,0.0,0.0,1941,46304,29115,-17189
11577,0.0,0.0,0.0,1941,46308,29115,-17193
11578,0.0,0.0,0.0,1941,46312,29115,-17197
11579,0.0,0.0,0.0,1941,46316,29115,-17201
11580,1.0,1.0,1.0,1942,46320,29130,-17190
11581,0.0,0.0,0.0,1942,46324,29130,-17194
11582,0.0,0.0,0.0,1942,46328,29130,-17198
11583,0.0,0.0,0.0,1942,46332,29130,-17202
11584,0.0,0.0,0.0,1942,46336,29130,-17206
11585,0.0,0.0,0.0,1942,46340,29130,-17210
11586,0.0,0.0,0.0,1942,46344,29130,-17214
11587,0.0,0.0,0.0,1942,46348,29130,-17218
11588,0.0,0.0,0.0,1942,46352,29130,-17222
11589,0.0,0.0,0.0,1942,46356,29130,-17226
11590,0.0,0.0,0.0,1942,46360,29130,-17230
11591,1.0,1.0,1.0,1943,46364,29145,-17219
11592,0.0,0.0,0.0,1943,46368,29145,-17223
11593,0.0,0.0,0.0,1943,46372,29145,-17227
11594,0.0,0.0,0.3333333333333333,1943,46376,29145,-17231
11595,0.0,0.0,0.0,1943,46380,29145,-17235
11596,0.0,0.0,0.0,1943,46384,29145,-17239
11597,0.0,0.0,0.0,1943,46388,29145,-17243
11598,0.0,0.0,0.3333333333333333,1943,46392,29145,-17247
11599,0.0,0.0,0.0,1943,46396,29145,-17251
11600,0.0,0.0,0.0,1943,46400,29145,-17255
11601,0.0,0.0,0.0,1943,46404,29145,-17259
11602,1.0,1.0,0.6666666666666666,1944,46408,29160,-17248
11603,0.0,0.0,0.0,1944,46412,29160,-17252
11604,0.0,0.0,0.0,1944,46416,29160,-17256
11605,0.0,0.0,0.0,1944,46420,29160,-17260
11606,1.0,1.0,1.0,1945,46424,29175,-17249
11607,0.0,0.0,0.0,1945,46428,29175,-17253
11608,1.0,1.0,1.0,1946,46432,29190,-17242
11609,0.0,0.0,0.0,1946,46436,29190,-17246
11610,0.0,0.0,0.0,1946,46440,29190,-17250
11611,1.0,1.0,1.0,1947,46444,29205,-17239
11612,0.0,0.0,0.0,1947,46448,29205,-17243
11613,0.0,0.0,0.0,1947,46452,29205,-17247
11614,0.0,0.0,0.0,1947,46456,29205,-17251
11615,0.0,0.0,0.0,1947,46460,29205,-17255
11616,0.0,0.0,0.0,1947,46464,29205,-17259
11617,0.0,0.0,0.0,1947,46468,29205,-17263
11618,1.0,1.0,1.0,1948,46472,29220,-17252
11619,0.0,0.0,0.0,1948,46476,29220,-17256
11620,0.0,0.0,0.0,1948,46480,29220,-17260
11621,0.0,0.0,0.0,1948,46484,29220,-17264
11622,0.0,0.0,0.0,1948,46488,29220,-17268
11623,0.0,0.0,0.0,1948,46492,29220,-17272
11624,0.0,0.0,0.0,1948,46496,29220,-17276
11625,0.0,0.0,0.0,1948,46500,29220,-17280
11626,1.0,1.0,1.0,1949,46504,29235,-17269
11627,0.0,0.0,0.0,1949,46508,29235,-17273
11628,0.0,0.0,0.0,1949,46512,29235,-17277
11629,0.0,0.0,0.0,1949,46516,29235,-17281
11630,0.0,0.0,0.0,1949,46520,29235,-17285
11631,0.0,0.0,0.0,1949,46524,29235,-17289
11632,0.0,0.0,0.0,1949,46528,29235,-17293
11633,0.0,0.0,0.0,1949,46532,29235,-17297
11634,0.0,0.0,0.0,1949,46536,29235,-17301
11635,0.0,0.0,0.0,1949,46540,29235,-17305
11636,0.0,0.0,0.0,1949,46544,29235,-17309
11637,0.0,0.0,0.0,1949,46548,29235,-17313
11638,0.0,0.0,0.0,1949,46552,29235,-17317
11639,0.0,0.0,0.0,1949,46556,29235,-17321
11640,0.0,0.0,0.0,1949,46560,29235,-17325
11641,0.0,0.0,0.0,1949,46564,29235,-17329
11642,1.0,1.0,0.75,1950,46568,29250,-17318
11643,0.0,0.0,0.0,1950,46572,29250,-17322
11644,0.0,0.0,0.0,1950,46576,29250,-17326
11645,0.0,0.0,0.0,1950,46580,29250,-17330
11646,0.0,0.0,0.0,1950,46584,29250,-17334
11647,0.0,0.0,0.3333333333333333,1950,46588,29250,-17338
11648,0.0,0.0,0.0,1950,46592,29250,-17342
11649,0.0,0.0,0.0,1950,46596,29250,-17346
11650,0.0,0.0,0.0,1950,46600,29250,-17350
11651,0.0,0.0,0.0,1950,46604,29250,-17354
11652,1.0,1.0,1.0,1951,46608,29265,-17343
11653,0.0,0.0,0.0,1951,46612,29265,-17347
11654,0.0,0.0,0.0,1951,46616,29265,-17351
11655,0.0,0.0,0.0,1951,46620,29265,-17355
11656,0.0,0.0,0.0,1951,46624,29265,-17359
11657,0.0,0.0,0.0,1951,46628,29265,-17363
11658,0.0,0.0,0.0,1951,46632,29265,-17367
11659,1.0,1.0,0.6666666666666666,1952,46636,29280,-17356
11660,0.0,0.0,0.0,1952,46640,29280,-17360
11661,0.0,0.0,0.0,1952,46644,29280,-17364
11662,0.0,0.0,0.0,1952,46648,29280,-17368
11663,0.0,0.0,0.0,1952,46652,29280,-17372
11664,0.0,0.0,0.0,1952,46656,29280,-17376
11665,0.0,0.0,0.0,1952,46660,29280,-17380
11666,0.0,0.0,0.0,1952,46664,29280,-17384
11667,0.0,0.0,0.0,1952,46668,29280,-17388
11668,1.0,1.0,1.0,1953,46672,29295,-17377
11669,0.0,0.0,0.0,1953,46676,29295,-17381
11670,0.0,0.0,0.0,1953,46680,29295,-17385
11671,1.0,1.0,1.0,1954,46684,29310,-17374
11672,0.0,0.0,0.0,1954,46688,29310,-17378
11673,0.0,0.0,0.0,1954,46692,29310,-17382
11674,0.0,0.0,0.0,1954,46696,29310,-17386
11675,0.0,0.0,0.0,1954,46700,29310,-17390
11676,0.0,0.0,0.0,1954,46704,29310,-17394
11677,1.0,1.0,1.0,1955,46708,29325,-17383
11678,1.0,1.0,1.0,1956,46712,29340,-17372
11679,1.0,0.0,0.25,1957,46716,29355,-17361
11680,0.0,0.0,0.0,1957,46720,29355,-17365
11681,0.0,0.0,0.0,1957,46724,29355,-17369
11682,1.0,1.0,1.0,1958,46728,29370,-17358
11683,0.0,0.0,0.0,1958,46732,29370,-17362
11684,0.0,0.0,0.0,1958,46736,29370,-17366
11685,0.0,0.0,0.0,1958,46740,29370,-17370
11686,0.0,0.0,0.0,1958,46744,29370,-17374
11687,0.0,0.0,0.4,1958,46748,29370,-17378
11688,0.0,0.0,0.0,1958,46752,29370,-17382
11689,0.0,0.0,0.0,1958,46756,29370,-17386
11690,1.0,1.0,1.0,1959,46760,29385,-17375
11691,0.0,0.0,0.0,1959,46764,29385,-17379
11692,0.0,0.0,0.0,1959,46768,29385,-17383
11693,0.0,0.0,0.0,1959,46772,29385,-17387
11694,0.0,0.0,0.0,1959,46776,29385,-17391
11695,0.0,0.0,0.0,1959,46780,29385,-17395
11696,0.0,0.0,0.0,1959,46784,29385,-17399
11697,0.0,0.0,0.0,1959,46788,29385,-17403
11698,0.0,0.0,0.0,1959,46792,29385,-17407
11699,0.0,0.0,0.0,1959,46796,29385,-17411
11700,0.0,0.0,0.0,1959,46800,29385,-17415
11701,0.0,0.0,0.0,1959,46804,29385,-17419
11702,0.0,0.0,0.0,1959,46808,29385,-17423
11703,0.0,0.0,0.0,1959,46812,29385,-17427
11704,1.0,1.0,1.0,1960,46816,29400,-17416
11705,0.0,0.0,0.0,1960,46820,29400,-17420
11706,0.0,0.0,0.0,1960,46824,29400,-17424
11707,0.0,0.0,0.0,1960,46828,29400,-17428
11708,0.0,0.0,0.0,1960,46832,29400,-17432
11709,0.0,0.0,0.2,1960,46836,29400,-17436
11710,0.0,0.0,0.0,1960,46840,29400,-17440
11711,0.0,0.0,0.0,1960,46844,29400,-17444
11712,0.0,0.0,0.0,1960,46848,29400,-17448
11713,0.0,0.0,0.0,1960,46852,29400,-17452
11714,0.0,0.0,0.3333333333333333,1960,46856,29400,-17456
11715,0.0,0.0,0.0,1960,46860,29400,-17460
11716,1.0,1.0,1.0,1961,46864,29415,-17449
11717,0.0,0.0,0.0,1961,46868,29415,-17453
11718,0.0,0.0,0.0,1961,46872,29415,-17457
11719,1.0,1.0,1.0,1962,46876,29430,-17446
11720,0.0,0.0,0.0,1962,46880,29430,-17450
11721,0.0,0.0,0.0,1962,46884,29430,-17454
11722,0.0,0.0,0.0,1962,46888,29430,-17458
11723,1.0,1.0,0.6666666666666666,1963,46892,29445,-17447
11724,0.0,0.0,0.0,1963,46896,29445,-17451
11725,0.0,0.0,0.0,1963,46900,29445,-17455
11726,0.0,0.0,0.0,1963,46904,29445,-17459
11727,0.0,0.0,0.0,1963,46908,29445,-17463
11728,0.0,0.0,0.0,1963,46912,29445,-17467
11729,0.0,0.0,0.0,1963,46916,29445,-17471
11730,0.0,0.0,0.0,1963,46920,29445,-17475
11731,1.0,1.0,1.0,1964,46924,29460,-17464
11732,0.0,0.0,0.0,1964,46928,29460,-17468
11733,0.0,0.0,0.0,1964,46932,29460,-17472
11734,0.0,0.0,0.0,1964,46936,29460,-17476
11735,0.0,0.0,0.0,1964,46940,29460,-17480
11736,0.0,0.0,0.0,1964,46944,29460,-17484
11737,0.0,0.0,0.0,1964,46948,29460,-17488
11738,1.0,1.0,1.0,1965,46952,29475,-17477
11739,1.0,1.0,1.0,1966,46956,29490,-17466
11740,0.0,0.0,0.0,1966,46960,29490,-17470
11741,0.0,0.0,0.0,1966,46964,29490,-17474
11742,0.0,0.0,0.2,1966,46968,29490,-17478
11743,1.0,1.0,1.0,1967,46972,29505,-17467
11744,0.0,0.0,0.0,1967,46976,29505,-17471
11745,0.0,0.0,0.0,1967,46980,29505,-17475
11746,0.0,0.0,0.0,1967,46984,29505,-17479
11747,0.0,0.0,0.0,1967,46988,29505,-17483
11748,0.0,0.0,0.0,1967,46992,29505,-17487
11749,0.0,0.0,0.0,1967,46996,29505,-17491
11750,0.0,0.0,0.0,1967,47000,29505,-17495
11751,1.0,1.0,0.6666666666666666,1968,47004,29520,-17484
11752,0.0,0.0,0.0,1968,47008,29520,-17488
11753,0.0,0.0,0.0,1968,47012,29520,-17492
11754,0.0,0.0,0.0,1968,47016,29520,-17496
11755,1.0,1.0,0.6666666666666666,1969,47020,29535,-17485
11756,1.0,1.0,1.0,1970,47024,29550,-17474
11757,0.0,0.0,0.0,1970,47028,29550,-17478
11758,0.0,0.0,0.0,1970,47032,29550,-17482
11759,0.0,0.0,0.0,1970,47036,29550,-17486
11760,0.0,0.0,0.0,1970,47040,29550,-17490
11761,0.0,0.0,0.0,1970,47044,29550,-17494
11762,0.0,0.0,0.0,1970,47048,29550,-17498
11763,0.0,0.0,0.0,1970,47052,29550,-17502
11764,1.0,1.0,1.0,1971,47056,29565,-17491
11765,0.0,0.0,0.0,1971,47060,29565,-17495
11766,1.0,1.0,1.0,1972,47064,29580,-17484
11767,0.0,0.0,0.0,1972,47068,29580,-17488
11768,0.0,0.0,0.0,1972,47072,29580,-17492
11769,0.0,0.0,0.0,1972,47076,29580,-17496
11770,0.0,0.0,0.0,1972,47080,29580,-17500
11771,0.0,0.0,0.0,1972,47084,29580,-17504
11772,0.0,0.0,0.0,1972,47088,29580,-17508
11773,0.0,0.0,0.0,1972,47092,29580,-17512
11774,0.0,0.0,0.5,1972,47096,29580,-17516
11775,0.0,0.0,0.0,1972,47100,29580,-17520
11776,0.0,0.0,0.3333333333333333,1972,47104,29580,-17524
11777,0.0,0.0,0.0,1972,47108,29580,-17528
11778,1.0,1.0,0.6666666666666666,1973,47112,29595,-17517
11779,1.0,1.0,1.0,1974,47116,29610,-17506
11780,0.0,0.0,0.0,1974,47120,29610,-17510
11781,1.0,1.0,1.0,1975,47124,29625,-17499
11782,0.0,0.0,0.0,1975,47128,29625,-17503
11783,0.0,0.0,0.0,1975,47132,29625,-17507
11784,0.0,0.0,0.0,1975,47136,29625,-17511
11785,1.0,1.0,0.6,1976,47140,29640,-17500
11786,0.0,0.0,0.0,1976,47144,29640,-17504
11787,0.0,0.0,0.0,1976,47148,29640,-17508
11788,0.0,0.0,0.0,1976,47152,29640,-17512
11789,0.0,0.0,0.0,1976,47156,29640,-17516
11790,0.0,0.0,0.0,1976,47160,29640,-17520
11791,0.0,0.0,0.0,1976,47164,29640,-17524
11792,0.0,0.0,0.0,1976,47168,29640,-17528
11793,0.0,0.0,0.0,1976,47172,29640,-17532
11794,0.0,0.0,0.0,1976,47176,29640,-17536
11795,0.0,0.0,0.0,1976,47180,29640,-17540
11796,0.0,0.0,0.0,1976,47184,29640,-17544
11797,0.0,0.0,0.0,1976,47188,29640,-17548
11798,0.0,0.0,0.0,1976,47192,29640,-17552
11799,0.0,0.0,0.0,1976,47196,29640,-17556
11800,0.0,0.0,0.0,1976,47200,29640,-17560
11801,0.0,0.0,0.0,1976,47204,29640,-17564
11802,0.0,0.0,0.0,1976,47208,29640,-17568
11803,0.0,0.0,0.0,1976,47212,29640,-17572
11804,0.0,0.0,0.0,1976,47216,29640,-17576
11805,0.0,0.0,0.0,1976,47220,29640,-17580
11806,0.0,0.0,0.0,1976,47224,29640,-17584
11807,0.0,0.0,0.0,1976,47228,29640,-17588
11808,0.0,0.0,0.0,1976,47232,29640,-17592
11809,1.0,1.0,1.0,1977,47236,29655,-17581
11810,0.0,0.0,0.0,1977,47240,29655,-17585
11811,0.0,0.0,0.0,1977,47244,29655,-17589
11812,1.0,0.0,0.3333333333333333,1978,47248,29670,-17578
11813,0.0,0.0,0.0,1978,47252,29670,-17582
11814,0.0,0.0,0.0,1978,47256,29670,-17586
11815,0.0,0.0,0.0,1978,47260,29670,-17590
11816,0.0,0.0,0.0,1978,47264,29670,-17594
11817,0.0,0.0,0.0,1978,47268,29670,-17598
11818,0.0,0.0,0.0,1978,47272,29670,-17602
11819,0.0,0.0,0.0,1978,47276,29670,-17606
11820,0.0,0.0,0.0,1978,47280,29670,-17610
11821,0.0,0.0,0.0,1978,47284,29670,-17614
11822,0.0,0.0,0.0,1978,47288,29670,-17618
11823,0.0,0.0,0.0,1978,47292,29670,-17622
11824,0.0,0.0,0.0,1978,47296,29670,-17626
11825,1.0,1.0,1.0,1979,47300,29685,-17615
11826,0.0,0.0,0.0,1979,47304,29685,-17619
11827,1.0,1.0,1.0,1980,47308,29700,-17608
11828,1.0,1.0,1.0,1981,47312,29715,-17597
11829,0.0,0.0,0.0,1981,47316,29715,-17601
11830,0.0,0.0,0.0,1981,47320,29715,-17605
11831,0.0,0.0,0.0,1981,47324,29715,-17609
11832,0.0,0.0,0.0,1981,47328,29715,-17613
11833,0.0,0.0,0.0,1981,47332,29715,-17617
11834,0.0,0.0,0.0,1981,47336,29715,-17621
11835,0.0,0.0,0.0,1981,47340,29715,-17625
11836,0.0,0.0,0.0,1981,47344,29715,-17629
11837,0.0,0.0,0.0,1981,47348,29715,-17633
11838,0.0,0.0,0.0,1981,47352,29715,-17637
11839,1.0,1.0,1.0,1982,47356,29730,-17626
11840,0.0,0.0,0.0,1982,47360,29730,-17630
11841,0.0,0.0,0.0,1982,47364,29730,-17634
11842,0.0,0.0,0.0,1982,47368,29730,-17638
11843,0.0,0.0,0.0,1982,47372,29730,-17642
11844,0.0,0.0,0.0,1982,47376,29730,-17646
11845,0.0,0.0,0.0,1982,47380,29730,-17650
11846,0.0,0.0,0.0,1982,47384,29730,-17654
11847,0.0,0.0,0.3333333333333333,1982,47388,29730,-17658
11848,0.0,0.0,0.3333333333333333,1982,47392,29730,-17662
11849,0.0,0.0,0.0,1982,47396,29730,-17666
11850,0.0,0.0,0.0,1982,47400,29730,-17670
11851,0.0,0.0,0.0,1982,47404,29730,-17674
11852,0.0,0.0,0.0,1982,47408,29730,-17678
11853,1.0,1.0,0.6,1983,47412,29745,-17667
11854,1.0,1.0,1.0,1984,47416,29760,-17656
11855,0.0,1.0,0.6666666666666666,1984,47420,29760,-17660
11856,1.0,0.0,0.5,1985,47424,29775,-17649
11857,1.0,1.0,0.6666666666666666,1986,47428,29790,-17638
11858,0.0,0.0,0.0,1986,47432,29790,-17642
11859,0.0,0.0,0.0,1986,47436,29790,-17646
11860,1.0,1.0,1.0,1987,47440,29805,-17635
11861,0.0,0.0,0.3333333333333333,1987,47444,29805,-17639
11862,0.0,0.0,0.0,1987,47448,29805,-17643
11863,0.0,0.0,0.0,1987,47452,29805,-17647
11864,0.0,0.0,0.0,1987,47456,29805,-17651
11865,0.0,0.0,0.0,1987,47460,29805,-17655
11866,1.0,1.0,1.0,1988,47464,29820,-17644
11867,1.0,1.0,1.0,1989,47468,29835,-17633
11868,0.0,0.0,0.0,1989,47472,29835,-17637
11869,0.0,0.0,0.0,1989,47476,29835,-17641
11870,0.0,0.0,0.0,1989,47480,29835,-17645
11871,0.0,0.0,0.0,1989,47484,29835,-17649
11872,0.0,0.0,0.0,1989,47488,29835,-17653
11873,0.0,0.0,0.0,1989,47492,29835,-17657
11874,0.0,0.0,0.0,1989,47496,29835,-17661
11875,0.0,0.0,0.0,1989,47500,29835,-17665
11876,0.0,0.0,0.0,1989,47504,29835,-17669
11877,1.0,0.0,0.3333333333333333,1990,47508,29850,-17658
11878,0.0,0.0,0.0,1990,47512,29850,-17662
11879,0.0,0.0,0.0,1990,47516,29850,-17666
11880,0.0,0.0,0.0,1990,47520,29850,-17670
11881,0.0,0.0,0.0,1990,47524,29850,-17674
11882,1.0,1.0,1.0,1991,47528,29865,-17663
11883,0.0,0.0,0.0,1991,47532,29865,-17667
11884,0.0,0.0,0.0,1991,47536,29865,-17671
11885,1.0,1.0,1.0,1992,47540,29880,-17660
11886,0.0,0.0,0.0,1992,47544,29880,-17664
11887,1.0,0.0,0.2,1993,47548,29895,-17653
11888,0.0,0.0,0.0,1993,47552,29895,-17657
11889,0.0,0.0,0.0,1993,47556,29895,-17661
11890,0.0,0.0,0.0,1993,47560,29895,-17665
11891,0.0,0.0,0.0,1993,47564,29895,-17669
11892,0.0,0.0,0.0,1993,47568,29895,-17673
11893,0.0,0.0,0.0,1993,47572,29895,-17677
11894,0.0,0.0,0.0,1993,47576,29895,-17681
11895,0.0,0.0,0.0,1993,47580,29895,-17685
11896,0.0,0.0,0.3333333333333333,1993,47584,29895,-17689
11897,0.0,0.0,0.0,1993,47588,29895,-17693
11898,0.0,0.0,0.0,1993,47592,29895,-17697
11899,1.0,1.0,1.0,1994,47596,29910,-17686
11900,0.0,0.0,0.0,1994,47600,29910,-17690
11901,0.0,0.0,0.0,1994,47604,29910,-17694
11902,0.0,0.0,0.0,1994,47608,29910,-17698
11903,0.0,0.0,0.0,1994,47612,29910,-17702
11904,0.0,0.0,0.0,1994,47616,29910,-17706
11905,0.0,0.0,0.0,1994,47620,29910,-17710
11906,0.0,0.0,0.0,1994,47624,29910,-17714
11907,0.0,0.0,0.0,1994,47628,29910,-17718
11908,0.0,0.0,0.0,1994,47632,29910,-17722
11909,0.0,0.0,0.0,1994,47636,29910,-17726
11910,0.0,0.0,0.3333333333333333,1994,47640,29910,-17730
11911,1.0,0.0,0.5,1995,47644,29925,-17719
11912,1.0,1.0,1.0,1996,47648,29940,-17708
11913,0.0,0.0,0.0,1996,47652,29940,-17712
11914,1.0,1.0,1.0,1997,47656,29955,-17701
11915,0.0,0.0,0.0,1997,47660,29955,-17705
11916,1.0,1.0,1.0,1998,47664,29970,-17694
11917,0.0,0.0,0.0,1998,47668,29970,-17698
11918,0.0,0.0,0.0,1998,47672,29970,-17702
11919,0.0,0.0,0.0,1998,47676,29970,-17706
11920,1.0,1.0,1.0,1999,47680,29985,-17695
11921,0.0,0.0,0.0,1999,47684,29985,-17699
11922,0.0,0.0,0.0,1999,47688,29985,-17703
11923,1.0,0.0,0.5,2000,47692,30000,-17692
11924,0.0,0.0,0.0,2000,47696,30000,-17696
11925,0.0,0.0,0.0,2000,47700,30000,-17700
11926,0.0,0.0,0.0,2000,47704,30000,-17704
11927,0.0,0.0,0.0,2000,47708,30000,-17708
11928,0.0,0.0,0.0,2000,47712,30000,-17712
11929,0.0,0.0,0.0,2000,47716,30000,-17716
11930,0.0,0.0,0.0,2000,47720,30000,-17720
11931,0.0,0.0,0.0,2000,47724,30000,-17724
11932,1.0,0.0,0.3333333333333333,2001,47728,30015,-17713
11933,0.0,0.0,0.0,2001,47732,30015,-17717
11934,0.0,0.0,0.0,2001,47736,30015,-17721
11935,0.0,0.0,0.0,2001,47740,30015,-17725
11936,0.0,0.0,0.0,2001,47744,30015,-17729
11937,0.0,0.0,0.0,2001,47748,30015,-17733
11938,0.0,0.0,0.0,2001,47752,30015,-17737
11939,0.0,0.0,0.0,2001,47756,30015,-17741
11940,1.0,1.0,1.0,2002,47760,30030,-17730
11941,0.0,0.0,0.0,2002,47764,30030,-17734
11942,0.0,0.0,0.0,2002,47768,30030,-17738
11943,0.0,0.0,0.0,2002,47772,30030,-17742
11944,0.0,0.0,0.0,2002,47776,30030,-17746
11945,0.0,0.0,0.0,2002,47780,30030,-17750
11946,1.0,0.0,0.3333333333333333,2003,47784,30045,-17739
11947,0.0,0.0,0.0,2003,47788,30045,-17743
11948,0.0,0.0,0.0,2003,47792,30045,-17747
11949,0.0,0.0,0.0,2003,47796,30045,-17751
11950,0.0,0.0,0.0,2003,47800,30045,-17755
11951,1.0,1.0,1.0,2004,47804,30060,-17744
11952,0.0,0.0,0.0,2004,47808,30060,-17748
11953,1.0,1.0,1.0,2005,47812,30075,-17737
11954,1.0,1.0,1.0,2006,47816,30090,-17726
11955,0.0,0.0,0.0,2006,47820,30090,-17730
11956,0.0,0.0,0.0,2006,47824,30090,-17734
11957,0.0,0.0,0.0,2006,47828,30090,-17738
11958,0.0,0.0,0.0,2006,47832,30090,-17742
11959,0.0,0.0,0.0,2006,47836,30090,-17746
11960,1.0,1.0,1.0,2007,47840,30105,-17735
11961,1.0,1.0,1.0,2008,47844,30120,-17724
11962,0.0,0.0,0.0,2008,47848,30120,-17728
11963,1.0,0.0,0.3333333333333333,2009,47852,30135,-17717
11964,0.0,0.0,0.0,2009,47856,30135,-17721
11965,0.0,0.0,0.0,2009,47860,30135,-17725
11966,0.0,0.0,0.0,2009,47864,30135,-17729
11967,0.0,0.0,0.0,2009,47868,30135,-17733
11968,0.0,0.0,0.0,2009,47872,30135,-17737
11969,0.0,0.0,0.0,2009,47876,30135,-17741
11970,0.0,0.0,0.0,2009,47880,30135,-17745
11971,0.0,0.0,0.25,2009,47884,30135,-17749
11972,1.0,0.0,0.5,2010,47888,30150,-17738
11973,0.0,0.0,0.0,2010,47892,30150,-17742
11974,0.0,0.0,0.0,2010,47896,30150,-17746
11975,0.0,0.0,0.0,2010,47900,30150,-17750
11976,0.0,0.0,0.0,2010,47904,30150,-17754
11977,0.0,0.0,0.0,2010,47908,30150,-17758
11978,0.0,0.0,0.0,2010,47912,30150,-17762
11979,0.0,0.0,0.3333333333333333,2010,47916,30150,-17766
11980,0.0,0.0,0.0,2010,47920,30150,-17770
11981,0.0,0.0,0.0,2010,47924,30150,-17774
11982,0.0,0.0,0.0,2010,47928,30150,-17778
11983,0.0,0.0,0.3333333333333333,2010,47932,30150,-17782
11984,0.0,0.0,0.0,2010,47936,30150,-17786
11985,0.0,0.0,0.0,2010,47940,30150,-17790
11986,0.0,0.0,0.0,2010,47944,30150,-17794
11987,0.0,0.0,0.0,2010,47948,30150,-17798
11988,1.0,0.0,0.3333333333333333,2011,47952,30165,-17787
11989,0.0,0.0,0.0,2011,47956,30165,-17791
11990,1.0,0.0,0.3333333333333333,2012,47960,30180,-17780
11991,0.0,0.0,0.0,2012,47964,30180,-17784
11992,0.0,1.0,0.6666666666666666,2012,47968,30180,-17788
11993,0.0,0.0,0.0,2012,47972,30180,-17792
11994,0.0,0.0,0.0,2012,47976,30180,-17796
11995,1.0,1.0,1.0,2013,47980,30195,-17785
11996,0.0,0.0,0.0,2013,47984,30195,-17789
11997,0.0,0.0,0.0,2013,47988,30195,-17793
11998,0.0,0.0,0.0,2013,47992,30195,-17797
11999,0.0,0.0,0.0,2013,47996,30195,-17801
12000,1.0,1.0,1.0,2014,48000,30210,-17790
12001,0.0,0.0,0.0,2014,48004,30210,-17794
12002,0.0,0.0,0.0,2014,48008,30210,-17798
12003,0.0,0.0,0.0,2014,48012,30210,-17802
12004,0.0,0.0,0.0,2014,48016,30210,-17806
12005,0.0,0.0,0.0,2014,48020,30210,-17810
12006,1.0,1.0,1.0,2015,48024,30225,-17799
12007,0.0,0.0,0.0,2015,48028,30225,-17803
12008,0.0,1.0,0.6666666666666666,2015,48032,30225,-17807
12009,1.0,1.0,0.75,2016,48036,30240,-17796
12010,1.0,1.0,1.0,2017,48040,30255,-17785
12011,0.0,0.0,0.0,2017,48044,30255,-17789
12012,0.0,0.0,0.0,2017,48048,30255,-17793
12013,0.0,0.0,0.0,2017,48052,30255,-17797
12014,0.0,0.0,0.0,2017,48056,30255,-17801
12015,0.0,0.0,0.0,2017,48060,30255,-17805
12016,0.0,0.0,0.0,2017,48064,30255,-17809
12017,0.0,0.0,0.0,2017,48068,30255,-17813
12018,0.0,0.0,0.0,2017,48072,30255,-17817
12019,0.0,0.0,0.0,2017,48076,30255,-17821
12020,0.0,0.0,0.0,2017,48080,30255,-17825
12021,0.0,0.0,0.3333333333333333,2017,48084,30255,-17829
12022,0.0,0.0,0.0,2017,48088,30255,-17833
12023,1.0,1.0,1.0,2018,48092,30270,-17822
12024,0.0,0.0,0.0,2018,48096,30270,-17826
12025,0.0,0.0,0.0,2018,48100,30270,-17830
12026,0.0,0.0,0.0,2018,48104,30270,-17834
12027,0.0,0.0,0.0,2018,48108,30270,-17838
12028,0.0,0.0,0.0,2018,48112,30270,-17842
12029,0.0,0.0,0.0,2018,48116,30270,-17846
12030,0.0,0.0,0.0,2018,48120,30270,-17850
12031,0.0,0.0,0.0,2018,48124,30270,-17854
12032,0.0,0.0,0.0,2018,48128,30270,-17858
12033,1.0,1.0,1.0,2019,48132,30285,-17847
12034,0.0,0.0,0.0,2019,48136,30285,-17851
12035,1.0,1.0,1.0,2020,48140,30300,-17840
12036,0.0,0.0,0.0,2020,48144,30300,-17844
12037,0.0,0.0,0.0,2020,48148,30300,-17848
12038,0.0,0.0,0.0,2020,48152,30300,-17852
12039,0.0,0.0,0.0,2020,48156,30300,-17856
12040,0.0,0.0,0.0,2020,48160,30300,-17860
12041,0.0,0.0,0.0,2020,48164,30300,-17864
12042,0.0,0.0,0.3333333333333333,2020,48168,30300,-17868
12043,0.0,0.0,0.5,2020,48172,30300,-17872
12044,0.0,0.0,0.0,2020,48176,30300,-17876
12045,0.0,0.0,0.0,2020,48180,30300,-17880
12046,0.0,0.0,0.0,2020,48184,30300,-17884
12047,0.0,0.0,0.0,2020,48188,30300,-17888
12048,0.0,0.0,0.0,2020,48192,30300,-17892
12049,0.0,0.0,0.0,2020,48196,30300,-17896
12050,0.0,0.0,0.0,2020,48200,30300,-17900
12051,0.0,0.0,0.0,2020,48204,30300,-17904
12052,1.0,1.0,1.0,2021,48208,30315,-17893
12053,0.0,0.0,0.0,2021,48212,30315,-17897
12054,1.0,1.0,1.0,2022,48216,30330,-17886
12055,1.0,1.0,1.0,2023,48220,30345,-17875
12056,0.0,0.0,0.3333333333333333,2023,48224,30345,-17879
12057,0.0,0.0,0.0,2023,48228,30345,-17883
12058,0.0,0.0,0.0,2023,48232,30345,-17887
12059,0.0,0.0,0.0,2023,48236,30345,-17891
12060,0.0,0.0,0.0,2023,48240,30345,-17895
12061,0.0,0.0,0.0,2023,48244,30345,-17899
12062,0.0,0.0,0.0,2023,48248,30345,-17903
12063,1.0,1.0,1.0,2024,48252,30360,-17892
12064,0.0,0.0,0.0,2024,48256,30360,-17896
12065,0.0,0.0,0.0,2024,48260,30360,-17900
12066,0.0,0.0,0.0,2024,48264,30360,-17904
12067,0.0,0.0,0.0,2024,48268,30360,-17908
12068,0.0,0.0,0.0,2024,48272,30360,-17912
12069,0.0,0.0,0.0,2024,48276,30360,-17916
12070,0.0,0.0,0.0,2024,48280,30360,-17920
12071,0.0,0.0,0.0,2024,48284,30360,-17924
12072,0.0,0.0,0.0,2024,48288,30360,-17928
12073,0.0,0.0,0.3333333333333333,2024,48292,30360,-17932
12074,0.0,0.0,0.0,2024,48296,30360,-17936
12075,0.0,0.0,0.0,2024,48300,30360,-17940
12076,0.0,0.0,0.0,2024,48304,30360,-17944
12077,0.0,0.0,0.0,2024,48308,30360,-17948
12078,0.0,0.0,0.0,2024,48312,30360,-17952
12079,0.0,0.0,0.0,2024,48316,30360,-17956
12080,1.0,1.0,1.0,2025,48320,30375,-17945
12081,0.0,0.0,0.4,2025,48324,30375,-17949
12082,1.0,1.0,1.0,2026,48328,30390,-17938
12083,0.0,0.0,0.0,2026,48332,30390,-17942
12084,1.0,1.0,1.0,2027,48336,30405,-17931
12085,0.0,1.0,0.6666666666666666,2027,48340,30405,-17935
12086,1.0,1.0,1.0,2028,48344,30420,-17924
12087,0.0,0.0,0.0,2028,48348,30420,-17928
12088,1.0,0.0,0.3333333333333333,2029,48352,30435,-17917
12089,0.0,0.0,0.5,2029,48356,30435,-17921
12090,0.0,0.0,0.0,2029,48360,30435,-17925
12091,0.0,0.0,0.0,2029,48364,30435,-17929
12092,0.0,0.0,0.0,2029,48368,30435,-17933
12093,0.0,0.0,0.0,2029,48372,30435,-17937
12094,0.0,0.0,0.0,2029,48376,30435,-17941
12095,0.0,0.0,0.0,2029,48380,30435,-17945
12096,0.0,0.0,0.0,2029,48384,30435,-17949
12097,0.0,0.0,0.0,2029,48388,30435,-17953
12098,0.0,0.0,0.0,2029,48392,30435,-17957
12099,0.0,0.0,0.2,2029,48396,30435,-17961
12100,1.0,1.0,1.0,2030,48400,30450,-17950
12101,0.0,0.0,0.0,2030,48404,30450,-17954
12102,0.0,0.0,0.0,2030,48408,30450,-17958
12103,0.0,0.0,0.0,2030,48412,30450,-17962
12104,0.0,0.0,0.0,2030,48416,30450,-17966
12105,0.0,1.0,0.6,2030,48420,30450,-17970
12106,1.0,1.0,1.0,2031,48424,30465,-17959
12107,0.0,0.0,0.0,2031,48428,30465,-17963
12108,0.0,0.0,0.0,2031,48432,30465,-17967
12109,0.0,0.0,0.0,2031,48436,30465,-17971
12110,1.0,1.0,1.0,2032,48440,30480,-17960
12111,0.0,0.0,0.0,2032,48444,30480,-17964
12112,0.0,0.0,0.0,2032,48448,30480,-17968
12113,0.0,0.0,0.0,2032,48452,30480,-17972
12114,1.0,1.0,1.0,2033,48456,30495,-17961
12115,0.0,0.0,0.0,2033,48460,30495,-17965
12116,0.0,0.0,0.0,2033,48464,30495,-17969
12117,0.0,0.0,0.0,2033,48468,30495,-17973
12118,0.0,0.0,0.0,2033,48472,30495,-17977
12119,0.0,0.0,0.0,2033,48476,30495,-17981
12120,0.0,0.0,0.0,2033,48480,30495,-17985
12121,0.0,0.0,0.0,2033,48484,30495,-17989
12122,0.0,0.0,0.0,2033,48488,30495,-17993
12123,1.0,1.0,1.0,2034,48492,30510,-17982
12124,0.0,0.0,0.0,2034,48496,30510,-17986
12125,0.0,0.0,0.0,2034,48500,30510,-17990
12126,0.0,0.0,0.0,2034,48504,30510,-17994
12127,0.0,0.0,0.3333333333333333,2034,48508,30510,-17998
12128,1.0,1.0,1.0,2035,48512,30525,-17987
12129,0.0,1.0,0.6666666666666666,2035,48516,30525,-17991
12130,0.0,0.0,0.0,2035,48520,30525,-17995
12131,0.0,0.0,0.0,2035,48524,30525,-17999
12132,0.0,0.0,0.0,2035,48528,30525,-18003
12133,0.0,0.0,0.0,2035,48532,30525,-18007
12134,0.0,0.0,0.0,2035,48536,30525,-18011
12135,0.0,1.0,0.6,2035,48540,30525,-18015
12136,0.0,0.0,0.0,2035,48544,30525,-18019
12137,0.0,0.0,0.0,2035,48548,30525,-18023
12138,0.0,0.0,0.0,2035,48552,30525,-18027
12139,0.0,0.0,0.0,2035,48556,30525,-18031
12140,1.0,1.0,1.0,2036,48560,30540,-18020
12141,0.0,0.0,0.0,2036,48564,30540,-18024
12142,0.0,0.0,0.0,2036,48568,30540,-18028
12143,0.0,0.0,0.0,2036,48572,30540,-18032
12144,0.0,0.0,0.0,2036,48576,30540,-18036
12145,0.0,0.0,0.0,2036,48580,30540,-18040
12146,0.0,0.0,0.0,2036,48584,30540,-18044
12147,0.0,0.0,0.0,2036,48588,30540,-18048
12148,0.0,0.0,0.0,2036,48592,30540,-18052
12149,0.0,0.0,0.0,2036,48596,30540,-18056
12150,1.0,1.0,1.0,2037,48600,30555,-18045
12151,0.0,0.0,0.0,2037,48604,30555,-18049
12152,0.0,0.0,0.0,2037,48608,30555,-18053
12153,0.0,0.0,0.3333333333333333,2037,48612,30555,-18057
12154,0.0,0.0,0.0,2037,48616,30555,-18061
12155,0.0,0.0,0.0,2037,48620,30555,-18065
12156,0.0,0.0,0.0,2037,48624,30555,-18069
12157,0.0,0.0,0.0,2037,48628,30555,-18073
12158,0.0,0.0,0.0,2037,48632,30555,-18077
12159,0.0,0.0,0.0,2037,48636,30555,-18081
12160,0.0,0.0,0.0,2037,48640,30555,-18085
12161,0.0,0.0,0.0,2037,48644,30555,-18089
12162,0.0,0.0,0.0,2037,48648,30555,-18093
12163,0.0,0.0,0.0,2037,48652,30555,-18097
12164,1.0,1.0,1.0,2038,48656,30570,-18086
12165,0.0,0.0,0.0,2038,48660,30570,-18090
12166,0.0,0.0,0.0,2038,48664,30570,-18094
12167,0.0,0.0,0.4,2038,48668,30570,-18098
12168,0.0,0.0,0.0,2038,48672,30570,-18102
12169,0.0,0.0,0.0,2038,48676,30570,-18106
12170,0.0,0.0,0.3333333333333333,2038,48680,30570,-18110
12171,0.0,0.0,0.0,2038,48684,30570,-18114
12172,0.0,0.0,0.0,2038,48688,30570,-18118
12173,0.0,0.0,0.0,2038,48692,30570,-18122
12174,1.0,1.0,1.0,2039,48696,30585,-18111
12175,0.0,0.0,0.0,2039,48700,30585,-18115
12176,0.0,0.0,0.0,2039,48704,30585,-18119
12177,0.0,0.0,0.0,2039,48708,30585,-18123
12178,0.0,0.0,0.0,2039,48712,30585,-18127
12179,0.0,0.0,0.0,2039,48716,30585,-18131
12180,1.0,1.0,1.0,2040,48720,30600,-18120
12181,0.0,0.0,0.0,2040,48724,30600,-18124
12182,0.0,0.0,0.0,2040,48728,30600,-18128
12183,0.0,0.0,0.0,2040,48732,30600,-18132
12184,0.0,0.0,0.0,2040,48736,30600,-18136
12185,0.0,0.0,0.0,2040,48740,30600,-18140
12186,0.0,0.0,0.0,2040,48744,30600,-18144
12187,0.0,0.0,0.0,2040,48748,30600,-18148
12188,0.0,0.0,0.0,2040,48752,30600,-18152
12189,0.0,0.0,0.0,2040,48756,30600,-18156
12190,0.0,0.0,0.0,2040,48760,30600,-18160
12191,0.0,0.0,0.0,2040,48764,30600,-18164
12192,0.0,0.0,0.0,2040,48768,30600,-18168
12193,0.0,0.0,0.0,2040,48772,30600,-18172
12194,0.0,0.0,0.0,2040,48776,30600,-18176
12195,0.0,0.0,0.0,2040,48780,30600,-18180
12196,0.0,0.0,0.0,2040,48784,30600,-18184
12197,0.0,0.0,0.0,2040,48788,30600,-18188
12198,0.0,0.0,0.0,2040,48792,30600,-18192
12199,0.0,0.0,0.0,2040,48796,30600,-18196
12200,0.0,0.0,0.0,2040,48800,30600,-18200
12201,1.0,1.0,1.0,2041,48804,30615,-18189
12202,0.0,0.0,0.0,2041,48808,30615,-18193
12203,1.0,1.0,1.0,2042,48812,30630,-18182
12204,0.0,0.0,0.0,2042,48816,30630,-18186
12205,0.0,0.0,0.0,2042,48820,30630,-18190
12206,0.0,0.0,0.0,2042,48824,30630,-18194
12207,1.0,1.0,1.0,2043,48828,30645,-18183
12208,0.0,0.0,0.0,2043,48832,30645,-18187
12209,0.0,0.0,0.0,2043,48836,30645,-18191
12210,0.0,0.0,0.0,2043,48840,30645,-18195
12211,0.0,0.0,0.0,2043,48844,30645,-18199
12212,0.0,0.0,0.0,2043,48848,30645,-18203
12213,0.0,0.0,0.0,2043,48852,30645,-18207
12214,0.0,0.0,0.0,2043,48856,30645,-18211
12215,1.0,1.0,1.0,2044,48860,30660,-18200
12216,1.0,1.0,1.0,2045,48864,30675,-18189
12217,0.0,0.0,0.0,2045,48868,30675,-18193
12218,0.0,0.0,0.0,2045,48872,30675,-18197
12219,0.0,0.0,0.0,2045,48876,30675,-18201
12220,0.0,0.0,0.0,2045,48880,30675,-18205
12221,1.0,0.0,0.5,2046,48884,30690,-18194
12222,0.0,0.0,0.0,2046,48888,30690,-18198
12223,0.0,0.0,0.0,2046,48892,30690,-18202
12224,0.0,0.0,0.0,2046,48896,30690,-18206
12225,0.0,0.0,0.0,2046,48900,30690,-18210
12226,1.0,1.0,0.75,2047,48904,30705,-18199
12227,0.0,0.0,0.0,2047,48908,30705,-18203
12228,0.0,0.0,0.0,2047,48912,30705,-18207
12229,1.0,0.0,0.3333333333333333,2048,48916,30720,-18196
12230,0.0,0.0,0.0,2048,48920,30720,-18200
12231,0.0,0.0,0.0,2048,48924,30720,-18204
12232,0.0,0.0,0.0,2048,48928,30720,-18208
12233,0.0,0.0,0.0,2048,48932,30720,-18212
12234,0.0,0.0,0.0,2048,48936,30720,-18216
12235,0.0,0.0,0.0,2048,48940,30720,-18220
12236,1.0,1.0,1.0,2049,48944,30735,-18209
12237,0.0,0.0,0.0,2049,48948,30735,-18213
12238,0.0,0.0,0.0,2049,48952,30735,-18217
12239,0.0,0.0,0.0,2049,48956,30735,-18221
12240,0.0,0.0,0.0,2049,48960,30735,-18225
12241,0.0,0.0,0.0,2049,48964,30735,-18229
12242,0.0,0.0,0.0,2049,48968,30735,-18233
12243,1.0,1.0,0.6666666666666666,2050,48972,30750,-18222
12244,0.0,0.0,0.0,2050,48976,30750,-18226
12245,0.0,0.0,0.0,2050,48980,30750,-18230
12246,0.0,0.0,0.0,2050,48984,30750,-18234
12247,0.0,0.0,0.0,2050,48988,30750,-18238
12248,1.0,0.0,0.5,2051,48992,30765,-18227
12249,0.0,0.0,0.0,2051,48996,30765,-18231
12250,0.0,0.0,0.0,2051,49000,30765,-18235
12251,1.0,1.0,0.6666666666666666,2052,49004,30780,-18224
12252,0.0,0.0,0.0,2052,49008,30780,-18228
12253,0.0,0.0,0.0,2052,49012,30780,-18232
12254,0.0,0.0,0.0,2052,49016,30780,-18236
12255,0.0,0.0,0.0,2052,49020,30780,-18240
12256,0.0,0.0,0.0,2052,49024,30780,-18244
12257,0.0,0.0,0.0,2052,49028,30780,-18248
12258,0.0,0.0,0.0,2052,49032,30780,-18252
12259,1.0,1.0,1.0,2053,49036,30795,-18241
12260,0.0,0.0,0.0,2053,49040,30795,-18245
12261,0.0,0.0,0.0,2053,49044,30795,-18249
12262,0.0,0.0,0.0,2053,49048,30795,-18253
12263,0.0,0.0,0.0,2053,49052,30795,-18257
12264,0.0,1.0,0.8,2053,49056,30795,-18261
12265,0.0,0.0,0.0,2053,49060,30795,-18265
12266,0.0,0.0,0.0,2053,49064,30795,-18269
12267,1.0,1.0,0.75,2054,49068,30810,-18258
12268,1.0,1.0,0.6666666666666666,2055,49072,30825,-18247
12269,0.0,0.0,0.0,2055,49076,30825,-18251
12270,0.0,0.0,0.0,2055,49080,30825,-18255
12271,0.0,0.0,0.0,2055,49084,30825,-18259
12272,0.0,0.0,0.0,2055,49088,30825,-18263
12273,1.0,1.0,1.0,2056,49092,30840,-18252
12274,0.0,0.0,0.0,2056,49096,30840,-18256
12275,0.0,0.0,0.0,2056,49100,30840,-18260
12276,0.0,0.0,0.0,2056,49104,30840,-18264
12277,1.0,1.0,1.0,2057,49108,30855,-18253
12278,1.0,1.0,1.0,2058,49112,30870,-18242
12279,0.0,0.0,0.0,2058,49116,30870,-18246
12280,0.0,0.0,0.0,2058,49120,30870,-18250
12281,0.0,0.0,0.0,2058,49124,30870,-18254
12282,0.0,0.0,0.0,2058,49128,30870,-18258
12283,1.0,1.0,1.0,2059,49132,30885,-18247
12284,0.0,0.0,0.0,2059,49136,30885,-18251
12285,0.0,0.0,0.0,2059,49140,30885,-18255
12286,1.0,1.0,1.0,2060,49144,30900,-18244
12287,1.0,1.0,1.0,2061,49148,30915,-18233
12288,0.0,0.0,0.0,2061,49152,30915,-18237
12289,0.0,0.0,0.0,2061,49156,30915,-18241
12290,0.0,0.0,0.0,2061,49160,30915,-18245
12291,1.0,1.0,1.0,2062,49164,30930,-18234
12292,0.0,0.0,0.0,2062,49168,30930,-18238
12293,0.0,0.0,0.0,2062,49172,30930,-18242
12294,0.0,0.0,0.0,2062,49176,30930,-18246
12295,1.0,1.0,1.0,2063,49180,30945,-18235
12296,0.0,0.0,0.0,2063,49184,30945,-18239
12297,0.0,0.0,0.0,2063,49188,30945,-18243
12298,1.0,0.0,0.4,2064,49192,30960,-18232
12299,0.0,0.0,0.0,2064,49196,30960,-18236
12300,1.0,1.0,1.0,2065,49200,30975,-18225
12301,0.0,0.0,0.0,2065,49204,30975,-18229
12302,0.0,0.0,0.0,2065,49208,30975,-18233
12303,0.0,0.0,0.0,2065,49212,30975,-18237
12304,0.0,0.0,0.0,2065,49216,30975,-18241
12305,0.0,0.0,0.0,2065,49220,30975,-18245
12306,0.0,0.0,0.0,2065,49224,30975,-18249
12307,0.0,0.0,0.0,2065,49228,30975,-18253
12308,0.0,0.0,0.0,2065,49232,30975,-18257
12309,0.0,0.0,0.0,2065,49236,30975,-18261
12310,1.0,1.0,1.0,2066,49240,30990,-18250
12311,0.0,0.0,0.0,2066,49244,30990,-18254
12312,0.0,0.0,0.0,2066,49248,30990,-18258
12313,0.0,0.0,0.0,2066,49252,30990,-18262
12314,0.0,0.0,0.0,2066,49256,30990,-18266
12315,0.0,0.0,0.0,2066,49260,30990,-18270
12316,0.0,0.0,0.0,2066,49264,30990,-18274
12317,1.0,1.0,1.0,2067,49268,31005,-18263
12318,0.0,0.0,0.0,2067,49272,31005,-18267
12319,0.0,0.0,0.0,2067,49276,31005,-18271
12320,0.0,0.0,0.0,2067,49280,31005,-18275
12321,0.0,0.0,0.0,2067,49284,31005,-18279
12322,1.0,1.0,0.6666666666666666,2068,49288,31020,-18268
12323,0.0,0.0,0.0,2068,49292,31020,-18272
12324,0.0,0.0,0.0,2068,49296,31020,-18276
12325,0.0,0.0,0.0,2068,49300,31020,-18280
12326,0.0,0.0,0.0,2068,49304,31020,-18284
12327,1.0,1.0,1.0,2069,49308,31035,-18273
12328,0.0,0.0,0.0,2069,49312,31035,-18277
12329,0.0,0.0,0.0,2069,49316,31035,-18281
12330,1.0,1.0,1.0,2070,49320,31050,-18270
12331,0.0,0.0,0.0,2070,49324,31050,-18274
12332,0.0,0.0,0.3333333333333333,2070,49328,31050,-18278
12333,1.0,1.0,1.0,2071,49332,31065,-18267
12334,0.0,0.0,0.25,2071,49336,31065,-18271
12335,0.0,0.0,0.0,2071,49340,31065,-18275
12336,0.0,0.0,0.0,2071,49344,31065,-18279
12337,0.0,0.0,0.0,2071,49348,31065,-18283
12338,0.0,0.0,0.0,2071,49352,31065,-18287
12339,0.0,0.0,0.0,2071,49356,31065,-18291
12340,0.0,0.0,0.0,2071,49360,31065,-18295
12341,0.0,0.0,0.0,2071,49364,31065,-18299
12342,0.0,0.0,0.0,2071,49368,31065,-18303
12343,0.0,0.0,0.0,2071,49372,31065,-18307
12344,0.0,0.0,0.0,2071,49376,31065,-18311
12345,0.0,0.0,0.0,2071,49380,31065,-18315
12346,1.0,1.0,1.0,2072,49384,31080,-18304
12347,0.0,0.0,0.0,2072,49388,31080,-18308
12348,0.0,0.0,0.0,2072,49392,31080,-18312
12349,1.0,1.0,1.0,2073,49396,31095,-18301
12350,0.0,0.0,0.0,2073,49400,31095,-18305
12351,0.0,0.0,0.0,2073,49404,31095,-18309
12352,0.0,0.0,0.0,2073,49408,31095,-18313
12353,0.0,0.0,0.0,2073,49412,31095,-18317
12354,0.0,0.0,0.0,2073,49416,31095,-18321
12355,0.0,0.0,0.0,2073,49420,31095,-18325
12356,0.0,0.0,0.0,2073,49424,31095,-18329
12357,0.0,0.0,0.0,2073,49428,31095,-18333
12358,0.0,0.0,0.0,2073,49432,31095,-18337
12359,0.0,0.0,0.0,2073,49436,31095,-18341
12360,1.0,1.0,1.0,2074,49440,31110,-18330
12361,1.0,0.0,0.3333333333333333,2075,49444,31125,-18319
12362,0.0,0.0,0.0,2075,49448,31125,-18323
12363,0.0,0.0,0.0,2075,49452,31125,-18327
12364,0.0,0.0,0.0,2075,49456,31125,-18331
12365,1.0,0.0,0.4,2076,49460,31140,-18320
12366,1.0,1.0,1.0,2077,49464,31155,-18309
12367,1.0,1.0,0.6666666666666666,2078,49468,31170,-18298
12368,1.0,1.0,1.0,2079,49472,31185,-18287
12369,0.0,0.0,0.0,2079,49476,31185,-18291
12370,0.0,0.0,0.0,2079,49480,31185,-18295
12371,0.0,0.0,0.0,2079,49484,31185,-18299
12372,0.0,0.0,0.0,2079,49488,31185,-18303
12373,0.0,0.0,0.0,2079,49492,31185,-18307
12374,0.0,0.0,0.0,2079,49496,31185,-18311
12375,0.0,0.0,0.0,2079,49500,31185,-18315
12376,0.0,0.0,0.0,2079,49504,31185,-18319
12377,0.0,0.0,0.0,2079,49508,31185,-18323
12378,0.0,0.0,0.0,2079,49512,31185,-18327
12379,1.0,1.0,1.0,2080,49516,31200,-18316
12380,0.0,0.0,0.4,2080,49520,31200,-18320
12381,0.0,0.0,0.0,2080,49524,31200,-18324
12382,0.0,0.0,0.0,2080,49528,31200,-18328
12383,0.0,0.0,0.0,2080,49532,31200,-18332
12384,0.0,0.0,0.0,2080,49536,31200,-18336
12385,0.0,0.0,0.0,2080,49540,31200,-18340
12386,0.0,0.0,0.0,2080,49544,31200,-18344
12387,0.0,0.0,0.0,2080,49548,31200,-18348
12388,0.0,0.0,0.0,2080,49552,31200,-18352
12389,1.0,1.0,1.0,2081,49556,31215,-18341
12390,0.0,0.0,0.0,2081,49560,31215,-18345
12391,0.0,0.0,0.0,2081,49564,31215,-18349
12392,1.0,0.0,0.3333333333333333,2082,49568,31230,-18338
12393,0.0,0.0,0.0,2082,49572,31230,-18342
12394,0.0,0.0,0.0,2082,49576,31230,-18346
12395,0.0,0.0,0.0,2082,49580,31230,-18350
12396,1.0,1.0,0.75,2083,49584,31245,-18339
12397,0.0,0.0,0.0,2083,49588,31245,-18343
12398,0.0,0.0,0.0,2083,49592,31245,-18347
12399,0.0,0.0,0.0,2083,49596,31245,-18351
12400,1.0,1.0,1.0,2084,49600,31260,-18340
12401,0.0,0.0,0.0,2084,49604,31260,-18344
12402,0.0,0.0,0.0,2084,49608,31260,-18348
12403,1.0,1.0,1.0,2085,49612,31275,-18337
12404,0.0,0.0,0.0,2085,49616,31275,-18341
12405,0.0,0.0,0.0,2085,49620,31275,-18345
12406,0.0,0.0,0.0,2085,49624,31275,-18349
12407,0.0,0.0,0.0,2085,49628,31275,-18353
12408,1.0,1.0,1.0,2086,49632,31290,-18342
12409,0.0,0.0,0.0,2086,49636,31290,-18346
12410,0.0,0.0,0.0,2086,49640,31290,-18350
12411,0.0,0.0,0.0,2086,49644,31290,-18354
12412,0.0,0.0,0.0,2086,49648,31290,-18358
12413,1.0,1.0,1.0,2087,49652,31305,-18347
12414,0.0,0.0,0.0,2087,49656,31305,-18351
12415,1.0,1.0,1.0,2088,49660,31320,-18340
12416,1.0,1.0,1.0,2089,49664,31335,-18329
12417,0.0,0.0,0.0,2089,49668,31335,-18333
12418,0.0,0.0,0.0,2089,49672,31335,-18337
12419,0.0,0.0,0.0,2089,49676,31335,-18341
12420,1.0,1.0,1.0,2090,49680,31350,-18330
12421,0.0,0.0,0.0,2090,49684,31350,-18334
12422,0.0,0.0,0.0,2090,49688,31350,-18338
12423,0.0,0.0,0.0,2090,49692,31350,-18342
12424,0.0,1.0,0.75,2090,49696,31350,-18346
12425,0.0,0.0,0.0,2090,49700,31350,-18350
12426,0.0,1.0,0.8,2090,49704,31350,-18354
12427,0.0,0.0,0.0,2090,49708,31350,-18358
12428,0.0,0.0,0.0,2090,49712,31350,-18362
12429,0.0,0.0,0.0,2090,49716,31350,-18366
12430,1.0,1.0,1.0,2091,49720,31365,-18355
12431,0.0,0.0,0.0,2091,49724,31365,-18359
12432,0.0,0.0,0.0,2091,49728,31365,-18363
12433,0.0,0.0,0.0,2091,49732,31365,-18367
12434,0.0,0.0,0.0,2091,49736,31365,-18371
12435,0.0,0.0,0.0,2091,49740,31365,-18375
12436,0.0,0.0,0.0,2091,49744,31365,-18379
12437,0.0,0.0,0.0,2091,49748,31365,-18383
12438,0.0,0.0,0.0,2091,49752,31365,-18387
12439,1.0,1.0,1.0,2092,49756,31380,-18376
12440,0.0,0.0,0.0,2092,49760,31380,-18380
12441,0.0,0.0,0.0,2092,49764,31380,-18384
12442,1.0,1.0,0.6666666666666666,2093,49768,31395,-18373
12443,0.0,0.0,0.0,2093,49772,31395,-18377
12444,1.0,0.0,0.3333333333333333,2094,49776,31410,-18366
12445,0.0,0.0,0.0,2094,49780,31410,-18370
12446,0.0,0.0,0.0,2094,49784,31410,-18374
12447,0.0,0.0,0.0,2094,49788,31410,-18378
12448,0.0,0.0,0.0,2094,49792,31410,-18382
12449,0.0,0.0,0.0,2094,49796,31410,-18386
12450,1.0,0.0,0.4,2095,49800,31425,-18375
12451,1.0,1.0,1.0,2096,49804,31440,-18364
12452,0.0,0.0,0.0,2096,49808,31440,-18368
12453,0.0,0.0,0.0,2096,49812,31440,-18372
12454,1.0,1.0,1.0,2097,49816,31455,-18361
12455,0.0,0.0,0.0,2097,49820,31455,-18365
12456,0.0,0.0,0.0,2097,49824,31455,-18369
12457,0.0,0.0,0.0,2097,49828,31455,-18373
12458,0.0,0.0,0.0,2097,49832,31455,-18377
12459,0.0,0.0,0.0,2097,49836,31455,-18381
12460,1.0,1.0,1.0,2098,49840,31470,-18370
12461,0.0,0.0,0.0,2098,49844,31470,-18374
12462,0.0,0.0,0.0,2098,49848,31470,-18378
12463,1.0,1.0,1.0,2099,49852,31485,-18367
12464,0.0,0.0,0.0,2099,49856,31485,-18371
12465,0.0,0.0,0.0,2099,49860,31485,-18375
12466,0.0,0.0,0.0,2099,49864,31485,-18379
12467,0.0,0.0,0.0,2099,49868,31485,-18383
12468,0.0,0.0,0.0,2099,49872,31485,-18387
12469,1.0,1.0,1.0,2100,49876,31500,-18376
12470,0.0,0.0,0.0,2100,49880,31500,-18380
12471,0.0,0.0,0.0,2100,49884,31500,-18384
12472,0.0,0.0,0.0,2100,49888,31500,-18388
12473,0.0,0.0,0.0,2100,49892,31500,-18392
12474,0.0,0.0,0.0,2100,49896,31500,-18396
12475,0.0,0.0,0.0,2100,49900,31500,-18400
12476,0.0,0.0,0.0,2100,49904,31500,-18404
12477,0.0,0.0,0.0,2100,49908,31500,-18408
12478,0.0,0.0,0.0,2100,49912,31500,-18412
12479,1.0,1.0,1.0,2101,49916,31515,-18401
12480,1.0,1.0,1.0,2102,49920,31530,-18390
12481,0.0,0.0,0.0,2102,49924,31530,-18394
12482,1.0,1.0,1.0,2103,49928,31545,-18383
12483,1.0,1.0,1.0,2104,49932,31560,-18372
12484,1.0,1.0,1.0,2105,49936,31575,-18361
12485,1.0,1.0,1.0,2106,49940,31590,-18350
12486,0.0,0.0,0.0,2106,49944,31590,-18354
12487,0.0,0.0,0.0,2106,49948,31590,-18358
12488,0.0,0.0,0.0,2106,49952,31590,-18362
12489,1.0,1.0,1.0,2107,49956,31605,-18351
12490,0.0,0.0,0.0,2107,49960,31605,-18355
12491,0.0,0.0,0.0,2107,49964,31605,-18359
12492,0.0,0.0,0.0,2107,49968,31605,-18363
12493,0.0,0.0,0.0,2107,49972,31605,-18367
12494,0.0,0.0,0.0,2107,49976,31605,-18371
12495,1.0,1.0,0.6,2108,49980,31620,-18360
12496,0.0,0.0,0.0,2108,49984,31620,-18364
12497,1.0,1.0,0.6666666666666666,2109,49988,31635,-18353
12498,0.0,0.0,0.0,2109,49992,31635,-18357
12499,0.0,1.0,0.6,2109,49996,31635,-18361
12500,1.0,1.0,0.8,2110,50000,31650,-18350
12501,0.0,0.0,0.0,2110,50004,31650,-18354
12502,0.0,0.0,0.0,2110,50008,31650,-18358
12503,0.0,0.0,0.0,2110,50012,31650,-18362
12504,0.0,0.0,0.0,2110,50016,31650,-18366
12505,0.0,0.0,0.0,2110,50020,31650,-18370
12506,0.0,0.0,0.0,2110,50024,31650,-18374
12507,0.0,0.0,0.0,2110,50028,31650,-18378
12508,0.0,0.0,0.0,2110,50032,31650,-18382
12509,0.0,0.0,0.0,2110,50036,31650,-18386
12510,0.0,0.0,0.0,2110,50040,31650,-18390
12511,0.0,0.0,0.0,2110,50044,31650,-18394
12512,1.0,1.0,1.0,2111,50048,31665,-18383
12513,1.0,1.0,1.0,2112,50052,31680,-18372
12514,0.0,0.0,0.3333333333333333,2112,50056,31680,-18376
12515,0.0,0.0,0.0,2112,50060,31680,-18380
12516,0.0,0.0,0.0,2112,50064,31680,-18384
12517,0.0,0.0,0.0,2112,50068,31680,-18388
12518,0.0,0.0,0.3333333333333333,2112,50072,31680,-18392
12519,0.0,0.0,0.0,2112,50076,31680,-18396
12520,0.0,0.0,0.0,2112,50080,31680,-18400
12521,0.0,0.0,0.0,2112,50084,31680,-18404
12522,1.0,1.0,1.0,2113,50088,31695,-18393
12523,0.0,0.0,0.0,2113,50092,31695,-18397
12524,0.0,0.0,0.25,2113,50096,31695,-18401
12525,1.0,1.0,0.75,2114,50100,31710,-18390
12526,0.0,0.0,0.0,2114,50104,31710,-18394
12527,0.0,0.0,0.0,2114,50108,31710,-18398
12528,0.0,0.0,0.0,2114,50112,31710,-18402
12529,0.0,0.0,0.0,2114,50116,31710,-18406
12530,1.0,1.0,1.0,2115,50120,31725,-18395
12531,0.0,0.0,0.0,2115,50124,31725,-18399
12532,1.0,1.0,1.0,2116,50128,31740,-18388
12533,0.0,0.0,0.0,2116,50132,31740,-18392
12534,0.0,0.0,0.0,2116,50136,31740,-18396
12535,0.0,0.0,0.0,2116,50140,31740,-18400
12536,1.0,1.0,1.0,2117,50144,31755,-18389
12537,0.0,1.0,0.6666666666666666,2117,50148,31755,-18393
12538,0.0,0.0,0.0,2117,50152,31755,-18397
12539,0.0,0.0,0.0,2117,50156,31755,-18401
12540,1.0,0.0,0.25,2118,50160,31770,-18390
12541,0.0,0.0,0.0,2118,50164,31770,-18394
12542,0.0,0.0,0.0,2118,50168,31770,-18398
12543,0.0,0.0,0.0,2118,50172,31770,-18402
12544,0.0,0.0,0.0,2118,50176,31770,-18406
12545,0.0,0.0,0.0,2118,50180,31770,-18410
12546,0.0,0.0,0.0,2118,50184,31770,-18414
12547,0.0,0.0,0.0,2118,50188,31770,-18418
12548,0.0,0.0,0.0,2118,50192,31770,-18422
12549,0.0,0.0,0.0,2118,50196,31770,-18426
12550,0.0,0.0,0.2,2118,50200,31770,-18430
12551,0.0,0.0,0.0,2118,50204,31770,-18434
12552,0.0,0.0,0.0,2118,50208,31770,-18438
12553,0.0,0.0,0.0,2118,50212,31770,-18442
12554,0.0,0.0,0.0,2118,50216,31770,-18446
12555,0.0,0.0,0.0,2118,50220,31770,-18450
12556,0.0,0.0,0.0,2118,50224,31770,-18454
12557,0.0,0.0,0.0,2118,50228,31770,-18458
12558,1.0,1.0,1.0,2119,50232,31785,-18447
12559,0.0,0.0,0.0,2119,50236,31785,-18451
12560,0.0,0.0,0.0,2119,50240,31785,-18455
12561,0.0,0.0,0.0,2119,50244,31785,-18459
12562,0.0,0.0,0.0,2119,50248,31785,-18463
12563,0.0,0.0,0.0,2119,50252,31785,-18467
12564,0.0,0.0,0.0,2119,50256,31785,-18471
12565,0.0,0.0,0.0,2119,50260,31785,-18475
12566,0.0,0.0,0.0,2119,50264,31785,-18479
12567,1.0,1.0,1.0,2120,50268,31800,-18468
12568,0.0,0.0,0.0,2120,50272,31800,-18472
12569,1.0,0.0,0.3333333333333333,2121,50276,31815,-18461
12570,1.0,1.0,1.0,2122,50280,31830,-18450
12571,0.0,0.0,0.0,2122,50284,31830,-18454
12572,0.0,0.0,0.0,2122,50288,31830,-18458
12573,1.0,1.0,1.0,2123,50292,31845,-18447
12574,0.0,0.0,0.0,2123,50296,31845,-18451
12575,0.0,0.0,0.0,2123,50300,31845,-18455
12576,0.0,0.0,0.0,2123,50304,31845,-18459
12577,0.0,0.0,0.0,2123,50308,31845,-18463
12578,0.0,0.0,0.0,2123,50312,31845,-18467
12579,0.0,0.0,0.0,2123,50316,31845,-18471
12580,1.0,1.0,1.0,2124,50320,31860,-18460
12581,1.0,1.0,1.0,2125,50324,31875,-18449
12582,1.0,1.0,1.0,2126,50328,31890,-18438
12583,0.0,0.0,0.0,2126,50332,31890,-18442
12584,0.0,0.0,0.0,2126,50336,31890,-18446
12585,0.0,0.0,0.0,2126,50340,31890,-18450
12586,0.0,0.0,0.0,2126,50344,31890,-18454
12587,0.0,0.0,0.5,2126,50348,31890,-18458
12588,0.0,0.0,0.0,2126,50352,31890,-18462
12589,1.0,1.0,1.0,2127,50356,31905,-18451
12590,0.0,0.0,0.0,2127,50360,31905,-18455
12591,0.0,0.0,0.0,2127,50364,31905,-18459
12592,0.0,0.0,0.0,2127,50368,31905,-18463
12593,0.0,0.0,0.0,2127,50372,31905,-18467
12594,0.0,0.0,0.0,2127,50376,31905,-18471
12595,1.0,1.0,1.0,2128,50380,31920,-18460
12596,0.0,0.0,0.4,2128,50384,31920,-18464
12597,0.0,0.0,0.0,2128,50388,31920,-18468
12598,0.0,0.0,0.0,2128,50392,31920,-18472
12599,0.0,0.0,0.0,2128,50396,31920,-18476
12600,1.0,0.0,0.25,2129,50400,31935,-18465
12601,0.0,0.0,0.0,2129,50404,31935,-18469
12602,0.0,0.0,0.0,2129,50408,31935,-18473
12603,0.0,0.0,0.0,2129,50412,31935,-18477
12604,0.0,0.0,0.0,2129,50416,31935,-18481
12605,0.0,0.0,0.0,2129,50420,31935,-18485
12606,0.0,0.0,0.0,2129,50424,31935,-18489
12607,1.0,1.0,1.0,2130,50428,31950,-18478
12608,0.0,0.0,0.3333333333333333,2130,50432,31950,-18482
12609,0.0,1.0,0.8,2130,50436,31950,-18486
12610,0.0,0.0,0.0,2130,50440,31950,-18490
12611,0.0,0.0,0.0,2130,50444,31950,-18494
12612,0.0,0.0,0.0,2130,50448,31950,-18498
12613,0.0,0.0,0.0,2130,50452,31950,-18502
12614,0.0,0.0,0.0,2130,50456,31950,-18506
12615,0.0,0.0,0.0,2130,50460,31950,-18510
12616,0.0,0.0,0.0,2130,50464,31950,-18514
12617,0.0,0.0,0.0,2130,50468,31950,-18518
12618,0.0,0.0,0.0,2130,50472,31950,-18522
12619,1.0,1.0,1.0,2131,50476,31965,-18511
12620,0.0,0.0,0.3333333333333333,2131,50480,31965,-18515
12621,0.0,0.0,0.0,2131,50484,31965,-18519
12622,0.0,0.0,0.0,2131,50488,31965,-18523
12623,0.0,0.0,0.3333333333333333,2131,50492,31965,-18527
12624,0.0,0.0,0.0,2131,50496,31965,-18531
12625,0.0,0.0,0.0,2131,50500,31965,-18535
12626,0.0,0.0,0.25,2131,50504,31965,-18539
12627,0.0,0.0,0.0,2131,50508,31965,-18543
12628,0.0,0.0,0.0,2131,50512,31965,-18547
12629,0.0,0.0,0.0,2131,50516,31965,-18551
12630,0.0,0.0,0.0,2131,50520,31965,-18555
12631,0.0,0.0,0.0,2131,50524,31965,-18559
12632,0.0,0.0,0.0,2131,50528,31965,-18563
12633,0.0,0.0,0.0,2131,50532,31965,-18567
12634,0.0,0.0,0.0,2131,50536,31965,-18571
12635,0.0,0.0,0.0,2131,50540,31965,-18575
12636,0.0,0.0,0.0,2131,50544,31965,-18579
12637,0.0,0.0,0.0,2131,50548,31965,-18583
12638,1.0,1.0,1.0,2132,50552,31980,-18572
12639,1.0,1.0,1.0,2133,50556,31995,-18561
12640,0.0,0.0,0.0,2133,50560,31995,-18565
12641,0.0,0.0,0.0,2133,50564,31995,-18569
12642,1.0,1.0,1.0,2134,50568,32010,-18558
12643,1.0,1.0,1.0,2135,50572,32025,-18547
12644,0.0,0.0,0.0,2135,50576,32025,-18551
12645,0.0,1.0,0.6666666666666666,2135,50580,32025,-18555
12646,0.0,0.0,0.0,2135,50584,32025,-18559
12647,0.0,0.0,0.0,2135,50588,32025,-18563
12648,0.0,0.0,0.25,2135,50592,32025,-18567
12649,0.0,0.0,0.0,2135,50596,32025,-18571
12650,1.0,1.0,0.6666666666666666,2136,50600,32040,-18560
12651,0.0,0.0,0.0,2136,50604,32040,-18564
12652,0.0,0.0,0.0,2136,50608,32040,-18568
12653,0.0,0.0,0.0,2136,50612,32040,-18572
12654,0.0,0.0,0.0,2136,50616,32040,-18576
12655,0.0,0.0,0.0,2136,50620,32040,-18580
12656,0.0,0.0,0.0,2136,50624,32040,-18584
12657,1.0,1.0,0.6666666666666666,2137,50628,32055,-18573
12658,0.0,0.0,0.0,2137,50632,32055,-18577
12659,0.0,0.0,0.3333333333333333,2137,50636,32055,-18581
12660,0.0,0.0,0.0,2137,50640,32055,-18585
12661,0.0,0.0,0.0,2137,50644,32055,-18589
12662,1.0,1.0,1.0,2138,50648,32070,-18578
12663,0.0,0.0,0.3333333333333333,2138,50652,32070,-18582
12664,0.0,0.0,0.3333333333333333,2138,50656,32070,-18586
12665,0.0,0.0,0.0,2138,50660,32070,-18590
12666,0.0,0.0,0.0,2138,50664,32070,-18594
12667,0.0,0.0,0.0,2138,50668,32070,-18598
12668,1.0,1.0,0.8,2139,50672,32085,-18587
12669,0.0,0.0,0.0,2139,50676,32085,-18591
12670,0.0,0.0,0.0,2139,50680,32085,-18595
12671,1.0,1.0,1.0,2140,50684,32100,-18584
12672,1.0,1.0,0.6666666666666666,2141,50688,32115,-18573
12673,0.0,0.0,0.0,2141,50692,32115,-18577
12674,0.0,0.0,0.0,2141,50696,32115,-18581
12675,0.0,0.0,0.0,2141,50700,32115,-18585
12676,0.0,0.0,0.0,2141,50704,32115,-18589
12677,0.0,0.0,0.0,2141,50708,32115,-18593
12678,1.0,1.0,1.0,2142,50712,32130,-18582
12679,0.0,0.0,0.0,2142,50716,32130,-18586
12680,0.0,0.0,0.0,2142,50720,32130,-18590
12681,0.0,0.0,0.0,2142,50724,32130,-18594
12682,0.0,0.0,0.0,2142,50728,32130,-18598
12683,0.0,0.0,0.0,2142,50732,32130,-18602
12684,0.0,0.0,0.3333333333333333,2142,50736,32130,-18606
12685,0.0,0.0,0.0,2142,50740,32130,-18610
12686,0.0,0.0,0.0,2142,50744,32130,-18614
12687,0.0,0.0,0.0,2142,50748,32130,-18618
12688,0.0,0.0,0.0,2142,50752,32130,-18622
12689,0.0,0.0,0.0,2142,50756,32130,-18626
12690,1.0,1.0,1.0,2143,50760,32145,-18615
12691,0.0,0.0,0.0,2143,50764,32145,-18619
12692,0.0,0.0,0.0,2143,50768,32145,-18623
12693,0.0,0.0,0.0,2143,50772,32145,-18627
12694,0.0,0.0,0.0,2143,50776,32145,-18631
12695,0.0,0.0,0.0,2143,50780,32145,-18635
12696,0.0,0.0,0.0,2143,50784,32145,-18639
12697,1.0,1.0,1.0,2144,50788,32160,-18628
12698,0.0,0.0,0.0,2144,50792,32160,-18632
12699,1.0,1.0,1.0,2145,50796,32175,-18621
12700,0.0,0.0,0.0,2145,50800,32175,-18625
12701,0.0,0.0,0.0,2145,50804,32175,-18629
12702,0.0,0.0,0.0,2145,50808,32175,-18633
12703,0.0,0.0,0.0,2145,50812,32175,-18637
12704,0.0,0.0,0.0,2145,50816,32175,-18641
12705,1.0,1.0,1.0,2146,50820,32190,-18630
12706,1.0,0.0,0.2,2147,50824,32205,-18619
12707,0.0,0.0,0.0,2147,50828,32205,-18623
12708,0.0,0.0,0.0,2147,50832,32205,-18627
12709,1.0,1.0,1.0,2148,50836,32220,-18616
12710,0.0,0.0,0.0,2148,50840,32220,-18620
12711,0.0,0.0,0.3333333333333333,2148,50844,32220,-18624
12712,1.0,0.0,0.3333333333333333,2149,50848,32235,-18613
12713,1.0,1.0,1.0,2150,50852,32250,-18602
12714,0.0,0.0,0.0,2150,50856,32250,-18606
12715,1.0,1.0,1.0,2151,50860,32265,-18595
12716,0.0,0.0,0.0,2151,50864,32265,-18599
12717,0.0,0.0,0.0,2151,50868,32265,-18603
12718,0.0,0.0,0.3333333333333333,2151,50872,32265,-18607
12719,1.0,1.0,1.0,2152,50876,32280,-18596
12720,1.0,1.0,0.6666666666666666,2153,50880,32295,-18585
12721,0.0,0.0,0.0,2153,50884,32295,-18589
12722,0.0,0.0,0.0,2153,50888,32295,-18593
12723,0.0,0.0,0.0,2153,50892,32295,-18597
12724,1.0,1.0,1.0,2154,50896,32310,-18586
12725,0.0,0.0,0.0,2154,50900,32310,-18590
12726,1.0,1.0,1.0,2155,50904,32325,-18579
12727,0.0,0.0,0.0,2155,50908,32325,-18583
12728,0.0,0.0,0.0,2155,50912,32325,-18587
12729,0.0,0.0,0.0,2155,50916,32325,-18591
12730,0.0,0.0,0.0,2155,50920,32325,-18595
12731,0.0,0.0,0.0,2155,50924,32325,-18599
12732,0.0,0.0,0.0,2155,50928,32325,-18603
12733,1.0,1.0,1.0,2156,50932,32340,-18592
12734,0.0,0.0,0.0,2156,50936,32340,-18596
12735,0.0,0.0,0.0,2156,50940,32340,-18600
12736,1.0,1.0,1.0,2157,50944,32355,-18589
12737,0.0,0.0,0.0,2157,50948,32355,-18593
12738,0.0,0.0,0.0,2157,50952,32355,-18597
12739,0.0,0.0,0.0,2157,50956,32355,-18601
12740,0.0,0.0,0.0,2157,50960,32355,-18605
12741,0.0,0.0,0.0,2157,50964,32355,-18609
12742,0.0,0.0,0.0,2157,50968,32355,-18613
12743,0.0,0.0,0.0,2157,50972,32355,-18617
12744,0.0,0.0,0.25,2157,50976,32355,-18621
12745,0.0,0.0,0.0,2157,50980,32355,-18625
12746,0.0,0.0,0.0,2157,50984,32355,-18629
12747,0.0,0.0,0.0,2157,50988,32355,-18633
12748,0.0,0.0,0.0,2157,50992,32355,-18637
12749,1.0,1.0,1.0,2158,50996,32370,-18626
12750,1.0,1.0,1.0,2159,51000,32385,-18615
12751,0.0,0.0,0.0,2159,51004,32385,-18619
12752,0.0,0.0,0.0,2159,51008,32385,-18623
12753,0.0,0.0,0.0,2159,51012,32385,-18627
12754,0.0,0.0,0.0,2159,51016,32385,-18631
12755,0.0,0.0,0.0,2159,51020,32385,-18635
12756,0.0,0.0,0.0,2159,51024,32385,-18639
12757,1.0,1.0,1.0,2160,51028,32400,-18628
12758,1.0,1.0,1.0,2161,51032,32415,-18617
12759,0.0,0.0,0.0,2161,51036,32415,-18621
12760,0.0,0.0,0.3333333333333333,2161,51040,32415,-18625
12761,0.0,0.0,0.3333333333333333,2161,51044,32415,-18629
12762,1.0,1.0,0.6666666666666666,2162,51048,32430,-18618
12763,0.0,0.0,0.0,2162,51052,32430,-18622
12764,1.0,1.0,0.75,2163,51056,32445,-18611
12765,0.0,0.0,0.0,2163,51060,32445,-18615
12766,0.0,0.0,0.0,2163,51064,32445,-18619
12767,0.0,0.0,0.0,2163,51068,32445,-18623
12768,0.0,0.0,0.0,2163,51072,32445,-18627
12769,0.0,0.0,0.0,2163,51076,32445,-18631
12770,0.0,0.0,0.0,2163,51080,32445,-18635
12771,0.0,0.0,0.0,2163,51084,32445,-18639
12772,0.0,0.0,0.0,2163,51088,32445,-18643
12773,0.0,0.0,0.0,2163,51092,32445,-18647
12774,0.0,0.0,0.0,2163,51096,32445,-18651
12775,1.0,1.0,1.0,2164,51100,32460,-18640
12776,0.0,0.0,0.0,2164,51104,32460,-18644
12777,0.0,0.0,0.0,2164,51108,32460,-18648
12778,0.0,0.0,0.0,2164,51112,32460,-18652
12779,1.0,0.0,0.3333333333333333,2165,51116,32475,-18641
12780,0.0,0.0,0.0,2165,51120,32475,-18645
12781,0.0,0.0,0.0,2165,51124,32475,-18649
12782,0.0,0.0,0.0,2165,51128,32475,-18653
12783,1.0,1.0,1.0,2166,51132,32490,-18642
12784,0.0,0.0,0.0,2166,51136,32490,-18646
12785,0.0,0.0,0.0,2166,51140,32490,-18650
12786,0.0,0.0,0.0,2166,51144,32490,-18654
12787,0.0,0.0,0.0,2166,51148,32490,-18658
12788,0.0,0.0,0.0,2166,51152,32490,-18662
12789,0.0,0.0,0.0,2166,51156,32490,-18666
12790,0.0,0.0,0.0,2166,51160,32490,-18670
12791,0.0,0.0,0.0,2166,51164,32490,-18674
12792,0.0,0.0,0.0,2166,51168,32490,-18678
12793,0.0,0.0,0.3333333333333333,2166,51172,32490,-18682
12794,0.0,0.0,0.0,2166,51176,32490,-18686
12795,0.0,0.0,0.0,2166,51180,32490,-18690
12796,0.0,0.0,0.0,2166,51184,32490,-18694
12797,0.0,0.0,0.0,2166,51188,32490,-18698
12798,0.0,0.0,0.0,2166,51192,32490,-18702
12799,1.0,1.0,1.0,2167,51196,32505,-18691
12800,1.0,0.0,0.3333333333333333,2168,51200,32520,-18680
12801,0.0,0.0,0.0,2168,51204,32520,-18684
12802,1.0,1.0,1.0,2169,51208,32535,-18673
12803,1.0,1.0,1.0,2170,51212,32550,-18662
12804,0.0,0.0,0.0,2170,51216,32550,-18666
12805,1.0,1.0,1.0,2171,51220,32565,-18655
12806,0.0,0.0,0.0,2171,51224,32565,-18659
12807,0.0,0.0,0.0,2171,51228,32565,-18663
12808,0.0,1.0,0.6,2171,51232,32565,-18667
12809,0.0,0.0,0.0,2171,51236,32565,-18671
12810,0.0,0.0,0.0,2171,51240,32565,-18675
12811,0.0,0.0,0.0,2171,51244,32565,-18679
12812,1.0,1.0,1.0,2172,51248,32580,-18668
12813,0.0,0.0,0.0,2172,51252,32580,-18672
12814,0.0,0.0,0.0,2172,51256,32580,-18676
12815,1.0,1.0,0.75,2173,51260,32595,-18665
12816,0.0,0.0,0.0,2173,51264,32595,-18669
12817,1.0,1.0,1.0,2174,51268,32610,-18658
12818,1.0,1.0,1.0,2175,51272,32625,-18647
12819,0.0,0.0,0.0,2175,51276,32625,-18651
12820,1.0,1.0,0.6666666666666666,2176,51280,32640,-18640
12821,0.0,0.0,0.0,2176,51284,32640,-18644
12822,0.0,0.0,0.0,2176,51288,32640,-18648
12823,0.0,0.0,0.0,2176,51292,32640,-18652
12824,0.0,1.0,0.6666666666666666,2176,51296,32640,-18656
12825,1.0,1.0,1.0,2177,51300,32655,-18645
12826,1.0,1.0,1.0,2178,51304,32670,-18634
12827,0.0,0.0,0.0,2178,51308,32670,-18638
12828,0.0,0.0,0.0,2178,51312,32670,-18642
12829,0.0,0.0,0.0,2178,51316,32670,-18646
12830,0.0,0.0,0.0,2178,51320,32670,-18650
12831,0.0,0.0,0.0,2178,51324,32670,-18654
12832,0.0,0.0,0.0,2178,51328,32670,-18658
12833,0.0,0.0,0.0,2178,51332,32670,-18662
12834,0.0,0.0,0.0,2178,51336,32670,-18666
12835,0.0,0.0,0.0,2178,51340,32670,-18670
12836,0.0,0.0,0.0,2178,51344,32670,-18674
12837,0.0,0.0,0.0,2178,51348,32670,-18678
12838,0.0,0.0,0.0,2178,51352,32670,-18682
12839,0.0,0.0,0.0,2178,51356,32670,-18686
12840,1.0,1.0,1.0,2179,51360,32685,-18675
12841,0.0,0.0,0.0,2179,51364,32685,-18679
12842,0.0,0.0,0.0,2179,51368,32685,-18683
12843,0.0,0.0,0.0,2179,51372,32685,-18687
12844,0.0,0.0,0.0,2179,51376,32685,-18691
12845,0.0,0.0,0.0,2179,51380,32685,-18695
12846,0.0,0.0,0.0,2179,51384,32685,-18699
12847,0.0,0.0,0.0,2179,51388,32685,-18703
12848,0.0,0.0,0.0,2179,51392,32685,-18707
12849,0.0,0.0,0.0,2179,51396,32685,-18711
12850,0.0,0.0,0.0,2179,51400,32685,-18715
12851,0.0,0.0,0.0,2179,51404,32685,-18719
12852,0.0,0.0,0.0,2179,51408,32685,-18723
12853,1.0,1.0,1.0,2180,51412,32700,-18712
12854,0.0,0.0,0.0,2180,51416,32700,-18716
12855,0.0,0.0,0.0,2180,51420,32700,-18720
12856,1.0,1.0,1.0,2181,51424,32715,-18709
12857,1.0,1.0,1.0,2182,51428,32730,-18698
12858,0.0,0.0,0.0,2182,51432,32730,-18702
12859,0.0,0.0,0.0,2182,51436,32730,-18706
12860,0.0,0.0,0.0,2182,51440,32730,-18710
12861,0.0,0.0,0.0,2182,51444,32730,-18714
12862,0.0,0.0,0.0,2182,51448,32730,-18718
12863,0.0,0.0,0.0,2182,51452,32730,-18722
12864,0.0,0.0,0.0,2182,51456,32730,-18726
12865,0.0,0.0,0.0,2182,51460,32730,-18730
12866,1.0,1.0,1.0,2183,51464,32745,-18719
12867,0.0,0.0,0.0,2183,51468,32745,-18723
12868,0.0,0.0,0.0,2183,51472,32745,-18727
12869,0.0,0.0,0.3333333333333333,2183,51476,32745,-18731
12870,0.0,0.0,0.0,2183,51480,32745,-18735
12871,0.0,0.0,0.0,2183,51484,32745,-18739
12872,0.0,0.0,0.0,2183,51488,32745,-18743
12873,0.0,0.0,0.0,2183,51492,32745,-18747
12874,0.0,0.0,0.0,2183,51496,32745,-18751
12875,0.0,1.0,0.6666666666666666,2183,51500,32745,-18755
12876,0.0,0.0,0.3333333333333333,2183,51504,32745,-18759
12877,0.0,0.0,0.0,2183,51508,32745,-18763
12878,0.0,0.0,0.0,2183,51512,32745,-18767
12879,0.0,0.0,0.0,2183,51516,32745,-18771
12880,0.0,0.0,0.0,2183,51520,32745,-18775
12881,0.0,0.0,0.0,2183,51524,32745,-18779
12882,0.0,0.0,0.0,2183,51528,32745,-18783
12883,0.0,0.0,0.0,2183,51532,32745,-18787
12884,0.0,0.0,0.0,2183,51536,32745,-18791
12885,0.0,0.0,0.0,2183,51540,32745,-18795
12886,0.0,0.0,0.0,2183,51544,32745,-18799
12887,1.0,1.0,1.0,2184,51548,32760,-18788
12888,1.0,1.0,1.0,2185,51552,32775,-18777
12889,1.0,1.0,1.0,2186,51556,32790,-18766
12890,0.0,0.0,0.0,2186,51560,32790,-18770
12891,0.0,0.0,0.0,2186,51564,32790,-18774
12892,1.0,1.0,1.0,2187,51568,32805,-18763
12893,1.0,1.0,1.0,2188,51572,32820,-18752
12894,0.0,1.0,0.8,2188,51576,32820,-18756
12895,0.0,0.0,0.0,2188,51580,32820,-18760
12896,0.0,0.0,0.0,2188,51584,32820,-18764
12897,0.0,0.0,0.0,2188,51588,32820,-18768
12898,0.0,0.0,0.0,2188,51592,32820,-18772
12899,0.0,0.0,0.0,2188,51596,32820,-18776
12900,0.0,0.0,0.0,2188,51600,32820,-18780
12901,1.0,1.0,1.0,2189,51604,32835,-18769
12902,0.0,0.0,0.0,2189,51608,32835,-18773
12903,0.0,0.0,0.0,2189,51612,32835,-18777
12904,0.0,0.0,0.3333333333333333,2189,51616,32835,-18781
12905,1.0,1.0,1.0,2190,51620,32850,-18770
12906,0.0,0.0,0.0,2190,51624,32850,-18774
12907,0.0,0.0,0.0,2190,51628,32850,-18778
12908,0.0,0.0,0.0,2190,51632,32850,-18782
12909,1.0,1.0,1.0,2191,51636,32865,-18771
12910,0.0,0.0,0.0,2191,51640,32865,-18775
12911,0.0,0.0,0.0,2191,51644,32865,-18779
12912,0.0,0.0,0.0,2191,51648,32865,-18783
12913,0.0,0.0,0.0,2191,51652,32865,-18787
12914,0.0,0.0,0.0,2191,51656,32865,-18791
12915,1.0,1.0,0.6666666666666666,2192,51660,32880,-18780
12916,0.0,0.0,0.0,2192,51664,32880,-18784
12917,1.0,1.0,1.0,2193,51668,32895,-18773
12918,0.0,0.0,0.0,2193,51672,32895,-18777
12919,0.0,0.0,0.0,2193,51676,32895,-18781
12920,0.0,0.0,0.0,2193,51680,32895,-18785
12921,0.0,0.0,0.3333333333333333,2193,51684,32895,-18789
12922,0.0,0.0,0.0,2193,51688,32895,-18793
12923,0.0,0.0,0.0,2193,51692,32895,-18797
12924,1.0,1.0,1.0,2194,51696,32910,-18786
12925,0.0,0.0,0.0,2194,51700,32910,-18790
12926,0.0,0.0,0.0,2194,51704,32910,-18794
12927,0.0,0.0,0.0,2194,51708,32910,-18798
12928,0.0,0.0,0.0,2194,51712,32910,-18802
12929,0.0,0.0,0.0,2194,51716,32910,-18806
12930,0.0,0.0,0.0,2194,51720,32910,-18810
12931,0.0,0.0,0.0,2194,51724,32910,-18814
12932,0.0,0.0,0.0,2194,51728,32910,-18818
12933,0.0,0.0,0.0,2194,51732,32910,-18822
12934,0.0,0.0,0.0,2194,51736,32910,-18826
12935,0.0,0.0,0.0,2194,51740,32910,-18830
12936,0.0,0.0,0.3333333333333333,2194,51744,32910,-18834
12937,0.0,0.0,0.0,2194,51748,32910,-18838
12938,0.0,0.0,0.0,2194,51752,32910,-18842
12939,0.0,0.0,0.0,2194,51756,32910,-18846
12940,1.0,1.0,0.6666666666666666,2195,51760,32925,-18835
12941,0.0,0.0,0.0,2195,51764,32925,-18839
12942,0.0,0.0,0.0,2195,51768,32925,-18843
12943,0.0,0.0,0.0,2195,51772,32925,-18847
12944,0.0,0.0,0.0,2195,51776,32925,-18851
12945,0.0,0.0,0.0,2195,51780,32925,-18855
12946,0.0,0.0,0.0,2195,51784,32925,-18859
12947,0.0,0.0,0.0,2195,51788,32925,-18863
12948,0.0,0.0,0.0,2195,51792,32925,-18867
12949,0.0,0.0,0.0,2195,51796,32925,-18871
12950,1.0,0.0,0.3333333333333333,2196,51800,32940,-18860
12951,1.0,1.0,1.0,2197,51804,32955,-18849
12952,0.0,0.0,0.0,2197,51808,32955,-18853
12953,0.0,0.0,0.0,2197,51812,32955,-18857
12954,0.0,0.0,0.0,2197,51816,32955,-18861
12955,0.0,0.0,0.0,2197,51820,32955,-18865
12956,0.0,0.0,0.0,2197,51824,32955,-18869
12957,0.0,0.0,0.0,2197,51828,32955,-18873
12958,1.0,1.0,1.0,2198,51832,32970,-18862
12959,1.0,1.0,1.0,2199,51836,32985,-18851
12960,0.0,0.0,0.0,2199,51840,32985,-18855
12961,1.0,1.0,1.0,2200,51844,33000,-18844
12962,1.0,1.0,1.0,2201,51848,33015,-18833
12963,0.0,0.0,0.0,2201,51852,33015,-18837
12964,0.0,0.0,0.0,2201,51856,33015,-18841
12965,1.0,1.0,0.6,2202,51860,33030,-18830
12966,0.0,0.0,0.0,2202,51864,33030,-18834
12967,0.0,0.0,0.0,2202,51868,33030,-18838
12968,0.0,0.0,0.0,2202,51872,33030,-18842
12969,1.0,0.0,0.3333333333333333,2203,51876,33045,-18831
12970,0.0,0.0,0.0,2203,51880,33045,-18835
12971,1.0,1.0,0.6666666666666666,2204,51884,33060,-18824
12972,0.0,0.0,0.0,2204,51888,33060,-18828
12973,1.0,1.0,0.6,2205,51892,33075,-18817
12974,0.0,1.0,0.6666666666666666,2205,51896,33075,-18821
12975,0.0,0.0,0.0,2205,51900,33075,-18825
12976,0.0,0.0,0.0,2205,51904,33075,-18829
12977,0.0,0.0,0.0,2205,51908,33075,-18833
12978,1.0,1.0,1.0,2206,51912,33090,-18822
12979,1.0,1.0,0.6666666666666666,2207,51916,33105,-18811
12980,0.0,0.0,0.0,2207,51920,33105,-18815
12981,1.0,1.0,1.0,2208,51924,33120,-18804
12982,0.0,0.0,0.0,2208,51928,33120,-18808
12983,0.0,0.0,0.0,2208,51932,33120,-18812
12984,0.0,0.0,0.0,2208,51936,33120,-18816
12985,1.0,1.0,1.0,2209,51940,33135,-18805
12986,0.0,0.0,0.0,2209,51944,33135,-18809
12987,1.0,1.0,0.75,2210,51948,33150,-18798
12988,0.0,0.0,0.0,2210,51952,33150,-18802
12989,0.0,0.0,0.0,2210,51956,33150,-18806
12990,0.0,0.0,0.0,2210,51960,33150,-18810
12991,0.0,0.0,0.0,2210,51964,33150,-18814
12992,0.0,0.0,0.0,2210,51968,33150,-18818
12993,0.0,0.0,0.0,2210,51972,33150,-18822
12994,0.0,0.0,0.0,2210,51976,33150,-18826
12995,0.0,0.0,0.0,2210,51980,33150,-18830
12996,1.0,1.0,1.0,2211,51984,33165,-18819
12997,0.0,0.0,0.0,2211,51988,33165,-18823
12998,1.0,1.0,1.0,2212,51992,33180,-18812
12999,1.0,1.0,1.0,2213,51996,33195,-18801
13000,0.0,0.0,0.0,2213,52000,33195,-18805
13001,0.0,0.0,0.0,2213,52004,33195,-18809
13002,1.0,0.0,0.3333333333333333,2214,52008,33210,-18798
13003,0.0,0.0,0.0,2214,52012,33210,-18802
13004,1.0,1.0,1.0,2215,52016,33225,-18791
13005,0.0,0.0,0.0,2215,52020,33225,-18795
13006,0.0,0.0,0.0,2215,52024,33225,-18799
13007,0.0,0.0,0.0,2215,52028,33225,-18803
13008,1.0,1.0,0.75,2216,52032,33240,-18792
13009,0.0,0.0,0.0,2216,52036,33240,-18796
13010,1.0,1.0,1.0,2217,52040,33255,-18785
13011,0.0,0.0,0.0,2217,52044,33255,-18789
13012,0.0,0.0,0.0,2217,52048,33255,-18793
13013,0.0,0.0,0.0,2217,52052,33255,-18797
13014,0.0,0.0,0.0,2217,52056,33255,-18801
13015,0.0,0.0,0.0,2217,52060,33255,-18805
13016,0.0,0.0,0.0,2217,52064,33255,-18809
13017,0.0,0.0,0.0,2217,52068,33255,-18813
13018,0.0,0.0,0.0,2217,52072,33255,-18817
13019,0.0,0.0,0.0,2217,52076,33255,-18821
13020,1.0,1.0,1.0,2218,52080,33270,-18810
13021,0.0,0.0,0.0,2218,52084,33270,-18814
13022,0.0,0.0,0.0,2218,52088,33270,-18818
13023,0.0,0.0,0.0,2218,52092,33270,-18822
13024,0.0,0.0,0.0,2218,52096,33270,-18826
13025,0.0,0.0,0.0,2218,52100,33270,-18830
13026,0.0,0.0,0.0,2218,52104,33270,-18834
13027,1.0,1.0,1.0,2219,52108,33285,-18823
13028,1.0,1.0,1.0,2220,52112,33300,-18812
13029,0.0,0.0,0.0,2220,52116,33300,-18816
13030,0.0,0.0,0.3333333333333333,2220,52120,33300,-18820
13031,0.0,0.0,0.0,2220,52124,33300,-18824
13032,0.0,0.0,0.0,2220,52128,33300,-18828
13033,0.0,0.0,0.0,2220,52132,33300,-18832
13034,1.0,1.0,1.0,2221,52136,33315,-18821
13035,0.0,0.0,0.0,2221,52140,33315,-18825
13036,0.0,0.0,0.0,2221,52144,33315,-18829
13037,1.0,1.0,1.0,2222,52148,33330,-18818
13038,0.0,0.0,0.0,2222,52152,33330,-18822
13039,0.0,0.0,0.0,2222,52156,33330,-18826
13040,0.0,0.0,0.0,2222,52160,33330,-18830
13041,0.0,0.0,0.25,2222,52164,33330,-18834
13042,0.0,0.0,0.0,2222,52168,33330,-18838
13043,1.0,1.0,1.0,2223,52172,33345,-18827
13044,0.0,0.0,0.0,2223,52176,33345,-18831
13045,0.0,0.0,0.3333333333333333,2223,52180,33345,-18835
13046,0.0,0.0,0.0,2223,52184,33345,-18839
13047,0.0,0.0,0.0,2223,52188,33345,-18843
13048,0.0,0.0,0.0,2223,52192,33345,-18847
13049,0.0,0.0,0.0,2223,52196,33345,-18851
13050,0.0,0.0,0.0,2223,52200,33345,-18855
13051,1.0,1.0,0.6,2224,52204,33360,-18844
13052,0.0,0.0,0.0,2224,52208,33360,-18848
13053,0.0,0.0,0.0,2224,52212,33360,-18852
13054,0.0,0.0,0.0,2224,52216,33360,-18856
13055,0.0,0.0,0.0,2224,52220,33360,-18860
13056,0.0,0.0,0.0,2224,52224,33360,-18864
13057,0.0,0.0,0.0,2224,52228,33360,-18868
13058,0.0,0.0,0.0,2224,52232,33360,-18872
13059,0.0,0.0,0.0,2224,52236,33360,-18876
13060,1.0,1.0,1.0,2225,52240,33375,-18865
13061,1.0,1.0,1.0,2226,52244,33390,-18854
13062,0.0,0.0,0.0,2226,52248,33390,-18858
13063,0.0,0.0,0.0,2226,52252,33390,-18862
13064,0.0,0.0,0.0,2226,52256,33390,-18866
13065,0.0,0.0,0.0,2226,52260,33390,-18870
13066,0.0,0.0,0.0,2226,52264,33390,-18874
13067,1.0,1.0,1.0,2227,52268,33405,-18863
13068,0.0,0.0,0.0,2227,52272,33405,-18867
13069,0.0,0.0,0.0,2227,52276,33405,-18871
13070,0.0,0.0,0.0,2227,52280,33405,-18875
13071,0.0,0.0,0.0,2227,52284,33405,-18879
13072,0.0,0.0,0.0,2227,52288,33405,-18883
13073,0.0,0.0,0.0,2227,52292,33405,-18887
13074,0.0,0.0,0.0,2227,52296,33405,-18891
13075,0.0,0.0,0.0,2227,52300,33405,-18895
13076,0.0,0.0,0.0,2227,52304,33405,-18899
13077,0.0,0.0,0.3333333333333333,2227,52308,33405,-18903
13078,0.0,0.0,0.0,2227,52312,33405,-18907
13079,0.0,0.0,0.0,2227,52316,33405,-18911
13080,0.0,0.0,0.0,2227,52320,33405,-18915
13081,0.0,0.0,0.0,2227,52324,33405,-18919
13082,0.0,0.0,0.0,2227,52328,33405,-18923
13083,0.0,0.0,0.0,2227,52332,33405,-18927
13084,0.0,0.0,0.0,2227,52336,33405,-18931
13085,0.0,0.0,0.0,2227,52340,33405,-18935
13086,0.0,0.0,0.0,2227,52344,33405,-18939
13087,0.0,0.0,0.0,2227,52348,33405,-18943
13088,0.0,0.0,0.0,2227,52352,33405,-18947
13089,0.0,0.0,0.0,2227,52356,33405,-18951
13090,0.0,0.0,0.0,2227,52360,33405,-18955
13091,0.0,0.0,0.0,2227,52364,33405,-18959
13092,0.0,0.0,0.0,2227,52368,33405,-18963
13093,0.0,0.0,0.0,2227,52372,33405,-18967
13094,0.0,0.0,0.0,2227,52376,33405,-18971
13095,0.0,0.0,0.0,2227,52380,33405,-18975
13096,0.0,0.0,0.0,2227,52384,33405,-18979
13097,1.0,1.0,1.0,2228,52388,33420,-18968
13098,0.0,0.0,0.0,2228,52392,33420,-18972
13099,0.0,0.0,0.0,2228,52396,33420,-18976
13100,0.0,0.0,0.0,2228,52400,33420,-18980
13101,0.0,0.0,0.0,2228,52404,33420,-18984
13102,1.0,1.0,1.0,2229,52408,33435,-18973
13103,1.0,1.0,1.0,2230,52412,33450,-18962
13104,1.0,1.0,1.0,2231,52416,33465,-18951
13105,1.0,1.0,0.6,2232,52420,33480,-18940
13106,0.0,0.0,0.0,2232,52424,33480,-18944
13107,0.0,0.0,0.0,2232,52428,33480,-18948
13108,0.0,0.0,0.0,2232,52432,33480,-18952
13109,0.0,0.0,0.0,2232,52436,33480,-18956
13110,0.0,0.0,0.0,2232,52440,33480,-18960
13111,0.0,0.0,0.25,2232,52444,33480,-18964
13112,1.0,0.0,0.3333333333333333,2233,52448,33495,-18953
13113,0.0,0.0,0.0,2233,52452,33495,-18957
13114,0.0,0.0,0.0,2233,52456,33495,-18961
13115,0.0,0.0,0.4,2233,52460,33495,-18965
13116,0.0,0.0,0.0,2233,52464,33495,-18969
13117,0.0,0.0,0.0,2233,52468,33495,-18973
13118,1.0,1.0,1.0,2234,52472,33510,-18962
13119,0.0,0.0,0.0,2234,52476,33510,-18966
13120,0.0,0.0,0.0,2234,52480,33510,-18970
13121,0.0,0.0,0.0,2234,52484,33510,-18974
13122,0.0,0.0,0.0,2234,52488,33510,-18978
13123,1.0,1.0,1.0,2235,52492,33525,-18967
13124,0.0,0.0,0.0,2235,52496,33525,-18971
13125,0.0,0.0,0.0,2235,52500,33525,-18975
13126,0.0,0.0,0.0,2235,52504,33525,-18979
13127,0.0,0.0,0.0,2235,52508,33525,-18983
13128,0.0,0.0,0.0,2235,52512,33525,-18987
13129,1.0,0.0,0.3333333333333333,2236,52516,33540,-18976
13130,0.0,0.0,0.0,2236,52520,33540,-18980
13131,0.0,0.0,0.0,2236,52524,33540,-18984
13132,0.0,0.0,0.0,2236,52528,33540,-18988
13133,0.0,0.0,0.0,2236,52532,33540,-18992
13134,0.0,0.0,0.0,2236,52536,33540,-18996
13135,0.0,0.0,0.0,2236,52540,33540,-19000
13136,0.0,0.0,0.0,2236,52544,33540,-19004
13137,0.0,0.0,0.0,2236,52548,33540,-19008
13138,0.0,0.0,0.0,2236,52552,33540,-19012
13139,0.0,0.0,0.0,2236,52556,33540,-19016
13140,0.0,0.0,0.0,2236,52560,33540,-19020
13141,0.0,0.0,0.0,2236,52564,33540,-19024
13142,0.0,0.0,0.0,2236,52568,33540,-19028
13143,0.0,0.0,0.0,2236,52572,33540,-19032
13144,0.0,0.0,0.0,2236,52576,33540,-19036
13145,0.0,0.0,0.0,2236,52580,33540,-19040
13146,1.0,0.0,0.3333333333333333,2237,52584,33555,-19029
13147,0.0,0.0,0.0,2237,52588,33555,-19033
13148,0.0,0.0,0.0,2237,52592,33555,-19037
13149,0.0,0.0,0.0,2237,52596,33555,-19041
13150,0.0,0.0,0.0,2237,52600,33555,-19045
13151,0.0,0.0,0.0,2237,52604,33555,-19049
13152,0.0,0.0,0.0,2237,52608,33555,-19053
13153,0.0,0.0,0.0,2237,52612,33555,-19057
13154,0.0,0.0,0.0,2237,52616,33555,-19061
13155,1.0,1.0,0.6666666666666666,2238,52620,33570,-19050
13156,0.0,0.0,0.0,2238,52624,33570,-19054
13157,0.0,0.0,0.0,2238,52628,33570,-19058
13158,1.0,1.0,1.0,2239,52632,33585,-19047
13159,1.0,1.0,0.6,2240,52636,33600,-19036
13160,0.0,0.0,0.0,2240,52640,33600,-19040
13161,0.0,0.0,0.0,2240,52644,33600,-19044
13162,0.0,0.0,0.2,2240,52648,33600,-19048
13163,0.0,0.0,0.0,2240,52652,33600,-19052
13164,0.0,0.0,0.0,2240,52656,33600,-19056
13165,0.0,0.0,0.0,2240,52660,33600,-19060
13166,0.0,0.0,0.0,2240,52664,33600,-19064
13167,0.0,0.0,0.0,2240,52668,33600,-19068
13168,0.0,0.0,0.0,2240,52672,33600,-19072
13169,0.0,0.0,0.0,2240,52676,33600,-19076
13170,0.0,0.0,0.0,2240,52680,33600,-19080
13171,0.0,0.0,0.0,2240,52684,33600,-19084
13172,0.0,0.0,0.0,2240,52688,33600,-19088
13173,0.0,0.0,0.0,2240,52692,33600,-19092
13174,0.0,0.0,0.0,2240,52696,33600,-19096
13175,0.0,0.0,0.0,2240,52700,33600,-19100
13176,0.0,0.0,0.0,2240,52704,33600,-19104
13177,1.0,0.0,0.3333333333333333,2241,52708,33615,-19093
13178,1.0,1.0,1.0,2242,52712,33630,-19082
13179,1.0,1.0,1.0,2243,52716,33645,-19071
13180,0.0,0.0,0.0,2243,52720,33645,-19075
13181,0.0,0.0,0.0,2243,52724,33645,-19079
13182,0.0,0.0,0.0,2243,52728,33645,-19083
13183,0.0,0.0,0.0,2243,52732,33645,-19087
13184,1.0,1.0,1.0,2244,52736,33660,-19076
13185,0.0,0.0,0.0,2244,52740,33660,-19080
13186,0.0,0.0,0.0,2244,52744,33660,-19084
13187,0.0,0.0,0.5,2244,52748,33660,-19088
13188,0.0,0.0,0.0,2244,52752,33660,-19092
13189,0.0,0.0,0.0,2244,52756,33660,-19096
13190,0.0,0.0,0.0,2244,52760,33660,-19100
13191,1.0,1.0,1.0,2245,52764,33675,-19089
13192,0.0,0.0,0.0,2245,52768,33675,-19093
13193,0.0,0.0,0.0,2245,52772,33675,-19097
13194,1.0,1.0,1.0,2246,52776,33690,-19086
13195,0.0,0.0,0.0,2246,52780,33690,-19090
13196,1.0,1.0,1.0,2247,52784,33705,-19079
13197,0.0,0.0,0.0,2247,52788,33705,-19083
13198,1.0,1.0,1.0,2248,52792,33720,-19072
13199,0.0,0.0,0.0,2248,52796,33720,-19076
13200,0.0,0.0,0.0,2248,52800,33720,-19080
13201,0.0,0.0,0.0,2248,52804,33720,-19084
13202,0.0,0.0,0.0,2248,52808,33720,-19088
13203,1.0,1.0,1.0,2249,52812,33735,-19077
13204,1.0,1.0,1.0,2250,52816,33750,-19066
13205,0.0,0.0,0.0,2250,52820,33750,-19070
13206,1.0,1.0,1.0,2251,52824,33765,-19059
13207,0.0,0.0,0.0,2251,52828,33765,-19063
13208,0.0,0.0,0.0,2251,52832,33765,-19067
13209,1.0,1.0,1.0,2252,52836,33780,-19056
13210,0.0,0.0,0.25,2252,52840,33780,-19060
13211,0.0,0.0,0.0,2252,52844,33780,-19064
13212,0.0,0.0,0.0,2252,52848,33780,-19068
13213,0.0,0.0,0.0,2252,52852,33780,-19072
13214,0.0,0.0,0.5,2252,52856,33780,-19076
13215,0.0,0.0,0.0,2252,52860,33780,-19080
13216,0.0,0.0,0.0,2252,52864,33780,-19084
13217,0.0,0.0,0.25,2252,52868,33780,-19088
13218,1.0,0.0,0.3333333333333333,2253,52872,33795,-19077
13219,0.0,0.0,0.0,2253,52876,33795,-19081
13220,1.0,1.0,1.0,2254,52880,33810,-19070
13221,0.0,0.0,0.2,2254,52884,33810,-19074
13222,0.0,0.0,0.0,2254,52888,33810,-19078
13223,0.0,0.0,0.0,2254,52892,33810,-19082
13224,1.0,1.0,0.6666666666666666,2255,52896,33825,-19071
13225,0.0,0.0,0.0,2255,52900,33825,-19075
13226,0.0,0.0,0.0,2255,52904,33825,-19079
13227,1.0,1.0,0.75,2256,52908,33840,-19068
13228,0.0,0.0,0.0,2256,52912,33840,-19072
13229,0.0,0.0,0.0,2256,52916,33840,-19076
13230,0.0,1.0,0.6666666666666666,2256,52920,33840,-19080
13231,0.0,0.0,0.3333333333333333,2256,52924,33840,-19084
13232,0.0,0.0,0.0,2256,52928,33840,-19088
13233,0.0,0.0,0.0,2256,52932,33840,-19092
13234,0.0,0.0,0.0,2256,52936,33840,-19096
13235,0.0,0.0,0.0,2256,52940,33840,-19100
13236,0.0,0.0,0.0,2256,52944,33840,-19104
13237,0.0,0.0,0.0,2256,52948,33840,-19108
13238,0.0,0.0,0.0,2256,52952,33840,-19112
13239,1.0,1.0,1.0,2257,52956,33855,-19101
13240,0.0,0.0,0.0,2257,52960,33855,-19105
13241,0.0,0.0,0.0,2257,52964,33855,-19109
13242,0.0,0.0,0.0,2257,52968,33855,-19113
13243,1.0,1.0,1.0,2258,52972,33870,-19102
13244,0.0,1.0,0.6666666666666666,2258,52976,33870,-19106
13245,0.0,0.0,0.3333333333333333,2258,52980,33870,-19110
13246,1.0,1.0,1.0,2259,52984,33885,-19099
13247,0.0,0.0,0.0,2259,52988,33885,-19103
13248,0.0,0.0,0.0,2259,52992,33885,-19107
13249,0.0,0.0,0.0,2259,52996,33885,-19111
13250,0.0,0.0,0.0,2259,53000,33885,-19115
13251,1.0,1.0,1.0,2260,53004,33900,-19104
13252,1.0,1.0,1.0,2261,53008,33915,-19093
13253,0.0,0.0,0.0,2261,53012,33915,-19097
13254,1.0,1.0,1.0,2262,53016,33930,-19086
13255,0.0,0.0,0.0,2262,53020,33930,-19090
13256,0.0,0.0,0.0,2262,53024,33930,-19094
13257,1.0,1.0,1.0,2263,53028,33945,-19083
13258,0.0,0.0,0.0,2263,53032,33945,-19087
13259,1.0,1.0,1.0,2264,53036,33960,-19076
13260,0.0,0.0,0.2,2264,53040,33960,-19080
13261,0.0,0.0,0.0,2264,53044,33960,-19084
13262,0.0,0.0,0.3333333333333333,2264,53048,33960,-19088
13263,1.0,1.0,1.0,2265,53052,33975,-19077
13264,0.0,0.0,0.0,2265,53056,33975,-19081
13265,0.0,0.0,0.0,2265,53060,33975,-19085
13266,0.0,0.0,0.0,2265,53064,33975,-19089
13267,0.0,0.0,0.0,2265,53068,33975,-19093
13268,0.0,0.0,0.3333333333333333,2265,53072,33975,-19097
13269,0.0,0.0,0.0,2265,53076,33975,-19101
13270,0.0,0.0,0.0,2265,53080,33975,-19105
13271,0.0,0.0,0.0,2265,53084,33975,-19109
13272,0.0,0.0,0.0,2265,53088,33975,-19113
13273,0.0,0.0,0.0,2265,53092,33975,-19117
13274,0.0,0.0,0.0,2265,53096,33975,-19121
13275,0.0,0.0,0.0,2265,53100,33975,-19125
13276,1.0,1.0,1.0,2266,53104,33990,-19114
13277,1.0,1.0,1.0,2267,53108,34005,-19103
13278,0.0,0.0,0.0,2267,53112,34005,-19107
13279,0.0,0.0,0.0,2267,53116,34005,-19111
13280,0.0,0.0,0.0,2267,53120,34005,-19115
13281,0.0,0.0,0.0,2267,53124,34005,-19119
13282,1.0,1.0,1.0,2268,53128,34020,-19108
13283,0.0,0.0,0.0,2268,53132,34020,-19112
13284,0.0,0.0,0.0,2268,53136,34020,-19116
13285,1.0,1.0,1.0,2269,53140,34035,-19105
13286,1.0,1.0,1.0,2270,53144,34050,-19094
13287,0.0,0.0,0.0,2270,53148,34050,-19098
13288,0.0,0.0,0.0,2270,53152,34050,-19102
13289,0.0,0.0,0.0,2270,53156,34050,-19106
13290,1.0,1.0,1.0,2271,53160,34065,-19095
13291,0.0,0.0,0.0,2271,53164,34065,-19099
13292,0.0,0.0,0.0,2271,53168,34065,-19103
13293,0.0,0.0,0.0,2271,53172,34065,-19107
13294,0.0,0.0,0.0,2271,53176,34065,-19111
13295,0.0,0.0,0.0,2271,53180,34065,-19115
13296,1.0,1.0,1.0,2272,53184,34080,-19104
13297,1.0,1.0,1.0,2273,53188,34095,-19093
13298,0.0,0.0,0.0,2273,53192,34095,-19097
13299,0.0,0.0,0.0,2273,53196,34095,-19101
13300,1.0,1.0,1.0,2274,53200,34110,-19090
13301,0.0,0.0,0.0,2274,53204,34110,-19094
13302,0.0,0.0,0.0,2274,53208,34110,-19098
13303,1.0,1.0,1.0,2275,53212,34125,-19087
13304,0.0,0.0,0.0,2275,53216,34125,-19091
13305,0.0,0.0,0.0,2275,53220,34125,-19095
13306,0.0,0.0,0.25,2275,53224,34125,-19099
13307,0.0,0.0,0.25,2275,53228,34125,-19103
13308,0.0,0.0,0.3333333333333333,2275,53232,34125,-19107
13309,1.0,1.0,1.0,2276,53236,34140,-19096
13310,1.0,1.0,1.0,2277,53240,34155,-19085
13311,0.0,0.0,0.0,2277,53244,34155,-19089
13312,0.0,0.0,0.0,2277,53248,34155,-19093
13313,0.0,0.0,0.0,2277,53252,34155,-19097
13314,0.0,0.0,0.0,2277,53256,34155,-19101
13315,1.0,1.0,1.0,2278,53260,34170,-19090
13316,0.0,0.0,0.0,2278,53264,34170,-19094
13317,0.0,0.0,0.0,2278,53268,34170,-19098
13318,0.0,0.0,0.0,2278,53272,34170,-19102
13319,1.0,1.0,1.0,2279,53276,34185,-19091
13320,0.0,0.0,0.0,2279,53280,34185,-19095
13321,0.0,0.0,0.0,2279,53284,34185,-19099
13322,1.0,1.0,1.0,2280,53288,34200,-19088
13323,0.0,0.0,0.0,2280,53292,34200,-19092
13324,1.0,1.0,1.0,2281,53296,34215,-19081
13325,1.0,1.0,1.0,2282,53300,34230,-19070
13326,1.0,1.0,1.0,2283,53304,34245,-19059
13327,1.0,1.0,1.0,2284,53308,34260,-19048
13328,0.0,0.0,0.0,2284,53312,34260,-19052
13329,0.0,0.0,0.0,2284,53316,34260,-19056
13330,0.0,0.0,0.0,2284,53320,34260,-19060
13331,1.0,1.0,1.0,2285,53324,34275,-19049
13332,0.0,0.0,0.0,2285,53328,34275,-19053
13333,0.0,0.0,0.0,2285,53332,34275,-19057
13334,0.0,0.0,0.0,2285,53336,34275,-19061
13335,0.0,0.0,0.0,2285,53340,34275,-19065
13336,0.0,0.0,0.0,2285,53344,34275,-19069
13337,0.0,0.0,0.0,2285,53348,34275,-19073
13338,1.0,1.0,1.0,2286,53352,34290,-19062
13339,0.0,0.0,0.0,2286,53356,34290,-19066
13340,0.0,0.0,0.0,2286,53360,34290,-19070
13341,0.0,0.0,0.0,2286,53364,34290,-19074
13342,0.0,0.0,0.0,2286,53368,34290,-19078
13343,0.0,0.0,0.0,2286,53372,34290,-19082
13344,0.0,0.0,0.0,2286,53376,34290,-19086
13345,0.0,0.0,0.5,2286,53380,34290,-19090
13346,0.0,0.0,0.0,2286,53384,34290,-19094
13347,0.0,0.0,0.0,2286,53388,34290,-19098
13348,1.0,1.0,0.6666666666666666,2287,53392,34305,-19087
13349,0.0,0.0,0.0,2287,53396,34305,-19091
13350,0.0,0.0,0.0,2287,53400,34305,-19095
13351,0.0,0.0,0.0,2287,53404,34305,-19099
13352,0.0,0.0,0.0,2287,53408,34305,-19103
13353,1.0,1.0,1.0,2288,53412,34320,-19092
13354,0.0,0.0,0.0,2288,53416,34320,-19096
13355,0.0,0.0,0.0,2288,53420,34320,-19100
13356,0.0,0.0,0.0,2288,53424,34320,-19104
13357,0.0,0.0,0.0,2288,53428,34320,-19108
13358,1.0,1.0,0.6666666666666666,2289,53432,34335,-19097
13359,0.0,0.0,0.0,2289,53436,34335,-19101
13360,0.0,0.0,0.0,2289,53440,34335,-19105
13361,0.0,0.0,0.0,2289,53444,34335,-19109
13362,0.0,0.0,0.5,2289,53448,34335,-19113
13363,1.0,1.0,1.0,2290,53452,34350,-19102
13364,1.0,1.0,1.0,2291,53456,34365,-19091
13365,0.0,0.0,0.0,2291,53460,34365,-19095
13366,0.0,0.0,0.0,2291,53464,34365,-19099
13367,0.0,0.0,0.0,2291,53468,34365,-19103
13368,1.0,1.0,0.6666666666666666,2292,53472,34380,-19092
13369,0.0,0.0,0.0,2292,53476,34380,-19096
13370,0.0,0.0,0.0,2292,53480,34380,-19100
13371,1.0,1.0,1.0,2293,53484,34395,-19089
13372,0.0,0.0,0.0,2293,53488,34395,-19093
13373,0.0,0.0,0.0,2293,53492,34395,-19097
13374,0.0,0.0,0.0,2293,53496,34395,-19101
13375,0.0,0.0,0.0,2293,53500,34395,-19105
13376,0.0,0.0,0.0,2293,53504,34395,-19109
13377,0.0,0.0,0.0,2293,53508,34395,-19113
13378,0.0,0.0,0.0,2293,53512,34395,-19117
13379,1.0,1.0,1.0,2294,53516,34410,-19106
13380,0.0,0.0,0.0,2294,53520,34410,-19110
13381,1.0,1.0,1.0,2295,53524,34425,-19099
13382,0.0,0.0,0.0,2295,53528,34425,-19103
13383,0.0,0.0,0.0,2295,53532,34425,-19107
13384,0.0,0.0,0.0,2295,53536,34425,-19111
13385,0.0,0.0,0.0,2295,53540,34425,-19115
13386,0.0,0.0,0.0,2295,53544,34425,-19119
13387,0.0,0.0,0.0,2295,53548,34425,-19123
13388,0.0,0.0,0.0,2295,53552,34425,-19127
13389,0.0,0.0,0.0,2295,53556,34425,-19131
13390,0.0,0.0,0.0,2295,53560,34425,-19135
13391,0.0,0.0,0.0,2295,53564,34425,-19139
13392,0.0,0.0,0.0,2295,53568,34425,-19143
13393,0.0,0.0,0.0,2295,53572,34425,-19147
13394,0.0,0.0,0.0,2295,53576,34425,-19151
13395,0.0,0.0,0.0,2295,53580,34425,-19155
13396,0.0,0.0,0.0,2295,53584,34425,-19159
13397,0.0,0.0,0.0,2295,53588,34425,-19163
13398,0.0,0.0,0.0,2295,53592,34425,-19167
13399,0.0,0.0,0.0,2295,53596,34425,-19171
13400,1.0,0.0,0.3333333333333333,2296,53600,34440,-19160
13401,0.0,0.0,0.0,2296,53604,34440,-19164
13402,1.0,1.0,1.0,2297,53608,34455,-19153
13403,0.0,0.0,0.3333333333333333,2297,53612,34455,-19157
13404,0.0,0.0,0.0,2297,53616,34455,-19161
13405,1.0,1.0,1.0,2298,53620,34470,-19150
13406,0.0,0.0,0.0,2298,53624,34470,-19154
13407,1.0,1.0,1.0,2299,53628,34485,-19143
13408,0.0,0.0,0.0,2299,53632,34485,-19147
13409,0.0,0.0,0.0,2299,53636,34485,-19151
13410,0.0,0.0,0.0,2299,53640,34485,-19155
13411,0.0,0.0,0.0,2299,53644,34485,-19159
13412,0.0,0.0,0.0,2299,53648,34485,-19163
13413,0.0,0.0,0.0,2299,53652,34485,-19167
13414,0.0,0.0,0.0,2299,53656,34485,-19171
13415,0.0,0.0,0.0,2299,53660,34485,-19175
13416,0.0,0.0,0.0,2299,53664,34485,-19179
13417,0.0,0.0,0.0,2299,53668,34485,-19183
13418,0.0,0.0,0.0,2299,53672,34485,-19187
13419,0.0,0.0,0.0,2299,53676,34485,-19191
13420,0.0,0.0,0.0,2299,53680,34485,-19195
13421,0.0,0.0,0.0,2299,53684,34485,-19199
13422,1.0,1.0,1.0,2300,53688,34500,-19188
13423,0.0,0.0,0.0,2300,53692,34500,-19192
13424,0.0,0.0,0.0,2300,53696,34500,-19196
13425,0.0,0.0,0.0,2300,53700,34500,-19200
13426,1.0,1.0,1.0,2301,53704,34515,-19189
13427,0.0,0.0,0.0,2301,53708,34515,-19193
13428,0.0,0.0,0.0,2301,53712,34515,-19197
13429,1.0,0.0,0.4,2302,53716,34530,-19186
13430,0.0,0.0,0.0,2302,53720,34530,-19190
13431,0.0,0.0,0.0,2302,53724,34530,-19194
13432,0.0,0.0,0.0,2302,53728,34530,-19198
13433,0.0,0.0,0.0,2302,53732,34530,-19202
13434,0.0,0.0,0.0,2302,53736,34530,-19206
13435,0.0,0.0,0.0,2302,53740,34530,-19210
13436,0.0,0.0,0.3333333333333333,2302,53744,34530,-19214
13437,0.0,0.0,0.0,2302,53748,34530,-19218
13438,0.0,0.0,0.0,2302,53752,34530,-19222
13439,0.0,0.0,0.0,2302,53756,34530,-19226
13440,0.0,0.0,0.0,2302,53760,34530,-19230
13441,0.0,0.0,0.0,2302,53764,34530,-19234
13442,0.0,0.0,0.25,2302,53768,34530,-19238
13443,0.0,0.0,0.0,2302,53772,34530,-19242
13444,0.0,0.0,0.0,2302,53776,34530,-19246
13445,0.0,0.0,0.0,2302,53780,34530,-19250
13446,0.0,0.0,0.0,2302,53784,34530,-19254
13447,0.0,0.0,0.0,2302,53788,34530,-19258
13448,0.0,0.0,0.0,2302,53792,34530,-19262
13449,0.0,0.0,0.0,2302,53796,34530,-19266
13450,0.0,0.0,0.0,2302,53800,34530,-19270
13451,0.0,0.0,0.0,2302,53804,34530,-19274
13452,0.0,0.0,0.0,2302,53808,34530,-19278
13453,0.0,0.0,0.0,2302,53812,34530,-19282
13454,0.0,0.0,0.0,2302,53816,34530,-19286
13455,0.0,0.0,0.0,2302,53820,34530,-19290
13456,0.0,0.0,0.0,2302,53824,34530,-19294
13457,0.0,0.0,0.0,2302,53828,34530,-19298
13458,0.0,0.0,0.0,2302,53832,34530,-19302
13459,0.0,0.0,0.0,2302,53836,34530,-19306
13460,0.0,0.0,0.0,2302,53840,34530,-19310
13461,0.0,0.0,0.0,2302,53844,34530,-19314
13462,0.0,0.0,0.0,2302,53848,34530,-19318
13463,0.0,0.0,0.0,2302,53852,34530,-19322
13464,0.0,1.0,0.6,2302,53856,34530,-19326
13465,0.0,0.0,0.0,2302,53860,34530,-19330
13466,0.0,0.0,0.0,2302,53864,34530,-19334
13467,0.0,0.0,0.0,2302,53868,34530,-19338
13468,1.0,1.0,0.8,2303,53872,34545,-19327
13469,0.0,0.0,0.25,2303,53876,34545,-19331
13470,0.0,0.0,0.0,2303,53880,34545,-19335
13471,0.0,0.0,0.0,2303,53884,34545,-19339
13472,0.0,0.0,0.5,2303,53888,34545,-19343
13473,0.0,0.0,0.0,2303,53892,34545,-19347
13474,0.0,0.0,0.0,2303,53896,34545,-19351
13475,0.0,0.0,0.0,2303,53900,34545,-19355
13476,0.0,0.0,0.0,2303,53904,34545,-19359
13477,0.0,0.0,0.0,2303,53908,34545,-19363
13478,0.0,0.0,0.0,2303,53912,34545,-19367
13479,1.0,1.0,1.0,2304,53916,34560,-19356
13480,0.0,0.0,0.0,2304,53920,34560,-19360
13481,0.0,0.0,0.0,2304,53924,34560,-19364
13482,0.0,0.0,0.0,2304,53928,34560,-19368
13483,0.0,0.0,0.0,2304,53932,34560,-19372
13484,0.0,0.0,0.0,2304,53936,34560,-19376
13485,0.0,0.0,0.0,2304,53940,34560,-19380
13486,0.0,0.0,0.0,2304,53944,34560,-19384
13487,0.0,0.0,0.0,2304,53948,34560,-19388
13488,0.0,0.0,0.0,2304,53952,34560,-19392
13489,0.0,0.0,0.0,2304,53956,34560,-19396
13490,1.0,1.0,1.0,2305,53960,34575,-19385
13491,0.0,0.0,0.0,2305,53964,34575,-19389
13492,0.0,0.0,0.0,2305,53968,34575,-19393
13493,1.0,1.0,1.0,2306,53972,34590,-19382
13494,0.0,0.0,0.0,2306,53976,34590,-19386
13495,0.0,0.0,0.0,2306,53980,34590,-19390
13496,0.0,0.0,0.0,2306,53984,34590,-19394
13497,0.0,0.0,0.0,2306,53988,34590,-19398
13498,0.0,0.0,0.0,2306,53992,34590,-19402
13499,1.0,1.0,1.0,2307,53996,34605,-19391
13500,1.0,1.0,0.75,2308,54000,34620,-19380
13501,0.0,0.0,0.0,2308,54004,34620,-19384
13502,0.0,0.0,0.0,2308,54008,34620,-19388
13503,0.0,0.0,0.0,2308,54012,34620,-19392
13504,0.0,0.0,0.0,2308,54016,34620,-19396
13505,0.0,0.0,0.0,2308,54020,34620,-19400
13506,0.0,0.0,0.0,2308,54024,34620,-19404
13507,0.0,0.0,0.0,2308,54028,34620,-19408
13508,0.0,0.0,0.0,2308,54032,34620,-19412
13509,0.0,0.0,0.0,2308,54036,34620,-19416
13510,0.0,0.0,0.0,2308,54040,34620,-19420
13511,0.0,0.0,0.0,2308,54044,34620,-19424
13512,0.0,0.0,0.0,2308,54048,34620,-19428
13513,1.0,1.0,1.0,2309,54052,34635,-19417
13514,0.0,0.0,0.0,2309,54056,34635,-19421
13515,0.0,0.0,0.0,2309,54060,34635,-19425
13516,0.0,0.0,0.0,2309,54064,34635,-19429
13517,0.0,0.0,0.0,2309,54068,34635,-19433
13518,1.0,1.0,1.0,2310,54072,34650,-19422
13519,0.0,0.0,0.0,2310,54076,34650,-19426
13520,0.0,0.0,0.0,2310,54080,34650,-19430
13521,0.0,0.0,0.0,2310,54084,34650,-19434
13522,0.0,0.0,0.0,2310,54088,34650,-19438
13523,0.0,0.0,0.0,2310,54092,34650,-19442
13524,1.0,1.0,1.0,2311,54096,34665,-19431
13525,1.0,1.0,1.0,2312,54100,34680,-19420
13526,0.0,0.0,0.0,2312,54104,34680,-19424
13527,0.0,0.0,0.0,2312,54108,34680,-19428
13528,0.0,0.0,0.0,2312,54112,34680,-19432
13529,0.0,0.0,0.0,2312,54116,34680,-19436
13530,1.0,1.0,1.0,2313,54120,34695,-19425
13531,0.0,0.0,0.0,2313,54124,34695,-19429
13532,0.0,0.0,0.0,2313,54128,34695,-19433
13533,0.0,0.0,0.0,2313,54132,34695,-19437
13534,1.0,1.0,1.0,2314,54136,34710,-19426
13535,1.0,1.0,1.0,2315,54140,34725,-19415
13536,0.0,0.0,0.0,2315,54144,34725,-19419
13537,0.0,0.0,0.0,2315,54148,34725,-19423
13538,0.0,0.0,0.0,2315,54152,34725,-19427
13539,0.0,0.0,0.0,2315,54156,34725,-19431
13540,0.0,0.0,0.0,2315,54160,34725,-19435
13541,0.0,0.0,0.0,2315,54164,34725,-19439
13542,0.0,0.0,0.0,2315,54168,34725,-19443
13543,0.0,0.0,0.0,2315,54172,34725,-19447
13544,0.0,0.0,0.0,2315,54176,34725,-19451
13545,1.0,1.0,1.0,2316,54180,34740,-19440
13546,0.0,0.0,0.0,2316,54184,34740,-19444
13547,0.0,0.0,0.25,2316,54188,34740,-19448
13548,1.0,1.0,1.0,2317,54192,34755,-19437
13549,0.0,1.0,0.6666666666666666,2317,54196,34755,-19441
13550,0.0,0.0,0.0,2317,54200,34755,-19445
13551,0.0,0.0,0.0,2317,54204,34755,-19449
13552,0.0,0.0,0.0,2317,54208,34755,-19453
13553,0.0,0.0,0.0,2317,54212,34755,-19457
13554,1.0,1.0,1.0,2318,54216,34770,-19446
13555,0.0,0.0,0.0,2318,54220,34770,-19450
13556,0.0,0.0,0.0,2318,54224,34770,-19454
13557,0.0,0.0,0.0,2318,54228,34770,-19458
13558,0.0,0.0,0.0,2318,54232,34770,-19462
13559,0.0,0.0,0.0,2318,54236,34770,-19466
13560,0.0,0.0,0.0,2318,54240,34770,-19470
13561,0.0,0.0,0.0,2318,54244,34770,-19474
13562,0.0,1.0,0.6666666666666666,2318,54248,34770,-19478
13563,0.0,0.0,0.0,2318,54252,34770,-19482
13564,0.0,0.0,0.0,2318,54256,34770,-19486
13565,0.0,0.0,0.0,2318,54260,34770,-19490
13566,0.0,0.0,0.0,2318,54264,34770,-19494
13567,1.0,1.0,0.75,2319,54268,34785,-19483
13568,0.0,0.0,0.0,2319,54272,34785,-19487
13569,0.0,0.0,0.0,2319,54276,34785,-19491
13570,0.0,0.0,0.0,2319,54280,34785,-19495
13571,0.0,0.0,0.0,2319,54284,34785,-19499
13572,0.0,0.0,0.0,2319,54288,34785,-19503
13573,0.0,0.0,0.2,2319,54292,34785,-19507
13574,0.0,0.0,0.0,2319,54296,34785,-19511
13575,0.0,0.0,0.0,2319,54300,34785,-19515
13576,0.0,0.0,0.0,2319,54304,34785,-19519
13577,0.0,0.0,0.0,2319,54308,34785,-19523
13578,0.0,0.0,0.0,2319,54312,34785,-19527
13579,0.0,0.0,0.0,2319,54316,34785,-19531
13580,0.0,0.0,0.0,2319,54320,34785,-19535
13581,0.0,0.0,0.0,2319,54324,34785,-19539
13582,0.0,0.0,0.0,2319,54328,34785,-19543
13583,0.0,0.0,0.0,2319,54332,34785,-19547
13584,1.0,1.0,0.75,2320,54336,34800,-19536
13585,0.0,0.0,0.0,2320,54340,34800,-19540
13586,0.0,0.0,0.0,2320,54344,34800,-19544
13587,0.0,0.0,0.0,2320,54348,34800,-19548
13588,0.0,0.0,0.0,2320,54352,34800,-19552
13589,0.0,0.0,0.0,2320,54356,34800,-19556
13590,0.0,0.0,0.0,2320,54360,34800,-19560
13591,1.0,1.0,1.0,2321,54364,34815,-19549
13592,0.0,0.0,0.0,2321,54368,34815,-19553
13593,0.0,0.0,0.0,2321,54372,34815,-19557
13594,0.0,0.0,0.0,2321,54376,34815,-19561
13595,1.0,1.0,1.0,2322,54380,34830,-19550
13596,0.0,0.0,0.0,2322,54384,34830,-19554
13597,0.0,0.0,0.0,2322,54388,34830,-19558
13598,0.0,0.0,0.0,2322,54392,34830,-19562
13599,0.0,0.0,0.0,2322,54396,34830,-19566
13600,0.0,0.0,0.0,2322,54400,34830,-19570
13601,0.0,0.0,0.0,2322,54404,34830,-19574
13602,1.0,1.0,1.0,2323,54408,34845,-19563
13603,0.0,0.0,0.0,2323,54412,34845,-19567
13604,0.0,0.0,0.0,2323,54416,34845,-19571
13605,0.0,0.0,0.0,2323,54420,34845,-19575
13606,0.0,1.0,0.6666666666666666,2323,54424,34845,-19579
13607,0.0,0.0,0.0,2323,54428,34845,-19583
13608,0.0,0.0,0.0,2323,54432,34845,-19587
13609,0.0,0.0,0.0,2323,54436,34845,-19591
13610,0.0,0.0,0.0,2323,54440,34845,-19595
13611,0.0,0.0,0.0,2323,54444,34845,-19599
13612,1.0,1.0,1.0,2324,54448,34860,-19588
13613,0.0,1.0,0.8,2324,54452,34860,-19592
13614,0.0,0.0,0.0,2324,54456,34860,-19596
13615,0.0,0.0,0.3333333333333333,2324,54460,34860,-19600
13616,0.0,0.0,0.0,2324,54464,34860,-19604
13617,1.0,1.0,1.0,2325,54468,34875,-19593
13618,0.0,0.0,0.25,2325,54472,34875,-19597
13619,1.0,0.0,0.3333333333333333,2326,54476,34890,-19586
13620,0.0,0.0,0.0,2326,54480,34890,-19590
13621,0.0,0.0,0.0,2326,54484,34890,-19594
13622,0.0,0.0,0.0,2326,54488,34890,-19598
13623,1.0,1.0,1.0,2327,54492,34905,-19587
13624,0.0,0.0,0.0,2327,54496,34905,-19591
13625,0.0,0.0,0.0,2327,54500,34905,-19595
13626,0.0,0.0,0.4,2327,54504,34905,-19599
13627,1.0,1.0,1.0,2328,54508,34920,-19588
13628,0.0,0.0,0.0,2328,54512,34920,-19592
13629,0.0,0.0,0.0,2328,54516,34920,-19596
13630,0.0,0.0,0.0,2328,54520,34920,-19600
13631,0.0,0.0,0.0,2328,54524,34920,-19604
13632,1.0,1.0,1.0,2329,54528,34935,-19593
13633,0.0,0.0,0.0,2329,54532,34935,-19597
13634,1.0,1.0,1.0,2330,54536,34950,-19586
13635,0.0,0.0,0.25,2330,54540,34950,-19590
13636,1.0,0.0,0.3333333333333333,2331,54544,34965,-19579
13637,0.0,0.0,0.0,2331,54548,34965,-19583
13638,1.0,1.0,1.0,2332,54552,34980,-19572
13639,1.0,0.0,0.3333333333333333,2333,54556,34995,-19561
13640,0.0,0.0,0.0,2333,54560,34995,-19565
13641,0.0,0.0,0.0,2333,54564,34995,-19569
13642,0.0,0.0,0.0,2333,54568,34995,-19573
13643,0.0,0.0,0.0,2333,54572,34995,-19577
13644,0.0,0.0,0.0,2333,54576,34995,-19581
13645,1.0,1.0,1.0,2334,54580,35010,-19570
13646,1.0,1.0,1.0,2335,54584,35025,-19559
13647,0.0,0.0,0.0,2335,54588,35025,-19563
13648,0.0,0.0,0.0,2335,54592,35025,-19567
13649,0.0,0.0,0.0,2335,54596,35025,-19571
13650,1.0,0.0,0.5,2336,54600,35040,-19560
13651,0.0,0.0,0.0,2336,54604,35040,-19564
13652,0.0,0.0,0.0,2336,54608,35040,-19568
13653,0.0,0.0,0.0,2336,54612,35040,-19572
13654,0.0,0.0,0.0,2336,54616,35040,-19576
13655,0.0,0.0,0.0,2336,54620,35040,-19580
13656,0.0,0.0,0.0,2336,54624,35040,-19584
13657,0.0,0.0,0.0,2336,54628,35040,-19588
13658,0.0,0.0,0.0,2336,54632,35040,-19592
13659,0.0,0.0,0.0,2336,54636,35040,-19596
13660,0.0,0.0,0.0,2336,54640,35040,-19600
13661,1.0,1.0,1.0,2337,54644,35055,-19589
13662,0.0,0.0,0.0,2337,54648,35055,-19593
13663,1.0,1.0,1.0,2338,54652,35070,-19582
13664,0.0,0.0,0.0,2338,54656,35070,-19586
13665,0.0,0.0,0.0,2338,54660,35070,-19590
13666,0.0,0.0,0.0,2338,54664,35070,-19594
13667,0.0,0.0,0.0,2338,54668,35070,-19598
13668,0.0,0.0,0.0,2338,54672,35070,-19602
13669,0.0,0.0,0.0,2338,54676,35070,-19606
13670,1.0,1.0,1.0,2339,54680,35085,-19595
13671,0.0,0.0,0.0,2339,54684,35085,-19599
13672,1.0,1.0,1.0,2340,54688,35100,-19588
13673,1.0,0.0,0.5,2341,54692,35115,-19577
13674,0.0,0.0,0.0,2341,54696,35115,-19581
13675,0.0,0.0,0.0,2341,54700,35115,-19585
13676,0.0,0.0,0.0,2341,54704,35115,-19589
13677,0.0,0.0,0.0,2341,54708,35115,-19593
13678,1.0,1.0,1.0,2342,54712,35130,-19582
13679,0.0,0.0,0.0,2342,54716,35130,-19586
13680,0.0,0.0,0.0,2342,54720,35130,-19590
13681,1.0,1.0,0.6666666666666666,2343,54724,35145,-19579
13682,0.0,0.0,0.0,2343,54728,35145,-19583
13683,0.0,0.0,0.0,2343,54732,35145,-19587
13684,0.0,0.0,0.0,2343,54736,35145,-19591
13685,0.0,0.0,0.0,2343,54740,35145,-19595
13686,1.0,1.0,1.0,2344,54744,35160,-19584
13687,0.0,0.0,0.0,2344,54748,35160,-19588
13688,0.0,0.0,0.0,2344,54752,35160,-19592
13689,0.0,0.0,0.0,2344,54756,35160,-19596
13690,0.0,0.0,0.0,2344,54760,35160,-19600
13691,1.0,1.0,1.0,2345,54764,35175,-19589
13692,0.0,0.0,0.0,2345,54768,35175,-19593
13693,0.0,0.0,0.0,2345,54772,35175,-19597
13694,1.0,1.0,1.0,2346,54776,35190,-19586
13695,0.0,0.0,0.0,2346,54780,35190,-19590
13696,0.0,0.0,0.0,2346,54784,35190,-19594
13697,0.0,0.0,0.0,2346,54788,35190,-19598
13698,0.0,0.0,0.0,2346,54792,35190,-19602
13699,0.0,0.0,0.0,2346,54796,35190,-19606
13700,0.0,0.0,0.0,2346,54800,35190,-19610
13701,0.0,0.0,0.0,2346,54804,35190,-19614
13702,0.0,0.0,0.0,2346,54808,35190,-19618
13703,0.0,0.0,0.0,2346,54812,35190,-19622
13704,0.0,0.0,0.0,2346,54816,35190,-19626
13705,0.0,0.0,0.0,2346,54820,35190,-19630
13706,1.0,1.0,1.0,2347,54824,35205,-19619
13707,0.0,0.0,0.0,2347,54828,35205,-19623
13708,0.0,0.0,0.0,2347,54832,35205,-19627
13709,0.0,0.0,0.0,2347,54836,35205,-19631
13710,0.0,0.0,0.0,2347,54840,35205,-19635
13711,0.0,0.0,0.0,2347,54844,35205,-19639
13712,0.0,0.0,0.0,2347,54848,35205,-19643
13713,1.0,1.0,1.0,2348,54852,35220,-19632
13714,1.0,1.0,1.0,2349,54856,35235,-19621
13715,0.0,0.0,0.0,2349,54860,35235,-19625
13716,0.0,0.0,0.0,2349,54864,35235,-19629
13717,0.0,0.0,0.0,2349,54868,35235,-19633
13718,1.0,1.0,1.0,2350,54872,35250,-19622
13719,0.0,0.0,0.0,2350,54876,35250,-19626
13720,0.0,0.0,0.0,2350,54880,35250,-19630
13721,0.0,0.0,0.0,2350,54884,35250,-19634
13722,0.0,0.0,0.0,2350,54888,35250,-19638
13723,0.0,0.0,0.0,2350,54892,35250,-19642
13724,0.0,0.0,0.0,2350,54896,35250,-19646
13725,0.0,0.0,0.0,2350,54900,35250,-19650
13726,0.0,0.0,0.0,2350,54904,35250,-19654
13727,0.0,0.0,0.3333333333333333,2350,54908,35250,-19658
13728,0.0,0.0,0.0,2350,54912,35250,-19662
13729,0.0,0.0,0.0,2350,54916,35250,-19666
13730,0.0,0.0,0.0,2350,54920,35250,-19670
13731,0.0,0.0,0.0,2350,54924,35250,-19674
13732,0.0,0.0,0.0,2350,54928,35250,-19678
13733,0.0,0.0,0.0,2350,54932,35250,-19682
13734,1.0,1.0,1.0,2351,54936,35265,-19671
13735,0.0,0.0,0.0,2351,54940,35265,-19675
13736,0.0,0.0,0.0,2351,54944,35265,-19679
13737,1.0,1.0,1.0,2352,54948,35280,-19668
13738,1.0,1.0,1.0,2353,54952,35295,-19657
13739,0.0,0.0,0.0,2353,54956,35295,-19661
13740,0.0,0.0,0.0,2353,54960,35295,-19665
13741,1.0,1.0,1.0,2354,54964,35310,-19654
13742,0.0,0.0,0.0,2354,54968,35310,-19658
13743,0.0,0.0,0.0,2354,54972,35310,-19662
13744,1.0,1.0,1.0,2355,54976,35325,-19651
13745,1.0,1.0,1.0,2356,54980,35340,-19640
13746,0.0,0.0,0.0,2356,54984,35340,-19644
13747,0.0,0.0,0.0,2356,54988,35340,-19648
13748,0.0,0.0,0.0,2356,54992,35340,-19652
13749,0.0,0.0,0.0,2356,54996,35340,-19656
13750,0.0,0.0,0.0,2356,55000,35340,-19660
13751,1.0,1.0,0.6666666666666666,2357,55004,35355,-19649
13752,0.0,0.0,0.0,2357,55008,35355,-19653
13753,0.0,0.0,0.0,2357,55012,35355,-19657
13754,0.0,0.0,0.0,2357,55016,35355,-19661
13755,0.0,0.0,0.0,2357,55020,35355,-19665
13756,0.0,0.0,0.0,2357,55024,35355,-19669
13757,0.0,0.0,0.0,2357,55028,35355,-19673
13758,0.0,0.0,0.0,2357,55032,35355,-19677
13759,0.0,0.0,0.0,2357,55036,35355,-19681
13760,0.0,0.0,0.0,2357,55040,35355,-19685
13761,1.0,1.0,1.0,2358,55044,35370,-19674
13762,0.0,0.0,0.0,2358,55048,35370,-19678
13763,0.0,0.0,0.0,2358,55052,35370,-19682
13764,0.0,0.0,0.0,2358,55056,35370,-19686
13765,0.0,0.0,0.0,2358,55060,35370,-19690
13766,0.0,0.0,0.0,2358,55064,35370,-19694
13767,0.0,0.0,0.0,2358,55068,35370,-19698
13768,0.0,0.0,0.0,2358,55072,35370,-19702
13769,1.0,1.0,1.0,2359,55076,35385,-19691
13770,0.0,0.0,0.0,2359,55080,35385,-19695
13771,0.0,0.0,0.0,2359,55084,35385,-19699
13772,0.0,0.0,0.0,2359,55088,35385,-19703
13773,0.0,0.0,0.0,2359,55092,35385,-19707
13774,0.0,0.0,0.3333333333333333,2359,55096,35385,-19711
13775,0.0,0.0,0.0,2359,55100,35385,-19715
13776,0.0,0.0,0.0,2359,55104,35385,-19719
13777,0.0,0.0,0.0,2359,55108,35385,-19723
13778,0.0,0.0,0.0,2359,55112,35385,-19727
13779,0.0,0.0,0.0,2359,55116,35385,-19731
13780,0.0,0.0,0.0,2359,55120,35385,-19735
13781,0.0,0.0,0.0,2359,55124,35385,-19739
13782,0.0,0.0,0.0,2359,55128,35385,-19743
13783,0.0,0.0,0.0,2359,55132,35385,-19747
13784,0.0,0.0,0.0,2359,55136,35385,-19751
13785,0.0,0.0,0.0,2359,55140,35385,-19755
13786,0.0,0.0,0.5,2359,55144,35385,-19759
13787,0.0,0.0,0.0,2359,55148,35385,-19763
13788,0.0,0.0,0.0,2359,55152,35385,-19767
13789,0.0,0.0,0.0,2359,55156,35385,-19771
13790,0.0,0.0,0.0,2359,55160,35385,-19775
13791,0.0,0.0,0.0,2359,55164,35385,-19779
13792,0.0,0.0,0.0,2359,55168,35385,-19783
13793,0.0,0.0,0.0,2359,55172,35385,-19787
13794,0.0,0.0,0.0,2359,55176,35385,-19791
13795,1.0,1.0,1.0,2360,55180,35400,-19780
13796,0.0,0.0,0.0,2360,55184,35400,-19784
13797,0.0,0.0,0.0,2360,55188,35400,-19788
13798,0.0,0.0,0.0,2360,55192,35400,-19792
13799,0.0,0.0,0.0,2360,55196,35400,-19796
13800,1.0,1.0,1.0,2361,55200,35415,-19785
13801,0.0,0.0,0.0,2361,55204,35415,-19789
13802,0.0,0.0,0.0,2361,55208,35415,-19793
13803,0.0,0.0,0.0,2361,55212,35415,-19797
13804,0.0,0.0,0.0,2361,55216,35415,-19801
13805,0.0,0.0,0.0,2361,55220,35415,-19805
13806,1.0,1.0,1.0,2362,55224,35430,-19794
13807,0.0,0.0,0.0,2362,55228,35430,-19798
13808,1.0,1.0,1.0,2363,55232,35445,-19787
13809,0.0,0.0,0.0,2363,55236,35445,-19791
13810,1.0,1.0,1.0,2364,55240,35460,-19780
13811,0.0,0.0,0.0,2364,55244,35460,-19784
13812,0.0,0.0,0.0,2364,55248,35460,-19788
13813,0.0,0.0,0.0,2364,55252,35460,-19792
13814,0.0,0.0,0.0,2364,55256,35460,-19796
13815,1.0,1.0,0.8,2365,55260,35475,-19785
13816,0.0,0.0,0.0,2365,55264,35475,-19789
13817,0.0,0.0,0.0,2365,55268,35475,-19793
13818,1.0,0.0,0.2,2366,55272,35490,-19782
13819,0.0,0.0,0.0,2366,55276,35490,-19786
13820,0.0,0.0,0.0,2366,55280,35490,-19790
13821,0.0,0.0,0.0,2366,55284,35490,-19794
13822,0.0,0.0,0.0,2366,55288,35490,-19798
13823,0.0,0.0,0.0,2366,55292,35490,-19802
13824,1.0,1.0,0.8,2367,55296,35505,-19791
13825,0.0,0.0,0.0,2367,55300,35505,-19795
13826,0.0,0.0,0.0,2367,55304,35505,-19799
13827,0.0,0.0,0.0,2367,55308,35505,-19803
13828,0.0,0.0,0.0,2367,55312,35505,-19807
13829,0.0,0.0,0.0,2367,55316,35505,-19811
13830,0.0,0.0,0.0,2367,55320,35505,-19815
13831,0.0,0.0,0.0,2367,55324,35505,-19819
13832,0.0,0.0,0.0,2367,55328,35505,-19823
13833,0.0,0.0,0.0,2367,55332,35505,-19827
13834,0.0,0.0,0.0,2367,55336,35505,-19831
13835,0.0,0.0,0.0,2367,55340,35505,-19835
13836,0.0,0.0,0.0,2367,55344,35505,-19839
13837,0.0,0.0,0.0,2367,55348,35505,-19843
13838,0.0,0.0,0.0,2367,55352,35505,-19847
13839,0.0,0.0,0.0,2367,55356,35505,-19851
13840,0.0,0.0,0.0,2367,55360,35505,-19855
13841,0.0,0.0,0.0,2367,55364,35505,-19859
13842,0.0,0.0,0.0,2367,55368,35505,-19863
13843,0.0,0.0,0.0,2367,55372,35505,-19867
13844,1.0,1.0,1.0,2368,55376,35520,-19856
13845,1.0,1.0,1.0,2369,55380,35535,-19845
13846,0.0,0.0,0.0,2369,55384,35535,-19849
13847,1.0,1.0,1.0,2370,55388,35550,-19838
13848,1.0,1.0,1.0,2371,55392,35565,-19827
13849,0.0,0.0,0.0,2371,55396,35565,-19831
13850,0.0,0.0,0.0,2371,55400,35565,-19835
13851,0.0,0.0,0.0,2371,55404,35565,-19839
13852,0.0,0.0,0.3333333333333333,2371,55408,35565,-19843
13853,0.0,0.0,0.0,2371,55412,35565,-19847
13854,0.0,0.0,0.0,2371,55416,35565,-19851
13855,0.0,0.0,0.0,2371,55420,35565,-19855
13856,0.0,0.0,0.0,2371,55424,35565,-19859
13857,0.0,0.0,0.0,2371,55428,35565,-19863
13858,0.0,0.0,0.0,2371,55432,35565,-19867
13859,0.0,0.0,0.0,2371,55436,35565,-19871
13860,0.0,0.0,0.0,2371,55440,35565,-19875
13861,0.0,0.0,0.0,2371,55444,35565,-19879
13862,0.0,0.0,0.0,2371,55448,35565,-19883
13863,0.0,0.0,0.0,2371,55452,35565,-19887
13864,0.0,0.0,0.0,2371,55456,35565,-19891
13865,0.0,0.0,0.0,2371,55460,35565,-19895
13866,0.0,0.0,0.0,2371,55464,35565,-19899
13867,0.0,0.0,0.0,2371,55468,35565,-19903
13868,0.0,0.0,0.0,2371,55472,35565,-19907
13869,0.0,0.0,0.0,2371,55476,35565,-19911
13870,1.0,1.0,1.0,2372,55480,35580,-19900
13871,0.0,0.0,0.0,2372,55484,35580,-19904
13872,0.0,0.0,0.0,2372,55488,35580,-19908
13873,0.0,0.0,0.0,2372,55492,35580,-19912
13874,0.0,0.0,0.0,2372,55496,35580,-19916
13875,0.0,0.0,0.0,2372,55500,35580,-19920
13876,0.0,0.0,0.0,2372,55504,35580,-19924
13877,0.0,0.0,0.0,2372,55508,35580,-19928
13878,0.0,0.0,0.0,2372,55512,35580,-19932
13879,0.0,0.0,0.0,2372,55516,35580,-19936
13880,0.0,0.0,0.0,2372,55520,35580,-19940
13881,0.0,0.0,0.0,2372,55524,35580,-19944
13882,0.0,0.0,0.0,2372,55528,35580,-19948
13883,0.0,0.0,0.0,2372,55532,35580,-19952
13884,0.0,0.0,0.0,2372,55536,35580,-19956
13885,0.0,0.0,0.0,2372,55540,35580,-19960
13886,0.0,0.0,0.0,2372,55544,35580,-19964
13887,0.0,0.0,0.0,2372,55548,35580,-19968
13888,0.0,0.0,0.0,2372,55552,35580,-19972
13889,0.0,0.0,0.0,2372,55556,35580,-19976
13890,1.0,1.0,1.0,2373,55560,35595,-19965
13891,0.0,0.0,0.0,2373,55564,35595,-19969
13892,0.0,0.0,0.0,2373,55568,35595,-19973
13893,0.0,0.0,0.0,2373,55572,35595,-19977
13894,1.0,1.0,0.6666666666666666,2374,55576,35610,-19966
13895,0.0,0.0,0.0,2374,55580,35610,-19970
13896,0.0,0.0,0.0,2374,55584,35610,-19974
13897,0.0,0.0,0.0,2374,55588,35610,-19978
13898,0.0,0.0,0.0,2374,55592,35610,-19982
13899,0.0,0.0,0.0,2374,55596,35610,-19986
13900,0.0,0.0,0.0,2374,55600,35610,-19990
13901,0.0,0.0,0.0,2374,55604,35610,-19994
13902,0.0,0.0,0.0,2374,55608,35610,-19998
13903,0.0,0.0,0.0,2374,55612,35610,-20002
13904,0.0,0.0,0.0,2374,55616,35610,-20006
13905,0.0,0.0,0.0,2374,55620,35610,-20010
13906,0.0,0.0,0.0,2374,55624,35610,-20014
13907,0.0,0.0,0.0,2374,55628,35610,-20018
13908,0.0,0.0,0.0,2374,55632,35610,-20022
13909,1.0,1.0,1.0,2375,55636,35625,-20011
13910,0.0,0.0,0.0,2375,55640,35625,-20015
13911,0.0,0.0,0.0,2375,55644,35625,-20019
13912,0.0,0.0,0.3333333333333333,2375,55648,35625,-20023
13913,0.0,0.0,0.0,2375,55652,35625,-20027
13914,0.0,0.0,0.0,2375,55656,35625,-20031
13915,1.0,1.0,1.0,2376,55660,35640,-20020
13916,0.0,0.0,0.0,2376,55664,35640,-20024
13917,0.0,0.0,0.0,2376,55668,35640,-20028
13918,0.0,0.0,0.0,2376,55672,35640,-20032
13919,0.0,0.0,0.0,2376,55676,35640,-20036
13920,0.0,0.0,0.0,2376,55680,35640,-20040
13921,0.0,0.0,0.0,2376,55684,35640,-20044
13922,0.0,0.0,0.0,2376,55688,35640,-20048
13923,0.0,0.0,0.0,2376,55692,35640,-20052
13924,0.0,0.0,0.0,2376,55696,35640,-20056
13925,0.0,0.0,0.0,2376,55700,35640,-20060
13926,0.0,0.0,0.0,2376,55704,35640,-20064
13927,1.0,1.0,1.0,2377,55708,35655,-20053
13928,0.0,0.0,0.0,2377,55712,35655,-20057
13929,0.0,0.0,0.0,2377,55716,35655,-20061
13930,1.0,1.0,1.0,2378,55720,35670,-20050
13931,1.0,1.0,1.0,2379,55724,35685,-20039
13932,0.0,0.0,0.0,2379,55728,35685,-20043
13933,0.0,0.0,0.0,2379,55732,35685,-20047
13934,0.0,0.0,0.0,2379,55736,35685,-20051
13935,0.0,0.0,0.0,2379,55740,35685,-20055
13936,0.0,0.0,0.0,2379,55744,35685,-20059
13937,0.0,0.0,0.0,2379,55748,35685,-20063
13938,0.0,0.0,0.0,2379,55752,35685,-20067
13939,1.0,1.0,1.0,2380,55756,35700,-20056
13940,0.0,0.0,0.0,2380,55760,35700,-20060
13941,0.0,0.0,0.0,2380,55764,35700,-20064
13942,0.0,0.0,0.0,2380,55768,35700,-20068
13943,0.0,0.0,0.0,2380,55772,35700,-20072
13944,1.0,1.0,0.8,2381,55776,35715,-20061
13945,0.0,0.0,0.25,2381,55780,35715,-20065
13946,0.0,0.0,0.0,2381,55784,35715,-20069
13947,0.0,0.0,0.0,2381,55788,35715,-20073
13948,0.0,0.0,0.0,2381,55792,35715,-20077
13949,0.0,0.0,0.0,2381,55796,35715,-20081
13950,1.0,1.0,1.0,2382,55800,35730,-20070
13951,1.0,0.0,0.5,2383,55804,35745,-20059
13952,0.0,0.0,0.0,2383,55808,35745,-20063
13953,0.0,0.0,0.0,2383,55812,35745,-20067
13954,1.0,1.0,1.0,2384,55816,35760,-20056
13955,0.0,0.0,0.0,2384,55820,35760,-20060
13956,1.0,1.0,1.0,2385,55824,35775,-20049
13957,0.0,0.0,0.0,2385,55828,35775,-20053
13958,1.0,1.0,1.0,2386,55832,35790,-20042
13959,0.0,0.0,0.0,2386,55836,35790,-20046
13960,0.0,0.0,0.0,2386,55840,35790,-20050
13961,1.0,1.0,0.75,2387,55844,35805,-20039
13962,0.0,0.0,0.0,2387,55848,35805,-20043
13963,0.0,0.0,0.0,2387,55852,35805,-20047
13964,1.0,1.0,1.0,2388,55856,35820,-20036
13965,0.0,0.0,0.0,2388,55860,35820,-20040
13966,0.0,0.0,0.0,2388,55864,35820,-20044
13967,0.0,0.0,0.0,2388,55868,35820,-20048
13968,1.0,1.0,1.0,2389,55872,35835,-20037
13969,0.0,0.0,0.0,2389,55876,35835,-20041
13970,1.0,1.0,1.0,2390,55880,35850,-20030
13971,0.0,0.0,0.0,2390,55884,35850,-20034
13972,0.0,0.0,0.0,2390,55888,35850,-20038
13973,0.0,0.0,0.0,2390,55892,35850,-20042
13974,0.0,0.0,0.0,2390,55896,35850,-20046
13975,0.0,0.0,0.0,2390,55900,35850,-20050
13976,1.0,1.0,0.6,2391,55904,35865,-20039
13977,0.0,0.0,0.0,2391,55908,35865,-20043
13978,1.0,1.0,1.0,2392,55912,35880,-20032
13979,0.0,0.0,0.0,2392,55916,35880,-20036
13980,0.0,0.0,0.0,2392,55920,35880,-20040
13981,0.0,0.0,0.0,2392,55924,35880,-20044
13982,0.0,0.0,0.0,2392,55928,35880,-20048
13983,0.0,0.0,0.0,2392,55932,35880,-20052
13984,0.0,0.0,0.0,2392,55936,35880,-20056
13985,0.0,0.0,0.0,2392,55940,35880,-20060
13986,0.0,0.0,0.0,2392,55944,35880,-20064
13987,0.0,0.0,0.0,2392,55948,35880,-20068
13988,0.0,0.0,0.0,2392,55952,35880,-20072
13989,0.0,0.0,0.0,2392,55956,35880,-20076
13990,0.0,0.0,0.0,2392,55960,35880,-20080
13991,0.0,0.0,0.0,2392,55964,35880,-20084
13992,0.0,0.0,0.0,2392,55968,35880,-20088
13993,0.0,0.0,0.0,2392,55972,35880,-20092
13994,0.0,0.0,0.0,2392,55976,35880,-20096
13995,0.0,0.0,0.0,2392,55980,35880,-20100
13996,0.0,0.0,0.0,2392,55984,35880,-20104
13997,0.0,0.0,0.0,2392,55988,35880,-20108
13998,0.0,0.0,0.0,2392,55992,35880,-20112
13999,0.0,0.0,0.0,2392,55996,35880,-20116
14000,0.0,0.0,0.0,2392,56000,35880,-20120
14001,0.0,0.0,0.0,2392,56004,35880,-20124
14002,0.0,1.0,0.6666666666666666,2392,56008,35880,-20128
14003,0.0,0.0,0.0,2392,56012,35880,-20132
14004,0.0,0.0,0.0,2392,56016,35880,-20136
14005,0.0,0.0,0.0,2392,56020,35880,-20140
14006,1.0,0.0,0.3333333333333333,2393,56024,35895,-20129
14007,0.0,0.0,0.0,2393,56028,35895,-20133
14008,0.0,0.0,0.0,2393,56032,35895,-20137
14009,0.0,1.0,0.6666666666666666,2393,56036,35895,-20141
14010,1.0,1.0,1.0,2394,56040,35910,-20130
14011,0.0,0.0,0.0,2394,56044,35910,-20134
14012,0.0,0.0,0.0,2394,56048,35910,-20138
14013,0.0,0.0,0.0,2394,56052,35910,-20142
14014,1.0,1.0,1.0,2395,56056,35925,-20131
14015,0.0,0.0,0.0,2395,56060,35925,-20135
14016,0.0,0.0,0.0,2395,56064,35925,-20139
14017,1.0,1.0,1.0,2396,56068,35940,-20128
14018,0.0,0.0,0.0,2396,56072,35940,-20132
14019,0.0,0.0,0.0,2396,56076,35940,-20136
14020,0.0,0.0,0.0,2396,56080,35940,-20140
14021,0.0,0.0,0.0,2396,56084,35940,-20144
14022,0.0,0.0,0.0,2396,56088,35940,-20148
14023,0.0,0.0,0.0,2396,56092,35940,-20152
14024,0.0,0.0,0.0,2396,56096,35940,-20156
14025,0.0,0.0,0.0,2396,56100,35940,-20160
14026,0.0,0.0,0.0,2396,56104,35940,-20164
14027,0.0,0.0,0.0,2396,56108,35940,-20168
14028,0.0,0.0,0.0,2396,56112,35940,-20172
14029,0.0,0.0,0.0,2396,56116,35940,-20176
14030,1.0,1.0,1.0,2397,56120,35955,-20165
14031,0.0,0.0,0.0,2397,56124,35955,-20169
14032,0.0,0.0,0.0,2397,56128,35955,-20173
14033,0.0,0.0,0.0,2397,56132,35955,-20177
14034,0.0,0.0,0.0,2397,56136,35955,-20181
14035,1.0,1.0,1.0,2398,56140,35970,-20170
14036,0.0,0.0,0.0,2398,56144,35970,-20174
14037,0.0,0.0,0.0,2398,56148,35970,-20178
14038,0.0,0.0,0.0,2398,56152,35970,-20182
14039,0.0,0.0,0.0,2398,56156,35970,-20186
14040,0.0,0.0,0.0,2398,56160,35970,-20190
14041,0.0,0.0,0.0,2398,56164,35970,-20194
14042,0.0,0.0,0.0,2398,56168,35970,-20198
14043,0.0,0.0,0.0,2398,56172,35970,-20202
14044,0.0,0.0,0.0,2398,56176,35970,-20206
14045,0.0,0.0,0.0,2398,56180,35970,-20210
14046,0.0,0.0,0.0,2398,56184,35970,-20214
14047,1.0,0.0,0.25,2399,56188,35985,-20203
14048,0.0,0.0,0.0,2399,56192,35985,-20207
14049,1.0,1.0,1.0,2400,56196,36000,-20196
14050,0.0,0.0,0.0,2400,56200,36000,-20200
14051,0.0,0.0,0.0,2400,56204,36000,-20204
14052,1.0,0.0,0.4,2401,56208,36015,-20193
14053,0.0,0.0,0.0,2401,56212,36015,-20197
14054,0.0,0.0,0.0,2401,56216,36015,-20201
14055,0.0,0.0,0.0,2401,56220,36015,-20205
14056,0.0,0.0,0.0,2401,56224,36015,-20209
14057,0.0,0.0,0.0,2401,56228,36015,-20213
14058,0.0,0.0,0.0,2401,56232,36015,-20217
14059,0.0,0.0,0.0,2401,56236,36015,-20221
14060,0.0,0.0,0.0,2401,56240,36015,-20225
14061,1.0,1.0,1.0,2402,56244,36030,-20214
14062,0.0,0.0,0.0,2402,56248,36030,-20218
14063,0.0,0.0,0.0,2402,56252,36030,-20222
14064,0.0,0.0,0.0,2402,56256,36030,-20226
14065,0.0,0.0,0.0,2402,56260,36030,-20230
14066,0.0,0.0,0.0,2402,56264,36030,-20234
14067,0.0,0.0,0.0,2402,56268,36030,-20238
14068,0.0,0.0,0.0,2402,56272,36030,-20242
14069,0.0,0.0,0.0,2402,56276,36030,-20246
14070,0.0,0.0,0.0,2402,56280,36030,-20250
14071,0.0,0.0,0.0,2402,56284,36030,-20254
14072,0.0,0.0,0.0,2402,56288,36030,-20258
14073,0.0,0.0,0.0,2402,56292,36030,-20262
14074,0.0,0.0,0.0,2402,56296,36030,-20266
14075,0.0,0.0,0.0,2402,56300,36030,-20270
14076,0.0,0.0,0.0,2402,56304,36030,-20274
14077,0.0,0.0,0.0,2402,56308,36030,-20278
14078,0.0,0.0,0.0,2402,56312,36030,-20282
14079,0.0,0.0,0.0,2402,56316,36030,-20286
14080,0.0,0.0,0.0,2402,56320,36030,-20290
14081,0.0,0.0,0.0,2402,56324,36030,-20294
14082,0.0,0.0,0.0,2402,56328,36030,-20298
14083,0.0,0.0,0.0,2402,56332,36030,-20302
14084,0.0,0.0,0.0,2402,56336,36030,-20306
14085,0.0,0.0,0.0,2402,56340,36030,-20310
14086,0.0,0.0,0.0,2402,56344,36030,-20314
14087,0.0,0.0,0.0,2402,56348,36030,-20318
14088,0.0,0.0,0.0,2402,56352,36030,-20322
14089,0.0,0.0,0.0,2402,56356,36030,-20326
14090,0.0,0.0,0.0,2402,56360,36030,-20330
14091,1.0,1.0,1.0,2403,56364,36045,-20319
14092,0.0,0.0,0.0,2403,56368,36045,-20323
14093,0.0,0.0,0.0,2403,56372,36045,-20327
14094,0.0,0.0,0.0,2403,56376,36045,-20331
14095,0.0,0.0,0.0,2403,56380,36045,-20335
14096,0.0,0.0,0.0,2403,56384,36045,-20339
14097,1.0,1.0,1.0,2404,56388,36060,-20328
14098,0.0,0.0,0.0,2404,56392,36060,-20332
14099,0.0,0.0,0.0,2404,56396,36060,-20336
14100,0.0,1.0,0.6666666666666666,2404,56400,36060,-20340
14101,1.0,1.0,0.8,2405,56404,36075,-20329
14102,0.0,1.0,0.6666666666666666,2405,56408,36075,-20333
14103,0.0,0.0,0.0,2405,56412,36075,-20337
14104,1.0,0.0,0.4,2406,56416,36090,-20326
14105,1.0,1.0,1.0,2407,56420,36105,-20315
14106,0.0,0.0,0.0,2407,56424,36105,-20319
14107,0.0,0.0,0.0,2407,56428,36105,-20323
14108,0.0,0.0,0.0,2407,56432,36105,-20327
14109,0.0,0.0,0.3333333333333333,2407,56436,36105,-20331
14110,0.0,0.0,0.0,2407,56440,36105,-20335
14111,0.0,0.0,0.0,2407,56444,36105,-20339
14112,0.0,0.0,0.0,2407,56448,36105,-20343
14113,0.0,0.0,0.0,2407,56452,36105,-20347
14114,0.0,0.0,0.0,2407,56456,36105,-20351
14115,0.0,0.0,0.0,2407,56460,36105,-20355
14116,0.0,0.0,0.0,2407,56464,36105,-20359
14117,1.0,1.0,1.0,2408,56468,36120,-20348
14118,0.0,0.0,0.0,2408,56472,36120,-20352
14119,0.0,0.0,0.0,2408,56476,36120,-20356
14120,0.0,0.0,0.0,2408,56480,36120,-20360
14121,0.0,0.0,0.0,2408,56484,36120,-20364
14122,0.0,0.0,0.0,2408,56488,36120,-20368
14123,0.0,0.0,0.0,2408,56492,36120,-20372
14124,0.0,0.0,0.0,2408,56496,36120,-20376
14125,0.0,0.0,0.3333333333333333,2408,56500,36120,-20380
14126,0.0,0.0,0.0,2408,56504,36120,-20384
14127,0.0,0.0,0.0,2408,56508,36120,-20388
14128,0.0,0.0,0.0,2408,56512,36120,-20392
14129,1.0,0.0,0.4,2409,56516,36135,-20381
14130,0.0,0.0,0.0,2409,56520,36135,-20385
14131,1.0,0.0,0.4,2410,56524,36150,-20374
14132,0.0,0.0,0.4,2410,56528,36150,-20378
14133,0.0,0.0,0.0,2410,56532,36150,-20382
14134,0.0,0.0,0.0,2410,56536,36150,-20386
14135,0.0,0.0,0.0,2410,56540,36150,-20390
14136,0.0,0.0,0.0,2410,56544,36150,-20394
14137,1.0,1.0,1.0,2411,56548,36165,-20383
14138,0.0,0.0,0.0,2411,56552,36165,-20387
14139,0.0,0.0,0.3333333333333333,2411,56556,36165,-20391
14140,0.0,0.0,0.0,2411,56560,36165,-20395
14141,0.0,0.0,0.0,2411,56564,36165,-20399
14142,0.0,0.0,0.0,2411,56568,36165,-20403
14143,1.0,1.0,1.0,2412,56572,36180,-20392
14144,1.0,1.0,1.0,2413,56576,36195,-20381
14145,0.0,0.0,0.0,2413,56580,36195,-20385
14146,0.0,0.0,0.0,2413,56584,36195,-20389
14147,0.0,0.0,0.0,2413,56588,36195,-20393
14148,0.0,0.0,0.0,2413,56592,36195,-20397
14149,0.0,0.0,0.0,2413,56596,36195,-20401
14150,0.0,0.0,0.0,2413,56600,36195,-20405
14151,0.0,0.0,0.0,2413,56604,36195,-20409
14152,0.0,0.0,0.0,2413,56608,36195,-20413
14153,0.0,0.0,0.0,2413,56612,36195,-20417
14154,0.0,1.0,0.75,2413,56616,36195,-20421
14155,0.0,0.0,0.0,2413,56620,36195,-20425
14156,0.0,0.0,0.0,2413,56624,36195,-20429
14157,0.0,0.0,0.0,2413,56628,36195,-20433
14158,0.0,0.0,0.0,2413,56632,36195,-20437
14159,0.0,0.0,0.0,2413,56636,36195,-20441
14160,0.0,0.0,0.0,2413,56640,36195,-20445
14161,0.0,0.0,0.0,2413,56644,36195,-20449
14162,1.0,1.0,1.0,2414,56648,36210,-20438
14163,0.0,0.0,0.0,2414,56652,36210,-20442
14164,0.0,0.0,0.0,2414,56656,36210,-20446
14165,1.0,1.0,0.75,2415,56660,36225,-20435
14166,1.0,1.0,0.75,2416,56664,36240,-20424
14167,0.0,0.0,0.0,2416,56668,36240,-20428
14168,0.0,0.0,0.0,2416,56672,36240,-20432
14169,0.0,0.0,0.0,2416,56676,36240,-20436
14170,0.0,0.0,0.0,2416,56680,36240,-20440
14171,0.0,0.0,0.0,2416,56684,36240,-20444
14172,0.0,0.0,0.2,2416,56688,36240,-20448
14173,0.0,0.0,0.0,2416,56692,36240,-20452
14174,0.0,0.0,0.0,2416,56696,36240,-20456
14175,0.0,0.0,0.0,2416,56700,36240,-20460
14176,0.0,0.0,0.0,2416,56704,36240,-20464
14177,0.0,0.0,0.0,2416,56708,36240,-20468
14178,0.0,0.0,0.0,2416,56712,36240,-20472
14179,0.0,0.0,0.0,2416,56716,36240,-20476
14180,0.0,0.0,0.0,2416,56720,36240,-20480
14181,1.0,1.0,0.75,2417,56724,36255,-20469
14182,0.0,0.0,0.0,2417,56728,36255,-20473
14183,0.0,0.0,0.0,2417,56732,36255,-20477
14184,0.0,0.0,0.0,2417,56736,36255,-20481
14185,0.0,0.0,0.0,2417,56740,36255,-20485
14186,1.0,1.0,1.0,2418,56744,36270,-20474
14187,0.0,0.0,0.0,2418,56748,36270,-20478
14188,0.0,0.0,0.0,2418,56752,36270,-20482
14189,0.0,0.0,0.0,2418,56756,36270,-20486
14190,0.0,0.0,0.0,2418,56760,36270,-20490
14191,0.0,0.0,0.0,2418,56764,36270,-20494
14192,0.0,0.0,0.0,2418,56768,36270,-20498
14193,1.0,1.0,0.6,2419,56772,36285,-20487
14194,1.0,0.0,0.3333333333333333,2420,56776,36300,-20476
14195,1.0,1.0,1.0,2421,56780,36315,-20465
14196,1.0,1.0,1.0,2422,56784,36330,-20454
14197,1.0,1.0,1.0,2423,56788,36345,-20443
14198,0.0,0.0,0.0,2423,56792,36345,-20447
14199,1.0,1.0,1.0,2424,56796,36360,-20436
14200,0.0,0.0,0.0,2424,56800,36360,-20440
14201,0.0,0.0,0.0,2424,56804,36360,-20444
14202,0.0,0.0,0.0,2424,56808,36360,-20448
14203,0.0,0.0,0.0,2424,56812,36360,-20452
14204,0.0,0.0,0.0,2424,56816,36360,-20456
14205,0.0,0.0,0.0,2424,56820,36360,-20460
14206,0.0,0.0,0.0,2424,56824,36360,-20464
14207,0.0,0.0,0.0,2424,56828,36360,-20468
14208,0.0,0.0,0.0,2424,56832,36360,-20472
14209,0.0,0.0,0.0,2424,56836,36360,-20476
14210,0.0,0.0,0.0,2424,56840,36360,-20480
14211,0.0,0.0,0.0,2424,56844,36360,-20484
14212,1.0,0.0,0.5,2425,56848,36375,-20473
14213,1.0,1.0,1.0,2426,56852,36390,-20462
14214,0.0,0.0,0.0,2426,56856,36390,-20466
14215,0.0,0.0,0.0,2426,56860,36390,-20470
14216,1.0,1.0,0.6666666666666666,2427,56864,36405,-20459
14217,0.0,0.0,0.0,2427,56868,36405,-20463
14218,0.0,0.0,0.0,2427,56872,36405,-20467
14219,1.0,1.0,1.0,2428,56876,36420,-20456
14220,0.0,0.0,0.0,2428,56880,36420,-20460
14221,0.0,0.0,0.3333333333333333,2428,56884,36420,-20464
14222,0.0,0.0,0.0,2428,56888,36420,-20468
14223,1.0,1.0,0.6666666666666666,2429,56892,36435,-20457
14224,0.0,0.0,0.2,2429,56896,36435,-20461
14225,0.0,0.0,0.0,2429,56900,36435,-20465
14226,0.0,0.0,0.0,2429,56904,36435,-20469
14227,0.0,0.0,0.0,2429,56908,36435,-20473
14228,1.0,1.0,1.0,2430,56912,36450,-20462
14229,0.0,0.0,0.0,2430,56916,36450,-20466
14230,0.0,0.0,0.0,2430,56920,36450,-20470
14231,0.0,0.0,0.0,2430,56924,36450,-20474
14232,0.0,0.0,0.0,2430,56928,36450,-20478
14233,1.0,1.0,1.0,2431,56932,36465,-20467
14234,0.0,0.0,0.0,2431,56936,36465,-20471
14235,0.0,0.0,0.0,2431,56940,36465,-20475
14236,1.0,1.0,1.0,2432,56944,36480,-20464
14237,0.0,0.0,0.0,2432,56948,36480,-20468
14238,1.0,1.0,0.6,2433,56952,36495,-20457
14239,1.0,1.0,1.0,2434,56956,36510,-20446
14240,0.0,0.0,0.0,2434,56960,36510,-20450
14241,1.0,1.0,1.0,2435,56964,36525,-20439
14242,1.0,1.0,1.0,2436,56968,36540,-20428
14243,0.0,0.0,0.3333333333333333,2436,56972,36540,-20432
14244,0.0,0.0,0.0,2436,56976,36540,-20436
14245,0.0,0.0,0.0,2436,56980,36540,-20440
14246,0.0,0.0,0.0,2436,56984,36540,-20444
14247,1.0,1.0,1.0,2437,56988,36555,-20433
14248,0.0,0.0,0.0,2437,56992,36555,-20437
14249,0.0,0.0,0.0,2437,56996,36555,-20441
14250,0.0,0.0,0.3333333333333333,2437,57000,36555,-20445
14251,0.0,0.0,0.0,2437,57004,36555,-20449
14252,0.0,0.0,0.0,2437,57008,36555,-20453
14253,0.0,0.0,0.0,2437,57012,36555,-20457
14254,0.0,0.0,0.0,2437,57016,36555,-20461
14255,0.0,0.0,0.0,2437,57020,36555,-20465
14256,1.0,0.0,0.3333333333333333,2438,57024,36570,-20454
14257,0.0,0.0,0.0,2438,57028,36570,-20458
14258,0.0,0.0,0.0,2438,57032,36570,-20462
14259,0.0,0.0,0.4,2438,57036,36570,-20466
14260,1.0,1.0,1.0,2439,57040,36585,-20455
14261,0.0,0.0,0.0,2439,57044,36585,-20459
14262,0.0,0.0,0.0,2439,57048,36585,-20463
14263,0.0,0.0,0.0,2439,57052,36585,-20467
14264,0.0,0.0,0.0,2439,57056,36585,-20471
14265,0.0,0.0,0.0,2439,57060,36585,-20475
14266,0.0,0.0,0.0,2439,57064,36585,-20479
14267,0.0,0.0,0.0,2439,57068,36585,-20483
14268,0.0,0.0,0.0,2439,57072,36585,-20487
14269,0.0,0.0,0.0,2439,57076,36585,-20491
14270,1.0,1.0,1.0,2440,57080,36600,-20480
14271,0.0,0.0,0.0,2440,57084,36600,-20484
14272,0.0,1.0,0.6666666666666666,2440,57088,36600,-20488
14273,0.0,0.0,0.0,2440,57092,36600,-20492
14274,1.0,1.0,1.0,2441,57096,36615,-20481
14275,0.0,0.0,0.0,2441,57100,36615,-20485
14276,0.0,0.0,0.0,2441,57104,36615,-20489
14277,1.0,1.0,0.75,2442,57108,36630,-20478
14278,0.0,0.0,0.0,2442,57112,36630,-20482
14279,0.0,0.0,0.0,2442,57116,36630,-20486
14280,0.0,0.0,0.0,2442,57120,36630,-20490
14281,0.0,0.0,0.0,2442,57124,36630,-20494
14282,0.0,0.0,0.0,2442,57128,36630,-20498
14283,0.0,0.0,0.0,2442,57132,36630,-20502
14284,0.0,0.0,0.0,2442,57136,36630,-20506
14285,0.0,0.0,0.0,2442,57140,36630,-20510
14286,0.0,0.0,0.0,2442,57144,36630,-20514
14287,1.0,1.0,1.0,2443,57148,36645,-20503
14288,0.0,0.0,0.0,2443,57152,36645,-20507
14289,0.0,0.0,0.0,2443,57156,36645,-20511
14290,0.0,0.0,0.0,2443,57160,36645,-20515
14291,0.0,0.0,0.0,2443,57164,36645,-20519
14292,0.0,0.0,0.0,2443,57168,36645,-20523
14293,0.0,0.0,0.0,2443,57172,36645,-20527
14294,0.0,0.0,0.0,2443,57176,36645,-20531
14295,0.0,0.0,0.0,2443,57180,36645,-20535
14296,1.0,1.0,1.0,2444,57184,36660,-20524
14297,0.0,0.0,0.0,2444,57188,36660,-20528
14298,1.0,1.0,1.0,2445,57192,36675,-20517
14299,1.0,1.0,1.0,2446,57196,36690,-20506
14300,0.0,0.0,0.0,2446,57200,36690,-20510
14301,0.0,0.0,0.0,2446,57204,36690,-20514
14302,1.0,1.0,1.0,2447,57208,36705,-20503
14303,0.0,0.0,0.25,2447,57212,36705,-20507
14304,0.0,0.0,0.0,2447,57216,36705,-20511
14305,0.0,0.0,0.0,2447,57220,36705,-20515
14306,0.0,0.0,0.0,2447,57224,36705,-20519
14307,0.0,0.0,0.0,2447,57228,36705,-20523
14308,1.0,1.0,1.0,2448,57232,36720,-20512
14309,0.0,0.0,0.0,2448,57236,36720,-20516
14310,0.0,0.0,0.3333333333333333,2448,57240,36720,-20520
14311,0.0,0.0,0.0,2448,57244,36720,-20524
14312,0.0,0.0,0.0,2448,57248,36720,-20528
14313,0.0,0.0,0.0,2448,57252,36720,-20532
14314,0.0,0.0,0.0,2448,57256,36720,-20536
14315,0.0,0.0,0.0,2448,57260,36720,-20540
14316,0.0,0.0,0.3333333333333333,2448,57264,36720,-20544
14317,0.0,0.0,0.0,2448,57268,36720,-20548
14318,0.0,0.0,0.0,2448,57272,36720,-20552
14319,1.0,0.0,0.3333333333333333,2449,57276,36735,-20541
14320,0.0,0.0,0.0,2449,57280,36735,-20545
14321,1.0,1.0,1.0,2450,57284,36750,-20534
14322,0.0,0.0,0.0,2450,57288,36750,-20538
14323,1.0,1.0,1.0,2451,57292,36765,-20527
14324,0.0,0.0,0.0,2451,57296,36765,-20531
14325,1.0,1.0,1.0,2452,57300,36780,-20520
14326,1.0,1.0,0.6666666666666666,2453,57304,36795,-20509
14327,0.0,0.0,0.0,2453,57308,36795,-20513
14328,0.0,0.0,0.3333333333333333,2453,57312,36795,-20517
14329,0.0,0.0,0.0,2453,57316,36795,-20521
14330,1.0,1.0,1.0,2454,57320,36810,-20510
14331,0.0,0.0,0.0,2454,57324,36810,-20514
14332,0.0,0.0,0.0,2454,57328,36810,-20518
14333,0.0,0.0,0.0,2454,57332,36810,-20522
14334,1.0,1.0,1.0,2455,57336,36825,-20511
14335,0.0,0.0,0.0,2455,57340,36825,-20515
14336,0.0,0.0,0.0,2455,57344,36825,-20519
14337,0.0,0.0,0.25,2455,57348,36825,-20523
14338,0.0,0.0,0.0,2455,57352,36825,-20527
14339,0.0,0.0,0.0,2455,57356,36825,-20531
14340,0.0,0.0,0.0,2455,57360,36825,-20535
14341,0.0,0.0,0.0,2455,57364,36825,-20539
14342,0.0,0.0,0.0,2455,57368,36825,-20543
14343,0.0,0.0,0.0,2455,57372,36825,-20547
14344,0.0,0.0,0.0,2455,57376,36825,-20551
14345,0.0,0.0,0.0,2455,57380,36825,-20555
14346,0.0,0.0,0.0,2455,57384,36825,-20559
14347,0.0,0.0,0.0,2455,57388,36825,-20563
14348,0.0,0.0,0.0,2455,57392,36825,-20567
14349,0.0,0.0,0.0,2455,57396,36825,-20571
14350,0.0,0.0,0.0,2455,57400,36825,-20575
14351,0.0,0.0,0.3333333333333333,2455,57404,36825,-20579
14352,1.0,1.0,1.0,2456,57408,36840,-20568
14353,0.0,0.0,0.0,2456,57412,36840,-20572
14354,0.0,0.0,0.0,2456,57416,36840,-20576
14355,0.0,0.0,0.0,2456,57420,36840,-20580
14356,0.0,0.0,0.0,2456,57424,36840,-20584
14357,0.0,0.0,0.0,2456,57428,36840,-20588
14358,0.0,0.0,0.0,2456,57432,36840,-20592
14359,0.0,0.0,0.3333333333333333,2456,57436,36840,-20596
14360,0.0,0.0,0.0,2456,57440,36840,-20600
14361,1.0,1.0,1.0,2457,57444,36855,-20589
14362,0.0,0.0,0.0,2457,57448,36855,-20593
14363,1.0,1.0,0.6666666666666666,2458,57452,36870,-20582
14364,0.0,0.0,0.0,2458,57456,36870,-20586
14365,0.0,0.0,0.0,2458,57460,36870,-20590
14366,1.0,1.0,1.0,2459,57464,36885,-20579
14367,0.0,0.0,0.0,2459,57468,36885,-20583
14368,0.0,0.0,0.0,2459,57472,36885,-20587
14369,0.0,0.0,0.0,2459,57476,36885,-20591
14370,0.0,0.0,0.0,2459,57480,36885,-20595
14371,0.0,0.0,0.0,2459,57484,36885,-20599
14372,0.0,0.0,0.0,2459,57488,36885,-20603
14373,0.0,0.0,0.0,2459,57492,36885,-20607
14374,0.0,0.0,0.0,2459,57496,36885,-20611
14375,1.0,1.0,1.0,2460,57500,36900,-20600
14376,0.0,0.0,0.0,2460,57504,36900,-20604
14377,0.0,0.0,0.0,2460,57508,36900,-20608
14378,0.0,0.0,0.0,2460,57512,36900,-20612
14379,1.0,1.0,1.0,2461,57516,36915,-20601
14380,0.0,0.0,0.0,2461,57520,36915,-20605
14381,0.0,0.0,0.0,2461,57524,36915,-20609
14382,1.0,1.0,1.0,2462,57528,36930,-20598
14383,0.0,0.0,0.0,2462,57532,36930,-20602
14384,1.0,1.0,1.0,2463,57536,36945,-20591
14385,0.0,0.0,0.0,2463,57540,36945,-20595
14386,0.0,0.0,0.0,2463,57544,36945,-20599
14387,0.0,0.0,0.0,2463,57548,36945,-20603
14388,0.0,0.0,0.0,2463,57552,36945,-20607
14389,0.0,0.0,0.0,2463,57556,36945,-20611
14390,1.0,1.0,1.0,2464,57560,36960,-20600
14391,1.0,0.0,0.5,2465,57564,36975,-20589
14392,0.0,0.0,0.0,2465,57568,36975,-20593
14393,0.0,0.0,0.0,2465,57572,36975,-20597
14394,1.0,1.0,0.8,2466,57576,36990,-20586
14395,0.0,0.0,0.0,2466,57580,36990,-20590
14396,1.0,1.0,0.6666666666666666,2467,57584,37005,-20579
14397,0.0,0.0,0.0,2467,57588,37005,-20583
14398,1.0,1.0,1.0,2468,57592,37020,-20572
14399,0.0,0.0,0.0,2468,57596,37020,-20576
14400,1.0,1.0,1.0,2469,57600,37035,-20565
14401,0.0,0.0,0.0,2469,57604,37035,-20569
14402,0.0,0.0,0.0,2469,57608,37035,-20573
14403,0.0,0.0,0.0,2469,57612,37035,-20577
14404,0.0,0.0,0.5,2469,57616,37035,-20581
14405,0.0,0.0,0.0,2469,57620,37035,-20585
14406,0.0,0.0,0.0,2469,57624,37035,-20589
14407,0.0,0.0,0.0,2469,57628,37035,-20593
14408,0.0,0.0,0.0,2469,57632,37035,-20597
14409,1.0,1.0,1.0,2470,57636,37050,-20586
14410,1.0,1.0,1.0,2471,57640,37065,-20575
14411,0.0,0.0,0.0,2471,57644,37065,-20579
14412,0.0,0.0,0.0,2471,57648,37065,-20583
14413,0.0,0.0,0.0,2471,57652,37065,-20587
14414,0.0,0.0,0.0,2471,57656,37065,-20591
14415,0.0,0.0,0.0,2471,57660,37065,-20595
14416,0.0,0.0,0.0,2471,57664,37065,-20599
14417,1.0,1.0,0.6666666666666666,2472,57668,37080,-20588
14418,0.0,0.0,0.0,2472,57672,37080,-20592
14419,0.0,0.0,0.0,2472,57676,37080,-20596
14420,1.0,1.0,0.6666666666666666,2473,57680,37095,-20585
14421,0.0,0.0,0.0,2473,57684,37095,-20589
14422,0.0,0.0,0.0,2473,57688,37095,-20593
14423,0.0,0.0,0.0,2473,57692,37095,-20597
14424,0.0,0.0,0.0,2473,57696,37095,-20601
14425,0.0,0.0,0.0,2473,57700,37095,-20605
14426,0.0,0.0,0.0,2473,57704,37095,-20609
14427,0.0,0.0,0.0,2473,57708,37095,-20613
14428,0.0,0.0,0.0,2473,57712,37095,-20617
14429,0.0,0.0,0.0,2473,57716,37095,-20621
14430,1.0,1.0,1.0,2474,57720,37110,-20610
14431,0.0,0.0,0.0,2474,57724,37110,-20614
14432,0.0,0.0,0.0,2474,57728,37110,-20618
14433,0.0,0.0,0.0,2474,57732,37110,-20622
14434,0.0,0.0,0.0,2474,57736,37110,-20626
14435,0.0,0.0,0.0,2474,57740,37110,-20630
14436,0.0,0.0,0.0,2474,57744,37110,-20634
14437,0.0,0.0,0.0,2474,57748,37110,-20638
14438,1.0,1.0,1.0,2475,57752,37125,-20627
14439,1.0,1.0,1.0,2476,57756,37140,-20616
14440,0.0,0.0,0.0,2476,57760,37140,-20620
14441,0.0,0.0,0.0,2476,57764,37140,-20624
14442,0.0,0.0,0.0,2476,57768,37140,-20628
14443,1.0,1.0,1.0,2477,57772,37155,-20617
14444,0.0,0.0,0.0,2477,57776,37155,-20621
14445,0.0,0.0,0.0,2477,57780,37155,-20625
14446,1.0,1.0,1.0,2478,57784,37170,-20614
14447,0.0,0.0,0.0,2478,57788,37170,-20618
14448,0.0,0.0,0.0,2478,57792,37170,-20622
14449,1.0,1.0,1.0,2479,57796,37185,-20611
14450,0.0,0.0,0.0,2479,57800,37185,-20615
14451,0.0,0.0,0.0,2479,57804,37185,-20619
14452,1.0,1.0,1.0,2480,57808,37200,-20608
14453,0.0,0.0,0.0,2480,57812,37200,-20612
14454,0.0,0.0,0.0,2480,57816,37200,-20616
14455,0.0,0.0,0.0,2480,57820,37200,-20620
14456,0.0,0.0,0.0,2480,57824,37200,-20624
14457,0.0,0.0,0.0,2480,57828,37200,-20628
14458,0.0,0.0,0.0,2480,57832,37200,-20632
14459,0.0,0.0,0.0,2480,57836,37200,-20636
14460,0.0,0.0,0.0,2480,57840,37200,-20640
14461,0.0,0.0,0.0,2480,57844,37200,-20644
14462,0.0,0.0,0.0,2480,57848,37200,-20648
14463,0.0,0.0,0.0,2480,57852,37200,-20652
14464,0.0,1.0,0.6666666666666666,2480,57856,37200,-20656
14465,0.0,0.0,0.0,2480,57860,37200,-20660
14466,1.0,1.0,1.0,2481,57864,37215,-20649
14467,0.0,0.0,0.0,2481,57868,37215,-20653
14468,0.0,0.0,0.0,2481,57872,37215,-20657
14469,0.0,0.0,0.0,2481,57876,37215,-20661
14470,0.0,0.0,0.0,2481,57880,37215,-20665
14471,0.0,0.0,0.0,2481,57884,37215,-20669
14472,0.0,0.0,0.0,2481,57888,37215,-20673
14473,0.0,0.0,0.0,2481,57892,37215,-20677
14474,0.0,0.0,0.0,2481,57896,37215,-20681
14475,0.0,0.0,0.0,2481,57900,37215,-20685
14476,0.0,0.0,0.0,2481,57904,37215,-20689
14477,0.0,0.0,0.0,2481,57908,37215,-20693
14478,1.0,1.0,0.8,2482,57912,37230,-20682
14479,0.0,0.0,0.0,2482,57916,37230,-20686
14480,0.0,0.0,0.0,2482,57920,37230,-20690
14481,0.0,0.0,0.0,2482,57924,37230,-20694
14482,0.0,0.0,0.0,2482,57928,37230,-20698
14483,0.0,0.0,0.0,2482,57932,37230,-20702
14484,0.0,0.0,0.0,2482,57936,37230,-20706
14485,0.0,0.0,0.0,2482,57940,37230,-20710
14486,0.0,0.0,0.0,2482,57944,37230,-20714
14487,0.0,0.0,0.0,2482,57948,37230,-20718
14488,0.0,0.0,0.0,2482,57952,37230,-20722
14489,0.0,0.0,0.0,2482,57956,37230,-20726
14490,0.0,0.0,0.0,2482,57960,37230,-20730
14491,0.0,0.0,0.0,2482,57964,37230,-20734
14492,0.0,0.0,0.0,2482,57968,37230,-20738
14493,0.0,0.0,0.0,2482,57972,37230,-20742
14494,0.0,0.0,0.0,2482,57976,37230,-20746
14495,0.0,0.0,0.0,2482,57980,37230,-20750
14496,0.0,0.0,0.0,2482,57984,37230,-20754
14497,0.0,0.0,0.0,2482,57988,37230,-20758
14498,0.0,0.0,0.0,2482,57992,37230,-20762
14499,0.0,0.0,0.0,2482,57996,37230,-20766
14500,0.0,0.0,0.0,2482,58000,37230,-20770
14501,0.0,0.0,0.0,2482,58004,37230,-20774
14502,1.0,0.0,0.2,2483,58008,37245,-20763
14503,0.0,0.0,0.0,2483,58012,37245,-20767
14504,0.0,0.0,0.2,2483,58016,37245,-20771
14505,0.0,0.0,0.0,2483,58020,37245,-20775
14506,0.0,0.0,0.0,2483,58024,37245,-20779
14507,0.0,0.0,0.0,2483,58028,37245,-20783
14508,0.0,0.0,0.0,2483,58032,37245,-20787
14509,0.0,0.0,0.0,2483,58036,37245,-20791
14510,1.0,1.0,1.0,2484,58040,37260,-20780
14511,0.0,0.0,0.0,2484,58044,37260,-20784
14512,0.0,0.0,0.25,2484,58048,37260,-20788
14513,1.0,1.0,1.0,2485,58052,37275,-20777
14514,0.0,0.0,0.0,2485,58056,37275,-20781
14515,0.0,0.0,0.0,2485,58060,37275,-20785
14516,0.0,0.0,0.0,2485,58064,37275,-20789
14517,0.0,0.0,0.0,2485,58068,37275,-20793
14518,0.0,0.0,0.25,2485,58072,37275,-20797
14519,0.0,0.0,0.0,2485,58076,37275,-20801
14520,0.0,0.0,0.0,2485,58080,37275,-20805
14521,0.0,0.0,0.0,2485,58084,37275,-20809
14522,0.0,0.0,0.0,2485,58088,37275,-20813
14523,0.0,0.0,0.0,2485,58092,37275,-20817
14524,0.0,0.0,0.0,2485,58096,37275,-20821
14525,1.0,1.0,0.6666666666666666,2486,58100,37290,-20810
14526,0.0,0.0,0.0,2486,58104,37290,-20814
14527,1.0,1.0,1.0,2487,58108,37305,-20803
14528,0.0,0.0,0.0,2487,58112,37305,-20807
14529,1.0,0.0,0.4,2488,58116,37320,-20796
14530,0.0,0.0,0.0,2488,58120,37320,-20800
14531,0.0,0.0,0.0,2488,58124,37320,-20804
14532,0.0,0.0,0.3333333333333333,2488,58128,37320,-20808
14533,0.0,0.0,0.0,2488,58132,37320,-20812
14534,0.0,0.0,0.0,2488,58136,37320,-20816
14535,0.0,0.0,0.0,2488,58140,37320,-20820
14536,1.0,1.0,1.0,2489,58144,37335,-20809
14537,0.0,0.0,0.0,2489,58148,37335,-20813
14538,0.0,0.0,0.0,2489,58152,37335,-20817
14539,0.0,0.0,0.0,2489,58156,37335,-20821
14540,0.0,0.0,0.0,2489,58160,37335,-20825
14541,0.0,0.0,0.0,2489,58164,37335,-20829
14542,0.0,0.0,0.0,2489,58168,37335,-20833
14543,0.0,0.0,0.0,2489,58172,37335,-20837
14544,0.0,0.0,0.0,2489,58176,37335,-20841
14545,1.0,1.0,1.0,2490,58180,37350,-20830
14546,1.0,1.0,0.6,2491,58184,37365,-20819
14547,0.0,0.0,0.0,2491,58188,37365,-20823
14548,0.0,0.0,0.0,2491,58192,37365,-20827
14549,0.0,0.0,0.0,2491,58196,37365,-20831
14550,1.0,1.0,0.8,2492,58200,37380,-20820
14551,0.0,1.0,0.8,2492,58204,37380,-20824
14552,0.0,0.0,0.0,2492,58208,37380,-20828
14553,0.0,0.0,0.0,2492,58212,37380,-20832
14554,0.0,0.0,0.0,2492,58216,37380,-20836
14555,0.0,0.0,0.0,2492,58220,37380,-20840
14556,0.0,0.0,0.0,2492,58224,37380,-20844
14557,0.0,0.0,0.0,2492,58228,37380,-20848
14558,0.0,0.0,0.0,2492,58232,37380,-20852
14559,0.0,0.0,0.0,2492,58236,37380,-20856
14560,0.0,0.0,0.0,2492,58240,37380,-20860
14561,0.0,0.0,0.0,2492,58244,37380,-20864
14562,0.0,0.0,0.0,2492,58248,37380,-20868
14563,0.0,0.0,0.0,2492,58252,37380,-20872
14564,0.0,0.0,0.0,2492,58256,37380,-20876
14565,0.0,0.0,0.0,2492,58260,37380,-20880
14566,0.0,0.0,0.0,2492,58264,37380,-20884
14567,0.0,0.0,0.0,2492,58268,37380,-20888
14568,0.0,0.0,0.0,2492,58272,37380,-20892
14569,0.0,0.0,0.0,2492,58276,37380,-20896
14570,0.0,0.0,0.0,2492,58280,37380,-20900
14571,0.0,0.0,0.0,2492,58284,37380,-20904
14572,0.0,0.0,0.0,2492,58288,37380,-20908
14573,1.0,1.0,1.0,2493,58292,37395,-20897
14574,0.0,0.0,0.0,2493,58296,37395,-20901
14575,0.0,0.0,0.0,2493,58300,37395,-20905
14576,0.0,0.0,0.0,2493,58304,37395,-20909
14577,0.0,0.0,0.0,2493,58308,37395,-20913
14578,0.0,0.0,0.0,2493,58312,37395,-20917
14579,0.0,0.0,0.0,2493,58316,37395,-20921
14580,0.0,0.0,0.0,2493,58320,37395,-20925
14581,1.0,1.0,1.0,2494,58324,37410,-20914
14582,0.0,0.0,0.0,2494,58328,37410,-20918
14583,0.0,0.0,0.0,2494,58332,37410,-20922
14584,0.0,0.0,0.0,2494,58336,37410,-20926
14585,0.0,0.0,0.0,2494,58340,37410,-20930
14586,1.0,1.0,1.0,2495,58344,37425,-20919
14587,0.0,0.0,0.0,2495,58348,37425,-20923
14588,1.0,1.0,1.0,2496,58352,37440,-20912
14589,0.0,0.0,0.0,2496,58356,37440,-20916
14590,0.0,0.0,0.0,2496,58360,37440,-20920
14591,1.0,1.0,1.0,2497,58364,37455,-20909
14592,0.0,0.0,0.0,2497,58368,37455,-20913
14593,0.0,0.0,0.0,2497,58372,37455,-20917
14594,0.0,0.0,0.0,2497,58376,37455,-20921
14595,0.0,1.0,0.8,2497,58380,37455,-20925
14596,0.0,0.0,0.0,2497,58384,37455,-20929
14597,0.0,0.0,0.0,2497,58388,37455,-20933
14598,0.0,0.0,0.0,2497,58392,37455,-20937
14599,0.0,0.0,0.0,2497,58396,37455,-20941
14600,0.0,0.0,0.0,2497,58400,37455,-20945
14601,0.0,0.0,0.0,2497,58404,37455,-20949
14602,0.0,0.0,0.0,2497,58408,37455,-20953
14603,0.0,0.0,0.0,2497,58412,37455,-20957
14604,0.0,0.0,0.0,2497,58416,37455,-20961
14605,0.0,0.0,0.0,2497,58420,37455,-20965
14606,0.0,0.0,0.0,2497,58424,37455,-20969
14607,0.0,0.0,0.0,2497,58428,37455,-20973
14608,1.0,1.0,1.0,2498,58432,37470,-20962
14609,1.0,1.0,1.0,2499,58436,37485,-20951
14610,0.0,0.0,0.0,2499,58440,37485,-20955
14611,0.0,1.0,0.6666666666666666,2499,58444,37485,-20959
14612,0.0,0.0,0.0,2499,58448,37485,-20963
14613,1.0,1.0,1.0,2500,58452,37500,-20952
14614,0.0,0.0,0.0,2500,58456,37500,-20956
14615,1.0,1.0,1.0,2501,58460,37515,-20945
14616,0.0,0.0,0.0,2501,58464,37515,-20949
14617,0.0,0.0,0.0,2501,58468,37515,-20953
14618,0.0,0.0,0.0,2501,58472,37515,-20957
14619,0.0,0.0,0.0,2501,58476,37515,-20961
14620,0.0,0.0,0.0,2501,58480,37515,-20965
14621,0.0,0.0,0.0,2501,58484,37515,-20969
14622,0.0,0.0,0.0,2501,58488,37515,-20973
14623,0.0,0.0,0.0,2501,58492,37515,-20977
14624,0.0,0.0,0.0,2501,58496,37515,-20981
14625,0.0,0.0,0.0,2501,58500,37515,-20985
14626,0.0,0.0,0.0,2501,58504,37515,-20989
14627,0.0,0.0,0.0,2501,58508,37515,-20993
14628,0.0,0.0,0.0,2501,58512,37515,-20997
14629,0.0,0.0,0.0,2501,58516,37515,-21001
14630,0.0,0.0,0.0,2501,58520,37515,-21005
14631,0.0,0.0,0.0,2501,58524,37515,-21009
14632,0.0,0.0,0.0,2501,58528,37515,-21013
14633,1.0,1.0,1.0,2502,58532,37530,-21002
14634,0.0,0.0,0.0,2502,58536,37530,-21006
14635,1.0,1.0,1.0,2503,58540,37545,-20995
14636,0.0,0.0,0.0,2503,58544,37545,-20999
14637,1.0,1.0,1.0,2504,58548,37560,-20988
14638,0.0,0.0,0.0,2504,58552,37560,-20992
14639,0.0,0.0,0.0,2504,58556,37560,-20996
14640,0.0,0.0,0.0,2504,58560,37560,-21000
14641,0.0,0.0,0.0,2504,58564,37560,-21004
14642,0.0,0.0,0.0,2504,58568,37560,-21008
14643,0.0,0.0,0.0,2504,58572,37560,-21012
14644,1.0,1.0,1.0,2505,58576,37575,-21001
14645,0.0,0.0,0.0,2505,58580,37575,-21005
14646,1.0,1.0,1.0,2506,58584,37590,-20994
14647,0.0,0.0,0.0,2506,58588,37590,-20998
14648,0.0,0.0,0.0,2506,58592,37590,-21002
14649,1.0,1.0,1.0,2507,58596,37605,-20991
14650,0.0,0.0,0.0,2507,58600,37605,-20995
14651,1.0,1.0,1.0,2508,58604,37620,-20984
14652,1.0,1.0,0.6,2509,58608,37635,-20973
14653,1.0,1.0,1.0,2510,58612,37650,-20962
14654,0.0,0.0,0.0,2510,58616,37650,-20966
14655,0.0,0.0,0.0,2510,58620,37650,-20970
14656,0.0,0.0,0.0,2510,58624,37650,-20974
14657,1.0,1.0,1.0,2511,58628,37665,-20963
14658,0.0,0.0,0.0,2511,58632,37665,-20967
14659,0.0,0.0,0.0,2511,58636,37665,-20971
14660,1.0,1.0,1.0,2512,58640,37680,-20960
14661,0.0,0.0,0.0,2512,58644,37680,-20964
14662,0.0,0.0,0.0,2512,58648,37680,-20968
14663,0.0,0.0,0.0,2512,58652,37680,-20972
14664,0.0,0.0,0.0,2512,58656,37680,-20976
14665,0.0,0.0,0.25,2512,58660,37680,-20980
14666,0.0,0.0,0.0,2512,58664,37680,-20984
14667,0.0,0.0,0.0,2512,58668,37680,-20988
14668,0.0,0.0,0.0,2512,58672,37680,-20992
14669,0.0,0.0,0.0,2512,58676,37680,-20996
14670,0.0,0.0,0.0,2512,58680,37680,-21000
14671,1.0,1.0,1.0,2513,58684,37695,-20989
14672,0.0,0.0,0.0,2513,58688,37695,-20993
14673,0.0,0.0,0.0,2513,58692,37695,-20997
14674,0.0,0.0,0.0,2513,58696,37695,-21001
14675,0.0,0.0,0.0,2513,58700,37695,-21005
14676,1.0,1.0,1.0,2514,58704,37710,-20994
14677,0.0,0.0,0.3333333333333333,2514,58708,37710,-20998
14678,0.0,0.0,0.0,2514,58712,37710,-21002
14679,0.0,0.0,0.0,2514,58716,37710,-21006
14680,0.0,0.0,0.0,2514,58720,37710,-21010
14681,1.0,0.0,0.2,2515,58724,37725,-20999
14682,0.0,0.0,0.0,2515,58728,37725,-21003
14683,0.0,0.0,0.0,2515,58732,37725,-21007
14684,0.0,0.0,0.0,2515,58736,37725,-21011
14685,0.0,0.0,0.0,2515,58740,37725,-21015
14686,0.0,0.0,0.0,2515,58744,37725,-21019
14687,0.0,0.0,0.0,2515,58748,37725,-21023
14688,0.0,0.0,0.0,2515,58752,37725,-21027
14689,0.0,0.0,0.0,2515,58756,37725,-21031
14690,0.0,0.0,0.0,2515,58760,37725,-21035
14691,0.0,0.0,0.0,2515,58764,37725,-21039
14692,1.0,1.0,1.0,2516,58768,37740,-21028
14693,0.0,0.0,0.0,2516,58772,37740,-21032
14694,0.0,1.0,0.6666666666666666,2516,58776,37740,-21036
14695,0.0,0.0,0.0,2516,58780,37740,-21040
14696,1.0,1.0,1.0,2517,58784,37755,-21029
14697,0.0,0.0,0.0,2517,58788,37755,-21033
14698,0.0,0.0,0.0,2517,58792,37755,-21037
14699,0.0,0.0,0.0,2517,58796,37755,-21041
14700,0.0,0.0,0.0,2517,58800,37755,-21045
14701,0.0,0.0,0.0,2517,58804,37755,-21049
14702,0.0,0.0,0.0,2517,58808,37755,-21053
14703,0.0,0.0,0.0,2517,58812,37755,-21057
14704,0.0,0.0,0.0,2517,58816,37755,-21061
14705,0.0,0.0,0.0,2517,58820,37755,-21065
14706,0.0,0.0,0.0,2517,58824,37755,-21069
14707,0.0,0.0,0.0,2517,58828,37755,-21073
14708,0.0,0.0,0.0,2517,58832,37755,-21077
14709,0.0,0.0,0.0,2517,58836,37755,-21081
14710,0.0,0.0,0.0,2517,58840,37755,-21085
14711,0.0,0.0,0.0,2517,58844,37755,-21089
14712,0.0,0.0,0.0,2517,58848,37755,-21093
14713,0.0,0.0,0.0,2517,58852,37755,-21097
14714,0.0,0.0,0.0,2517,58856,37755,-21101
14715,0.0,0.0,0.0,2517,58860,37755,-21105
14716,0.0,0.0,0.0,2517,58864,37755,-21109
14717,0.0,0.0,0.0,2517,58868,37755,-21113
14718,0.0,0.0,0.0,2517,58872,37755,-21117
14719,0.0,0.0,0.0,2517,58876,37755,-21121
14720,0.0,0.0,0.0,2517,58880,37755,-21125
14721,1.0,1.0,1.0,2518,58884,37770,-21114
14722,0.0,0.0,0.0,2518,58888,37770,-21118
14723,0.0,0.0,0.0,2518,58892,37770,-21122
14724,0.0,0.0,0.0,2518,58896,37770,-21126
14725,0.0,0.0,0.0,2518,58900,37770,-21130
14726,0.0,0.0,0.0,2518,58904,37770,-21134
14727,0.0,0.0,0.0,2518,58908,37770,-21138
14728,0.0,0.0,0.0,2518,58912,37770,-21142
14729,0.0,0.0,0.0,2518,58916,37770,-21146
14730,0.0,0.0,0.0,2518,58920,37770,-21150
14731,0.0,0.0,0.0,2518,58924,37770,-21154
14732,0.0,0.0,0.0,2518,58928,37770,-21158
14733,0.0,0.0,0.0,2518,58932,37770,-21162
14734,0.0,0.0,0.0,2518,58936,37770,-21166
14735,0.0,0.0,0.4,2518,58940,37770,-21170
14736,0.0,0.0,0.0,2518,58944,37770,-21174
14737,0.0,0.0,0.0,2518,58948,37770,-21178
14738,0.0,0.0,0.0,2518,58952,37770,-21182
14739,0.0,0.0,0.0,2518,58956,37770,-21186
14740,0.0,0.0,0.0,2518,58960,37770,-21190
14741,0.0,0.0,0.0,2518,58964,37770,-21194
14742,1.0,1.0,1.0,2519,58968,37785,-21183
14743,0.0,0.0,0.0,2519,58972,37785,-21187
14744,0.0,0.0,0.0,2519,58976,37785,-21191
14745,0.0,0.0,0.0,2519,58980,37785,-21195
14746,0.0,0.0,0.0,2519,58984,37785,-21199
14747,0.0,0.0,0.0,2519,58988,37785,-21203
14748,0.0,0.0,0.0,2519,58992,37785,-21207
14749,0.0,0.0,0.0,2519,58996,37785,-21211
14750,0.0,0.0,0.0,2519,59000,37785,-21215
14751,0.0,0.0,0.0,2519,59004,37785,-21219
14752,0.0,0.0,0.0,2519,59008,37785,-21223
14753,0.0,0.0,0.0,2519,59012,37785,-21227
14754,0.0,0.0,0.0,2519,59016,37785,-21231
14755,0.0,0.0,0.3333333333333333,2519,59020,37785,-21235
14756,0.0,0.0,0.0,2519,59024,37785,-21239
14757,0.0,0.0,0.0,2519,59028,37785,-21243
14758,0.0,0.0,0.0,2519,59032,37785,-21247
14759,0.0,0.0,0.0,2519,59036,37785,-21251
14760,0.0,0.0,0.0,2519,59040,37785,-21255
14761,1.0,1.0,1.0,2520,59044,37800,-21244
14762,0.0,0.0,0.0,2520,59048,37800,-21248
14763,0.0,0.0,0.0,2520,59052,37800,-21252
14764,0.0,0.0,0.0,2520,59056,37800,-21256
14765,1.0,1.0,1.0,2521,59060,37815,-21245
14766,0.0,0.0,0.0,2521,59064,37815,-21249
14767,0.0,0.0,0.0,2521,59068,37815,-21253
14768,0.0,0.0,0.25,2521,59072,37815,-21257
14769,0.0,0.0,0.0,2521,59076,37815,-21261
14770,0.0,0.0,0.0,2521,59080,37815,-21265
14771,0.0,0.0,0.0,2521,59084,37815,-21269
14772,0.0,0.0,0.0,2521,59088,37815,-21273
14773,0.0,0.0,0.0,2521,59092,37815,-21277
14774,0.0,0.0,0.0,2521,59096,37815,-21281
14775,0.0,0.0,0.0,2521,59100,37815,-21285
14776,1.0,1.0,1.0,2522,59104,37830,-21274
14777,0.0,0.0,0.0,2522,59108,37830,-21278
14778,0.0,0.0,0.25,2522,59112,37830,-21282
14779,0.0,0.0,0.0,2522,59116,37830,-21286
14780,0.0,1.0,0.6,2522,59120,37830,-21290
14781,0.0,0.0,0.0,2522,59124,37830,-21294
14782,0.0,0.0,0.0,2522,59128,37830,-21298
14783,0.0,0.0,0.0,2522,59132,37830,-21302
14784,0.0,0.0,0.0,2522,59136,37830,-21306
14785,0.0,0.0,0.0,2522,59140,37830,-21310
14786,0.0,0.0,0.0,2522,59144,37830,-21314
14787,0.0,0.0,0.0,2522,59148,37830,-21318
14788,0.0,0.0,0.0,2522,59152,37830,-21322
14789,0.0,0.0,0.0,2522,59156,37830,-21326
14790,0.0,0.0,0.0,2522,59160,37830,-21330
14791,1.0,1.0,0.75,2523,59164,37845,-21319
14792,0.0,0.0,0.0,2523,59168,37845,-21323
14793,0.0,0.0,0.0,2523,59172,37845,-21327
14794,0.0,0.0,0.0,2523,59176,37845,-21331
14795,0.0,0.0,0.0,2523,59180,37845,-21335
14796,0.0,0.0,0.0,2523,59184,37845,-21339
14797,0.0,0.0,0.0,2523,59188,37845,-21343
14798,0.0,0.0,0.0,2523,59192,37845,-21347
14799,0.0,0.0,0.0,2523,59196,37845,-21351
14800,0.0,0.0,0.0,2523,59200,37845,-21355
14801,0.0,0.0,0.0,2523,59204,37845,-21359
14802,0.0,0.0,0.0,2523,59208,37845,-21363
14803,0.0,0.0,0.0,2523,59212,37845,-21367
14804,0.0,0.0,0.0,2523,59216,37845,-21371
14805,0.0,0.0,0.0,2523,59220,37845,-21375
14806,0.0,0.0,0.0,2523,59224,37845,-21379
14807,0.0,0.0,0.0,2523,59228,37845,-21383
14808,1.0,1.0,1.0,2524,59232,37860,-21372
14809,1.0,1.0,0.6666666666666666,2525,59236,37875,-21361
14810,0.0,0.0,0.0,2525,59240,37875,-21365
14811,0.0,0.0,0.0,2525,59244,37875,-21369
14812,0.0,0.0,0.0,2525,59248,37875,-21373
14813,0.0,0.0,0.0,2525,59252,37875,-21377
14814,1.0,1.0,1.0,2526,59256,37890,-21366
14815,0.0,0.0,0.0,2526,59260,37890,-21370
14816,0.0,0.0,0.0,2526,59264,37890,-21374
14817,1.0,1.0,1.0,2527,59268,37905,-21363
14818,0.0,0.0,0.0,2527,59272,37905,-21367
14819,0.0,0.0,0.0,2527,59276,37905,-21371
14820,0.0,0.0,0.0,2527,59280,37905,-21375
14821,1.0,1.0,0.6666666666666666,2528,59284,37920,-21364
14822,1.0,1.0,1.0,2529,59288,37935,-21353
14823,0.0,0.0,0.0,2529,59292,37935,-21357
14824,0.0,0.0,0.0,2529,59296,37935,-21361
14825,0.0,0.0,0.0,2529,59300,37935,-21365
14826,0.0,0.0,0.0,2529,59304,37935,-21369
14827,0.0,0.0,0.0,2529,59308,37935,-21373
14828,0.0,0.0,0.0,2529,59312,37935,-21377
14829,0.0,0.0,0.0,2529,59316,37935,-21381
14830,0.0,0.0,0.0,2529,59320,37935,-21385
14831,0.0,0.0,0.0,2529,59324,37935,-21389
14832,0.0,0.0,0.0,2529,59328,37935,-21393
14833,0.0,0.0,0.0,2529,59332,37935,-21397
14834,0.0,0.0,0.0,2529,59336,37935,-21401
14835,0.0,0.0,0.0,2529,59340,37935,-21405
14836,0.0,0.0,0.0,2529,59344,37935,-21409
14837,0.0,0.0,0.0,2529,59348,37935,-21413
14838,0.0,0.0,0.0,2529,59352,37935,-21417
14839,0.0,0.0,0.0,2529,59356,37935,-21421
14840,0.0,0.0,0.0,2529,59360,37935,-21425
14841,0.0,0.0,0.0,2529,59364,37935,-21429
14842,0.0,0.0,0.0,2529,59368,37935,-21433
14843,0.0,0.0,0.0,2529,59372,37935,-21437
14844,0.0,0.0,0.0,2529,59376,37935,-21441
14845,0.0,0.0,0.0,2529,59380,37935,-21445
14846,0.0,0.0,0.0,2529,59384,37935,-21449
14847,0.0,0.0,0.0,2529,59388,37935,-21453
14848,0.0,0.0,0.0,2529,59392,37935,-21457
14849,0.0,0.0,0.0,2529,59396,37935,-21461
14850,0.0,0.0,0.0,2529,59400,37935,-21465
14851,0.0,0.0,0.0,2529,59404,37935,-21469
14852,0.0,0.0,0.0,2529,59408,37935,-21473
14853,0.0,0.0,0.0,2529,59412,37935,-21477
14854,0.0,0.0,0.0,2529,59416,37935,-21481
14855,0.0,0.0,0.0,2529,59420,37935,-21485
14856,0.0,0.0,0.0,2529,59424,37935,-21489
14857,0.0,0.0,0.0,2529,59428,37935,-21493
14858,0.0,0.0,0.0,2529,59432,37935,-21497
14859,0.0,0.0,0.0,2529,59436,37935,-21501
14860,0.0,0.0,0.0,2529,59440,37935,-21505
14861,0.0,0.0,0.0,2529,59444,37935,-21509
14862,0.0,0.0,0.0,2529,59448,37935,-21513
14863,0.0,1.0,0.75,2529,59452,37935,-21517
14864,0.0,0.0,0.0,2529,59456,37935,-21521
14865,1.0,0.0,0.3333333333333333,2530,59460,37950,-21510
14866,0.0,0.0,0.0,2530,59464,37950,-21514
14867,0.0,0.0,0.25,2530,59468,37950,-21518
14868,1.0,1.0,0.6666666666666666,2531,59472,37965,-21507
14869,0.0,0.0,0.0,2531,59476,37965,-21511
14870,0.0,0.0,0.0,2531,59480,37965,-21515
14871,0.0,0.0,0.0,2531,59484,37965,-21519
14872,0.0,0.0,0.0,2531,59488,37965,-21523
14873,1.0,1.0,0.6666666666666666,2532,59492,37980,-21512
14874,0.0,0.0,0.3333333333333333,2532,59496,37980,-21516
14875,0.0,0.0,0.0,2532,59500,37980,-21520
14876,0.0,0.0,0.0,2532,59504,37980,-21524
14877,1.0,1.0,1.0,2533,59508,37995,-21513
14878,0.0,0.0,0.0,2533,59512,37995,-21517
14879,0.0,0.0,0.0,2533,59516,37995,-21521
14880,1.0,1.0,1.0,2534,59520,38010,-21510
14881,0.0,0.0,0.0,2534,59524,38010,-21514
14882,0.0,0.0,0.0,2534,59528,38010,-21518
14883,0.0,0.0,0.0,2534,59532,38010,-21522
14884,0.0,0.0,0.0,2534,59536,38010,-21526
14885,0.0,0.0,0.0,2534,59540,38010,-21530
14886,1.0,1.0,1.0,2535,59544,38025,-21519
14887,0.0,0.0,0.0,2535,59548,38025,-21523
14888,0.0,0.0,0.0,2535,59552,38025,-21527
14889,0.0,0.0,0.0,2535,59556,38025,-21531
14890,1.0,1.0,1.0,2536,59560,38040,-21520
14891,0.0,0.0,0.0,2536,59564,38040,-21524
14892,0.0,0.0,0.0,2536,59568,38040,-21528
14893,0.0,0.0,0.0,2536,59572,38040,-21532
14894,0.0,0.0,0.0,2536,59576,38040,-21536
14895,1.0,1.0,0.6,2537,59580,38055,-21525
14896,0.0,0.0,0.0,2537,59584,38055,-21529
14897,0.0,0.0,0.0,2537,59588,38055,-21533
14898,0.0,0.0,0.0,2537,59592,38055,-21537
14899,0.0,0.0,0.0,2537,59596,38055,-21541
14900,0.0,0.0,0.0,2537,59600,38055,-21545
14901,0.0,0.0,0.0,2537,59604,38055,-21549
14902,1.0,0.0,0.3333333333333333,2538,59608,38070,-21538
14903,0.0,0.0,0.0,2538,59612,38070,-21542
14904,0.0,0.0,0.0,2538,59616,38070,-21546
14905,0.0,0.0,0.0,2538,59620,38070,-21550
14906,0.0,0.0,0.0,2538,59624,38070,-21554
14907,0.0,0.0,0.0,2538,59628,38070,-21558
14908,0.0,0.0,0.0,2538,59632,38070,-21562
14909,0.0,0.0,0.0,2538,59636,38070,-21566
14910,0.0,0.0,0.0,2538,59640,38070,-21570
14911,0.0,0.0,0.0,2538,59644,38070,-21574
14912,0.0,0.0,0.0,2538,59648,38070,-21578
14913,0.0,0.0,0.3333333333333333,2538,59652,38070,-21582
14914,0.0,0.0,0.0,2538,59656,38070,-21586
14915,0.0,0.0,0.0,2538,59660,38070,-21590
14916,0.0,0.0,0.0,2538,59664,38070,-21594
14917,0.0,0.0,0.0,2538,59668,38070,-21598
14918,0.0,0.0,0.0,2538,59672,38070,-21602
14919,1.0,0.0,0.3333333333333333,2539,59676,38085,-21591
14920,0.0,0.0,0.0,2539,59680,38085,-21595
14921,0.0,0.0,0.0,2539,59684,38085,-21599
14922,0.0,0.0,0.2,2539,59688,38085,-21603
14923,0.0,0.0,0.0,2539,59692,38085,-21607
14924,0.0,0.0,0.0,2539,59696,38085,-21611
14925,1.0,1.0,1.0,2540,59700,38100,-21600
14926,1.0,1.0,1.0,2541,59704,38115,-21589
14927,1.0,0.0,0.2,2542,59708,38130,-21578
14928,1.0,1.0,1.0,2543,59712,38145,-21567
14929,0.0,1.0,0.6666666666666666,2543,59716,38145,-21571
14930,0.0,0.0,0.0,2543,59720,38145,-21575
14931,0.0,0.0,0.0,2543,59724,38145,-21579
14932,1.0,1.0,1.0,2544,59728,38160,-21568
14933,0.0,0.0,0.0,2544,59732,38160,-21572
14934,0.0,0.0,0.0,2544,59736,38160,-21576
14935,0.0,0.0,0.0,2544,59740,38160,-21580
14936,0.0,0.0,0.0,2544,59744,38160,-21584
14937,0.0,0.0,0.0,2544,59748,38160,-21588
14938,0.0,0.0,0.0,2544,59752,38160,-21592
14939,0.0,0.0,0.0,2544,59756,38160,-21596
14940,0.0,0.0,0.0,2544,59760,38160,-21600
14941,0.0,0.0,0.0,2544,59764,38160,-21604
14942,0.0,0.0,0.0,2544,59768,38160,-21608
14943,0.0,0.0,0.0,2544,59772,38160,-21612
14944,0.0,0.0,0.0,2544,59776,38160,-21616
14945,0.0,0.0,0.3333333333333333,2544,59780,38160,-21620
14946,0.0,0.0,0.0,2544,59784,38160,-21624
14947,0.0,0.0,0.0,2544,59788,38160,-21628
14948,0.0,0.0,0.0,2544,59792,38160,-21632
14949,0.0,0.0,0.0,2544,59796,38160,-21636
14950,0.0,0.0,0.0,2544,59800,38160,-21640
14951,0.0,0.0,0.0,2544,59804,38160,-21644
14952,0.0,0.0,0.0,2544,59808,38160,-21648
14953,0.0,0.0,0.0,2544,59812,38160,-21652
14954,1.0,1.0,1.0,2545,59816,38175,-21641
14955,0.0,0.0,0.0,2545,59820,38175,-21645
14956,0.0,0.0,0.0,2545,59824,38175,-21649
14957,0.0,0.0,0.0,2545,59828,38175,-21653
14958,0.0,0.0,0.0,2545,59832,38175,-21657
14959,0.0,0.0,0.0,2545,59836,38175,-21661
14960,0.0,0.0,0.0,2545,59840,38175,-21665
14961,0.0,0.0,0.0,2545,59844,38175,-21669
14962,0.0,0.0,0.0,2545,59848,38175,-21673
14963,0.0,0.0,0.0,2545,59852,38175,-21677
14964,0.0,0.0,0.0,2545,59856,38175,-21681
14965,0.0,0.0,0.0,2545,59860,38175,-21685
14966,0.0,0.0,0.0,2545,59864,38175,-21689
14967,0.0,0.0,0.0,2545,59868,38175,-21693
14968,0.0,0.0,0.0,2545,59872,38175,-21697
14969,0.0,0.0,0.0,2545,59876,38175,-21701
14970,1.0,1.0,0.8,2546,59880,38190,-21690
14971,0.0,0.0,0.0,2546,59884,38190,-21694
14972,1.0,1.0,1.0,2547,59888,38205,-21683
14973,0.0,0.0,0.0,2547,59892,38205,-21687
14974,0.0,0.0,0.0,2547,59896,38205,-21691
14975,0.0,0.0,0.0,2547,59900,38205,-21695
14976,0.0,1.0,0.6666666666666666,2547,59904,38205,-21699
14977,1.0,1.0,1.0,2548,59908,38220,-21688
14978,0.0,0.0,0.0,2548,59912,38220,-21692
14979,1.0,1.0,1.0,2549,59916,38235,-21681
14980,0.0,0.0,0.0,2549,59920,38235,-21685
14981,1.0,0.0,0.3333333333333333,2550,59924,38250,-21674
14982,1.0,1.0,1.0,2551,59928,38265,-21663
14983,0.0,0.0,0.0,2551,59932,38265,-21667
14984,0.0,0.0,0.0,2551,59936,38265,-21671
14985,0.0,0.0,0.0,2551,59940,38265,-21675
14986,0.0,0.0,0.0,2551,59944,38265,-21679
14987,0.0,0.0,0.0,2551,59948,38265,-21683
14988,0.0,0.0,0.0,2551,59952,38265,-21687
14989,0.0,0.0,0.0,2551,59956,38265,-21691
14990,1.0,1.0,0.8,2552,59960,38280,-21680
14991,0.0,0.0,0.0,2552,59964,38280,-21684
14992,0.0,0.0,0.0,2552,59968,38280,-21688
14993,1.0,1.0,1.0,2553,59972,38295,-21677
14994,1.0,1.0,0.6666666666666666,2554,59976,38310,-21666
14995,0.0,0.0,0.0,2554,59980,38310,-21670
14996,0.0,0.0,0.0,2554,59984,38310,-21674
14997,0.0,0.0,0.0,2554,59988,38310,-21678
14998,1.0,1.0,1.0,2555,59992,38325,-21667
14999,1.0,1.0,1.0,2556,59996,38340,-21656
15000,0.0,0.0,0.0,2556,60000,38340,-21660
15001,0.0,0.0,0.0,2556,60004,38340,-21664
15002,0.0,0.0,0.0,2556,60008,38340,-21668
15003,0.0,0.0,0.0,2556,60012,38340,-21672
15004,0.0,0.0,0.0,2556,60016,38340,-21676
15005,0.0,0.0,0.0,2556,60020,38340,-21680
15006,0.0,0.0,0.0,2556,60024,38340,-21684
15007,0.0,0.0,0.0,2556,60028,38340,-21688
15008,0.0,0.0,0.0,2556,60032,38340,-21692
15009,0.0,0.0,0.0,2556,60036,38340,-21696
15010,0.0,0.0,0.0,2556,60040,38340,-21700
15011,1.0,1.0,1.0,2557,60044,38355,-21689
15012,0.0,0.0,0.0,2557,60048,38355,-21693
15013,0.0,1.0,0.75,2557,60052,38355,-21697
15014,0.0,0.0,0.0,2557,60056,38355,-21701
15015,0.0,0.0,0.0,2557,60060,38355,-21705
15016,1.0,1.0,1.0,2558,60064,38370,-21694
15017,0.0,0.0,0.0,2558,60068,38370,-21698
15018,0.0,0.0,0.0,2558,60072,38370,-21702
15019,0.0,0.0,0.0,2558,60076,38370,-21706
15020,0.0,0.0,0.0,2558,60080,38370,-21710
15021,0.0,0.0,0.0,2558,60084,38370,-21714
15022,0.0,0.0,0.3333333333333333,2558,60088,38370,-21718
15023,0.0,0.0,0.0,2558,60092,38370,-21722
15024,0.0,0.0,0.0,2558,60096,38370,-21726
15025,0.0,0.0,0.0,2558,60100,38370,-21730
15026,0.0,0.0,0.0,2558,60104,38370,-21734
15027,0.0,0.0,0.0,2558,60108,38370,-21738
15028,0.0,0.0,0.0,2558,60112,38370,-21742
15029,0.0,0.0,0.0,2558,60116,38370,-21746
15030,0.0,0.0,0.0,2558,60120,38370,-21750
15031,0.0,0.0,0.0,2558,60124,38370,-21754
15032,0.0,0.0,0.0,2558,60128,38370,-21758
15033,1.0,1.0,1.0,2559,60132,38385,-21747
15034,0.0,0.0,0.0,2559,60136,38385,-21751
15035,0.0,0.0,0.0,2559,60140,38385,-21755
15036,1.0,1.0,1.0,2560,60144,38400,-21744
15037,0.0,0.0,0.3333333333333333,2560,60148,38400,-21748
15038,0.0,0.0,0.0,2560,60152,38400,-21752
15039,0.0,0.0,0.0,2560,60156,38400,-21756
15040,0.0,0.0,0.0,2560,60160,38400,-21760
15041,0.0,0.0,0.0,2560,60164,38400,-21764
15042,1.0,1.0,0.75,2561,60168,38415,-21753
15043,0.0,0.0,0.0,2561,60172,38415,-21757
15044,0.0,0.0,0.0,2561,60176,38415,-21761
15045,1.0,1.0,1.0,2562,60180,38430,-21750
15046,0.0,0.0,0.0,2562,60184,38430,-21754
15047,0.0,0.0,0.0,2562,60188,38430,-21758
15048,0.0,0.0,0.0,2562,60192,38430,-21762
15049,0.0,0.0,0.0,2562,60196,38430,-21766
15050,1.0,0.0,0.4,2563,60200,38445,-21755
15051,0.0,1.0,0.6666666666666666,2563,60204,38445,-21759
15052,0.0,0.0,0.0,2563,60208,38445,-21763
15053,0.0,0.0,0.0,2563,60212,38445,-21767
15054,0.0,0.0,0.2,2563,60216,38445,-21771
15055,0.0,0.0,0.0,2563,60220,38445,-21775
15056,1.0,1.0,1.0,2564,60224,38460,-21764
15057,0.0,0.0,0.0,2564,60228,38460,-21768
15058,1.0,1.0,1.0,2565,60232,38475,-21757
15059,0.0,0.0,0.0,2565,60236,38475,-21761
15060,0.0,0.0,0.0,2565,60240,38475,-21765
15061,0.0,0.0,0.0,2565,60244,38475,-21769
15062,0.0,0.0,0.0,2565,60248,38475,-21773
15063,0.0,0.0,0.0,2565,60252,38475,-21777
15064,0.0,0.0,0.0,2565,60256,38475,-21781
15065,0.0,0.0,0.0,2565,60260,38475,-21785
15066,0.0,0.0,0.0,2565,60264,38475,-21789
15067,0.0,0.0,0.0,2565,60268,38475,-21793
15068,1.0,1.0,0.8,2566,60272,38490,-21782
15069,0.0,0.0,0.0,2566,60276,38490,-21786
15070,1.0,1.0,1.0,2567,60280,38505,-21775
15071,0.0,0.0,0.0,2567,60284,38505,-21779
15072,0.0,0.0,0.0,2567,60288,38505,-21783
15073,1.0,1.0,1.0,2568,60292,38520,-21772
15074,0.0,0.0,0.0,2568,60296,38520,-21776
15075,0.0,0.0,0.0,2568,60300,38520,-21780
15076,0.0,0.0,0.0,2568,60304,38520,-21784
15077,0.0,0.0,0.0,2568,60308,38520,-21788
15078,0.0,0.0,0.0,2568,60312,38520,-21792
15079,0.0,0.0,0.0,2568,60316,38520,-21796
15080,0.0,0.0,0.0,2568,60320,38520,-21800
15081,0.0,0.0,0.0,2568,60324,38520,-21804
15082,0.0,0.0,0.0,2568,60328,38520,-21808
15083,0.0,0.0,0.0,2568,60332,38520,-21812
15084,0.0,0.0,0.0,2568,60336,38520,-21816
15085,0.0,0.0,0.0,2568,60340,38520,-21820
15086,0.0,0.0,0.0,2568,60344,38520,-21824
15087,0.0,0.0,0.0,2568,60348,38520,-21828
15088,0.0,0.0,0.0,2568,60352,38520,-21832
15089,0.0,0.0,0.0,2568,60356,38520,-21836
15090,1.0,0.0,0.3333333333333333,2569,60360,38535,-21825
15091,1.0,1.0,0.75,2570,60364,38550,-21814
15092,1.0,1.0,0.6666666666666666,2571,60368,38565,-21803
15093,0.0,0.0,0.0,2571,60372,38565,-21807
15094,0.0,0.0,0.0,2571,60376,38565,-21811
15095,0.0,0.0,0.0,2571,60380,38565,-21815
15096,0.0,0.0,0.0,2571,60384,38565,-21819
15097,0.0,0.0,0.0,2571,60388,38565,-21823
15098,0.0,0.0,0.0,2571,60392,38565,-21827
15099,1.0,1.0,1.0,2572,60396,38580,-21816
15100,0.0,0.0,0.0,2572,60400,38580,-21820
15101,1.0,1.0,1.0,2573,60404,38595,-21809
15102,0.0,0.0,0.25,2573,60408,38595,-21813
15103,0.0,0.0,0.0,2573,60412,38595,-21817
15104,0.0,0.0,0.3333333333333333,2573,60416,38595,-21821
15105,0.0,0.0,0.0,2573,60420,38595,-21825
15106,0.0,0.0,0.0,2573,60424,38595,-21829
15107,1.0,1.0,1.0,2574,60428,38610,-21818
15108,0.0,0.0,0.0,2574,60432,38610,-21822
15109,0.0,0.0,0.0,2574,60436,38610,-21826
15110,0.0,0.0,0.0,2574,60440,38610,-21830
15111,0.0,0.0,0.0,2574,60444,38610,-21834
15112,0.0,0.0,0.0,2574,60448,38610,-21838
15113,1.0,1.0,1.0,2575,60452,38625,-21827
15114,0.0,0.0,0.0,2575,60456,38625,-21831
15115,1.0,1.0,1.0,2576,60460,38640,-21820
15116,0.0,0.0,0.0,2576,60464,38640,-21824
15117,0.0,0.0,0.0,2576,60468,38640,-21828
15118,1.0,1.0,0.75,2577,60472,38655,-21817
15119,0.0,0.0,0.0,2577,60476,38655,-21821
15120,0.0,0.0,0.0,2577,60480,38655,-21825
15121,0.0,0.0,0.0,2577,60484,38655,-21829
15122,0.0,0.0,0.0,2577,60488,38655,-21833
15123,0.0,0.0,0.0,2577,60492,38655,-21837
15124,1.0,1.0,1.0,2578,60496,38670,-21826
15125,0.0,0.0,0.0,2578,60500,38670,-21830
15126,0.0,0.0,0.0,2578,60504,38670,-21834
15127,0.0,0.0,0.0,2578,60508,38670,-21838
15128,0.0,0.0,0.0,2578,60512,38670,-21842
15129,0.0,0.0,0.0,2578,60516,38670,-21846
15130,0.0,0.0,0.0,2578,60520,38670,-21850
15131,0.0,0.0,0.0,2578,60524,38670,-21854
15132,0.0,0.0,0.0,2578,60528,38670,-21858
15133,0.0,0.0,0.0,2578,60532,38670,-21862
15134,0.0,0.0,0.0,2578,60536,38670,-21866
15135,0.0,0.0,0.0,2578,60540,38670,-21870
15136,0.0,0.0,0.0,2578,60544,38670,-21874
15137,0.0,0.0,0.0,2578,60548,38670,-21878
15138,1.0,1.0,1.0,2579,60552,38685,-21867
15139,0.0,0.0,0.0,2579,60556,38685,-21871
15140,0.0,0.0,0.0,2579,60560,38685,-21875
15141,0.0,0.0,0.0,2579,60564,38685,-21879
15142,0.0,0.0,0.0,2579,60568,38685,-21883
15143,1.0,1.0,1.0,2580,60572,38700,-21872
15144,0.0,0.0,0.3333333333333333,2580,60576,38700,-21876
15145,0.0,0.0,0.0,2580,60580,38700,-21880
15146,0.0,0.0,0.0,2580,60584,38700,-21884
15147,0.0,0.0,0.0,2580,60588,38700,-21888
15148,0.0,1.0,0.6666666666666666,2580,60592,38700,-21892
15149,0.0,0.0,0.0,2580,60596,38700,-21896
15150,0.0,0.0,0.0,2580,60600,38700,-21900
15151,0.0,0.0,0.0,2580,60604,38700,-21904
15152,0.0,0.0,0.0,2580,60608,38700,-21908
15153,0.0,0.0,0.0,2580,60612,38700,-21912
15154,0.0,0.0,0.0,2580,60616,38700,-21916
15155,1.0,1.0,1.0,2581,60620,38715,-21905
15156,0.0,0.0,0.0,2581,60624,38715,-21909
15157,0.0,0.0,0.0,2581,60628,38715,-21913
15158,1.0,1.0,1.0,2582,60632,38730,-21902
15159,0.0,0.0,0.0,2582,60636,38730,-21906
15160,0.0,0.0,0.0,2582,60640,38730,-21910
15161,0.0,0.0,0.0,2582,60644,38730,-21914
15162,0.0,0.0,0.3333333333333333,2582,60648,38730,-21918
15163,1.0,1.0,1.0,2583,60652,38745,-21907
15164,0.0,0.0,0.0,2583,60656,38745,-21911
15165,0.0,0.0,0.0,2583,60660,38745,-21915
15166,0.0,0.0,0.0,2583,60664,38745,-21919
15167,0.0,0.0,0.0,2583,60668,38745,-21923
15168,0.0,0.0,0.0,2583,60672,38745,-21927
15169,1.0,1.0,1.0,2584,60676,38760,-21916
15170,0.0,0.0,0.3333333333333333,2584,60680,38760,-21920
15171,0.0,0.0,0.0,2584,60684,38760,-21924
15172,1.0,1.0,1.0,2585,60688,38775,-21913
15173,0.0,0.0,0.0,2585,60692,38775,-21917
15174,0.0,0.0,0.0,2585,60696,38775,-21921
15175,1.0,1.0,1.0,2586,60700,38790,-21910
15176,0.0,0.0,0.3333333333333333,2586,60704,38790,-21914
15177,0.0,0.0,0.0,2586,60708,38790,-21918
15178,0.0,0.0,0.0,2586,60712,38790,-21922
15179,0.0,0.0,0.0,2586,60716,38790,-21926
15180,0.0,0.0,0.0,2586,60720,38790,-21930
15181,0.0,0.0,0.0,2586,60724,38790,-21934
15182,0.0,0.0,0.0,2586,60728,38790,-21938
15183,0.0,0.0,0.0,2586,60732,38790,-21942
15184,0.0,0.0,0.0,2586,60736,38790,-21946
15185,0.0,0.0,0.0,2586,60740,38790,-21950
15186,0.0,0.0,0.0,2586,60744,38790,-21954
15187,1.0,1.0,1.0,2587,60748,38805,-21943
15188,0.0,0.0,0.0,2587,60752,38805,-21947
15189,0.0,0.0,0.0,2587,60756,38805,-21951
15190,1.0,1.0,0.6666666666666666,2588,60760,38820,-21940
15191,0.0,0.0,0.0,2588,60764,38820,-21944
15192,0.0,0.0,0.0,2588,60768,38820,-21948
15193,0.0,0.0,0.0,2588,60772,38820,-21952
15194,0.0,0.0,0.0,2588,60776,38820,-21956
15195,0.0,0.0,0.0,2588,60780,38820,-21960
15196,0.0,0.0,0.0,2588,60784,38820,-21964
15197,0.0,0.0,0.0,2588,60788,38820,-21968
15198,0.0,0.0,0.0,2588,60792,38820,-21972
15199,0.0,0.0,0.0,2588,60796,38820,-21976
15200,1.0,1.0,1.0,2589,60800,38835,-21965
15201,0.0,0.0,0.0,2589,60804,38835,-21969
15202,0.0,0.0,0.0,2589,60808,38835,-21973
15203,0.0,0.0,0.0,2589,60812,38835,-21977
15204,0.0,0.0,0.3333333333333333,2589,60816,38835,-21981
15205,0.0,0.0,0.0,2589,60820,38835,-21985
15206,0.0,0.0,0.0,2589,60824,38835,-21989
15207,0.0,0.0,0.0,2589,60828,38835,-21993
15208,0.0,0.0,0.0,2589,60832,38835,-21997
15209,0.0,0.0,0.0,2589,60836,38835,-22001
15210,1.0,1.0,1.0,2590,60840,38850,-21990
15211,0.0,0.0,0.0,2590,60844,38850,-21994
15212,0.0,0.0,0.0,2590,60848,38850,-21998
15213,0.0,0.0,0.0,2590,60852,38850,-22002
15214,0.0,0.0,0.0,2590,60856,38850,-22006
15215,0.0,0.0,0.0,2590,60860,38850,-22010
15216,0.0,0.0,0.0,2590,60864,38850,-22014
15217,0.0,0.0,0.0,2590,60868,38850,-22018
15218,0.0,0.0,0.0,2590,60872,38850,-22022
15219,0.0,0.0,0.25,2590,60876,38850,-22026
15220,1.0,1.0,1.0,2591,60880,38865,-22015
15221,0.0,0.0,0.0,2591,60884,38865,-22019
15222,0.0,0.0,0.0,2591,60888,38865,-22023
15223,0.0,0.0,0.5,2591,60892,38865,-22027
15224,0.0,0.0,0.0,2591,60896,38865,-22031
15225,0.0,0.0,0.0,2591,60900,38865,-22035
15226,0.0,0.0,0.0,2591,60904,38865,-22039
15227,0.0,0.0,0.0,2591,60908,38865,-22043
15228,1.0,1.0,1.0,2592,60912,38880,-22032
15229,0.0,0.0,0.0,2592,60916,38880,-22036
15230,0.0,0.0,0.0,2592,60920,38880,-22040
15231,1.0,1.0,1.0,2593,60924,38895,-22029
15232,0.0,0.0,0.0,2593,60928,38895,-22033
15233,0.0,0.0,0.3333333333333333,2593,60932,38895,-22037
15234,0.0,0.0,0.0,2593,60936,38895,-22041
15235,1.0,0.0,0.3333333333333333,2594,60940,38910,-22030
15236,0.0,0.0,0.0,2594,60944,38910,-22034
15237,0.0,0.0,0.0,2594,60948,38910,-22038
15238,0.0,0.0,0.0,2594,60952,38910,-22042
15239,0.0,0.0,0.0,2594,60956,38910,-22046
15240,1.0,1.0,1.0,2595,60960,38925,-22035
15241,0.0,0.0,0.0,2595,60964,38925,-22039
15242,1.0,1.0,0.75,2596,60968,38940,-22028
15243,1.0,1.0,1.0,2597,60972,38955,-22017
15244,0.0,0.0,0.0,2597,60976,38955,-22021
15245,1.0,1.0,1.0,2598,60980,38970,-22010
15246,0.0,0.0,0.0,2598,60984,38970,-22014
15247,0.0,0.0,0.0,2598,60988,38970,-22018
15248,0.0,0.0,0.0,2598,60992,38970,-22022
15249,0.0,0.0,0.0,2598,60996,38970,-22026
15250,1.0,1.0,1.0,2599,61000,38985,-22015
15251,0.0,0.0,0.0,2599,61004,38985,-22019
15252,0.0,0.0,0.0,2599,61008,38985,-22023
15253,1.0,1.0,1.0,2600,61012,39000,-22012
15254,1.0,1.0,1.0,2601,61016,39015,-22001
15255,0.0,0.0,0.0,2601,61020,39015,-22005
15256,0.0,0.0,0.0,2601,61024,39015,-22009
15257,0.0,0.0,0.0,2601,61028,39015,-22013
15258,0.0,0.0,0.0,2601,61032,39015,-22017
15259,0.0,0.0,0.0,2601,61036,39015,-22021
15260,0.0,0.0,0.0,2601,61040,39015,-22025
15261,1.0,1.0,1.0,2602,61044,39030,-22014
15262,1.0,1.0,1.0,2603,61048,39045,-22003
15263,0.0,0.0,0.0,2603,61052,39045,-22007
15264,1.0,1.0,1.0,2604,61056,39060,-21996
15265,0.0,0.0,0.0,2604,61060,39060,-22000
15266,0.0,0.0,0.0,2604,61064,39060,-22004
15267,0.0,0.0,0.0,2604,61068,39060,-22008
15268,0.0,0.0,0.0,2604,61072,39060,-22012
15269,0.0,0.0,0.0,2604,61076,39060,-22016
15270,0.0,0.0,0.0,2604,61080,39060,-22020
15271,0.0,0.0,0.0,2604,61084,39060,-22024
15272,0.0,0.0,0.0,2604,61088,39060,-22028
15273,0.0,0.0,0.0,2604,61092,39060,-22032
15274,0.0,0.0,0.25,2604,61096,39060,-22036
15275,0.0,0.0,0.25,2604,61100,39060,-22040
15276,0.0,0.0,0.3333333333333333,2604,61104,39060,-22044
15277,1.0,1.0,1.0,2605,61108,39075,-22033
15278,0.0,0.0,0.0,2605,61112,39075,-22037
15279,0.0,0.0,0.0,2605,61116,39075,-22041
15280,0.0,0.0,0.0,2605,61120,39075,-22045
15281,0.0,0.0,0.0,2605,61124,39075,-22049
15282,0.0,0.0,0.0,2605,61128,39075,-22053
15283,0.0,0.0,0.0,2605,61132,39075,-22057
15284,0.0,0.0,0.4,2605,61136,39075,-22061
15285,1.0,1.0,1.0,2606,61140,39090,-22050
15286,0.0,0.0,0.0,2606,61144,39090,-22054
15287,0.0,0.0,0.0,2606,61148,39090,-22058
15288,0.0,0.0,0.0,2606,61152,39090,-22062
15289,0.0,0.0,0.0,2606,61156,39090,-22066
15290,0.0,0.0,0.0,2606,61160,39090,-22070
15291,0.0,0.0,0.0,2606,61164,39090,-22074
15292,1.0,1.0,1.0,2607,61168,39105,-22063
15293,0.0,0.0,0.0,2607,61172,39105,-22067
15294,0.0,0.0,0.0,2607,61176,39105,-22071
15295,0.0,0.0,0.0,2607,61180,39105,-22075
15296,0.0,0.0,0.0,2607,61184,39105,-22079
15297,0.0,0.0,0.0,2607,61188,39105,-22083
15298,0.0,0.0,0.3333333333333333,2607,61192,39105,-22087
15299,0.0,0.0,0.25,2607,61196,39105,-22091
15300,0.0,0.0,0.0,2607,61200,39105,-22095
15301,1.0,1.0,0.6666666666666666,2608,61204,39120,-22084
15302,0.0,0.0,0.0,2608,61208,39120,-22088
15303,1.0,1.0,0.6666666666666666,2609,61212,39135,-22077
15304,0.0,0.0,0.0,2609,61216,39135,-22081
15305,0.0,0.0,0.0,2609,61220,39135,-22085
15306,0.0,0.0,0.0,2609,61224,39135,-22089
15307,0.0,0.0,0.0,2609,61228,39135,-22093
15308,1.0,1.0,0.6666666666666666,2610,61232,39150,-22082
15309,0.0,0.0,0.0,2610,61236,39150,-22086
15310,0.0,0.0,0.0,2610,61240,39150,-22090
15311,0.0,0.0,0.0,2610,61244,39150,-22094
15312,0.0,0.0,0.0,2610,61248,39150,-22098
15313,0.0,0.0,0.0,2610,61252,39150,-22102
15314,0.0,0.0,0.0,2610,61256,39150,-22106
15315,0.0,0.0,0.0,2610,61260,39150,-22110
15316,0.0,0.0,0.0,2610,61264,39150,-22114
15317,1.0,1.0,1.0,2611,61268,39165,-22103
15318,0.0,0.0,0.0,2611,61272,39165,-22107
15319,0.0,0.0,0.0,2611,61276,39165,-22111
15320,0.0,0.0,0.0,2611,61280,39165,-22115
15321,0.0,0.0,0.0,2611,61284,39165,-22119
15322,0.0,0.0,0.0,2611,61288,39165,-22123
15323,0.0,0.0,0.0,2611,61292,39165,-22127
15324,0.0,0.0,0.0,2611,61296,39165,-22131
15325,0.0,0.0,0.0,2611,61300,39165,-22135
15326,0.0,0.0,0.0,2611,61304,39165,-22139
15327,0.0,0.0,0.0,2611,61308,39165,-22143
15328,0.0,0.0,0.0,2611,61312,39165,-22147
15329,0.0,0.0,0.0,2611,61316,39165,-22151
15330,0.0,0.0,0.0,2611,61320,39165,-22155
15331,0.0,0.0,0.0,2611,61324,39165,-22159
15332,0.0,0.0,0.0,2611,61328,39165,-22163
15333,0.0,0.0,0.0,2611,61332,39165,-22167
15334,0.0,0.0,0.0,2611,61336,39165,-22171
15335,0.0,0.0,0.0,2611,61340,39165,-22175
15336,0.0,0.0,0.0,2611,61344,39165,-22179
15337,0.0,0.0,0.0,2611,61348,39165,-22183
15338,0.0,0.0,0.0,2611,61352,39165,-22187
15339,0.0,0.0,0.0,2611,61356,39165,-22191
15340,0.0,0.0,0.0,2611,61360,39165,-22195
15341,1.0,1.0,0.6666666666666666,2612,61364,39180,-22184
15342,0.0,0.0,0.0,2612,61368,39180,-22188
15343,0.0,0.0,0.0,2612,61372,39180,-22192
15344,0.0,0.0,0.0,2612,61376,39180,-22196
15345,0.0,0.0,0.0,2612,61380,39180,-22200
15346,1.0,0.0,0.2,2613,61384,39195,-22189
15347,0.0,0.0,0.0,2613,61388,39195,-22193
15348,0.0,0.0,0.0,2613,61392,39195,-22197
15349,0.0,0.0,0.0,2613,61396,39195,-22201
15350,0.0,0.0,0.0,2613,61400,39195,-22205
15351,0.0,0.0,0.0,2613,61404,39195,-22209
15352,0.0,0.0,0.0,2613,61408,39195,-22213
15353,0.0,0.0,0.0,2613,61412,39195,-22217
15354,0.0,0.0,0.0,2613,61416,39195,-22221
15355,0.0,0.0,0.0,2613,61420,39195,-22225
15356,0.0,0.0,0.0,2613,61424,39195,-22229
15357,0.0,0.0,0.0,2613,61428,39195,-22233
15358,1.0,1.0,1.0,2614,61432,39210,-22222
15359,1.0,1.0,1.0,2615,61436,39225,-22211
15360,1.0,1.0,0.6666666666666666,2616,61440,39240,-22200
15361,0.0,0.0,0.0,2616,61444,39240,-22204
15362,1.0,1.0,1.0,2617,61448,39255,-22193
15363,0.0,0.0,0.0,2617,61452,39255,-22197
15364,0.0,0.0,0.0,2617,61456,39255,-22201
15365,0.0,0.0,0.0,2617,61460,39255,-22205
15366,1.0,1.0,1.0,2618,61464,39270,-22194
15367,0.0,0.0,0.0,2618,61468,39270,-22198
15368,0.0,0.0,0.0,2618,61472,39270,-22202
15369,0.0,0.0,0.0,2618,61476,39270,-22206
15370,0.0,0.0,0.0,2618,61480,39270,-22210
15371,0.0,0.0,0.0,2618,61484,39270,-22214
15372,0.0,0.0,0.0,2618,61488,39270,-22218
15373,1.0,1.0,0.75,2619,61492,39285,-22207
15374,0.0,0.0,0.0,2619,61496,39285,-22211
15375,0.0,0.0,0.0,2619,61500,39285,-22215
15376,1.0,1.0,1.0,2620,61504,39300,-22204
15377,1.0,1.0,1.0,2621,61508,39315,-22193
15378,0.0,0.0,0.0,2621,61512,39315,-22197
15379,0.0,0.0,0.0,2621,61516,39315,-22201
15380,0.0,0.0,0.25,2621,61520,39315,-22205
15381,0.0,0.0,0.3333333333333333,2621,61524,39315,-22209
15382,0.0,0.0,0.0,2621,61528,39315,-22213
15383,0.0,0.0,0.0,2621,61532,39315,-22217
15384,0.0,0.0,0.0,2621,61536,39315,-22221
15385,1.0,1.0,1.0,2622,61540,39330,-22210
15386,1.0,1.0,1.0,2623,61544,39345,-22199
15387,0.0,0.0,0.0,2623,61548,39345,-22203
15388,0.0,0.0,0.0,2623,61552,39345,-22207
15389,0.0,0.0,0.0,2623,61556,39345,-22211
15390,0.0,0.0,0.0,2623,61560,39345,-22215
15391,0.0,0.0,0.0,2623,61564,39345,-22219
15392,0.0,0.0,0.0,2623,61568,39345,-22223
15393,0.0,0.0,0.0,2623,61572,39345,-22227
15394,0.0,0.0,0.0,2623,61576,39345,-22231
15395,0.0,0.0,0.0,2623,61580,39345,-22235
15396,0.0,0.0,0.0,2623,61584,39345,-22239
15397,0.0,0.0,0.0,2623,61588,39345,-22243
15398,0.0,0.0,0.0,2623,61592,39345,-22247
15399,1.0,1.0,1.0,2624,61596,39360,-22236
15400,0.0,0.0,0.0,2624,61600,39360,-22240
15401,0.0,0.0,0.0,2624,61604,39360,-22244
15402,0.0,0.0,0.0,2624,61608,39360,-22248
15403,0.0,0.0,0.0,2624,61612,39360,-22252
15404,1.0,1.0,0.6666666666666666,2625,61616,39375,-22241
15405,1.0,0.0,0.3333333333333333,2626,61620,39390,-22230
15406,0.0,0.0,0.0,2626,61624,39390,-22234
15407,0.0,0.0,0.4,2626,61628,39390,-22238
15408,0.0,0.0,0.0,2626,61632,39390,-22242
15409,0.0,0.0,0.0,2626,61636,39390,-22246
15410,0.0,0.0,0.0,2626,61640,39390,-22250
15411,0.0,0.0,0.0,2626,61644,39390,-22254
15412,0.0,0.0,0.0,2626,61648,39390,-22258
15413,1.0,1.0,1.0,2627,61652,39405,-22247
15414,0.0,0.0,0.0,2627,61656,39405,-22251
15415,0.0,0.0,0.0,2627,61660,39405,-22255
15416,0.0,0.0,0.0,2627,61664,39405,-22259
15417,0.0,0.0,0.0,2627,61668,39405,-22263
15418,0.0,0.0,0.0,2627,61672,39405,-22267
15419,1.0,1.0,1.0,2628,61676,39420,-22256
15420,0.0,0.0,0.4,2628,61680,39420,-22260
15421,0.0,0.0,0.0,2628,61684,39420,-22264
15422,0.0,0.0,0.0,2628,61688,39420,-22268
15423,1.0,1.0,1.0,2629,61692,39435,-22257
15424,0.0,0.0,0.0,2629,61696,39435,-22261
15425,0.0,0.0,0.0,2629,61700,39435,-22265
15426,1.0,1.0,0.6666666666666666,2630,61704,39450,-22254
15427,0.0,0.0,0.0,2630,61708,39450,-22258
15428,1.0,1.0,1.0,2631,61712,39465,-22247
15429,0.0,0.0,0.0,2631,61716,39465,-22251
15430,0.0,0.0,0.0,2631,61720,39465,-22255
15431,0.0,0.0,0.0,2631,61724,39465,-22259
15432,0.0,0.0,0.0,2631,61728,39465,-22263
15433,0.0,0.0,0.0,2631,61732,39465,-22267
15434,0.0,0.0,0.0,2631,61736,39465,-22271
15435,1.0,1.0,1.0,2632,61740,39480,-22260
15436,0.0,0.0,0.0,2632,61744,39480,-22264
15437,1.0,1.0,1.0,2633,61748,39495,-22253
15438,0.0,0.0,0.0,2633,61752,39495,-22257
15439,0.0,0.0,0.0,2633,61756,39495,-22261
15440,0.0,0.0,0.0,2633,61760,39495,-22265
15441,0.0,0.0,0.0,2633,61764,39495,-22269
15442,0.0,0.0,0.0,2633,61768,39495,-22273
15443,1.0,1.0,1.0,2634,61772,39510,-22262
15444,1.0,1.0,1.0,2635,61776,39525,-22251
15445,1.0,1.0,0.75,2636,61780,39540,-22240
15446,0.0,0.0,0.0,2636,61784,39540,-22244
15447,1.0,1.0,1.0,2637,61788,39555,-22233
15448,0.0,0.0,0.0,2637,61792,39555,-22237
15449,0.0,0.0,0.0,2637,61796,39555,-22241
15450,0.0,0.0,0.0,2637,61800,39555,-22245
15451,0.0,0.0,0.0,2637,61804,39555,-22249
15452,0.0,0.0,0.0,2637,61808,39555,-22253
15453,0.0,0.0,0.0,2637,61812,39555,-22257
15454,0.0,0.0,0.0,2637,61816,39555,-22261
15455,0.0,0.0,0.0,2637,61820,39555,-22265
15456,0.0,0.0,0.0,2637,61824,39555,-22269
15457,0.0,0.0,0.0,2637,61828,39555,-22273
15458,0.0,0.0,0.0,2637,61832,39555,-22277
15459,1.0,1.0,1.0,2638,61836,39570,-22266
15460,0.0,0.0,0.25,2638,61840,39570,-22270
15461,0.0,0.0,0.0,2638,61844,39570,-22274
15462,0.0,0.0,0.3333333333333333,2638,61848,39570,-22278
15463,0.0,0.0,0.0,2638,61852,39570,-22282
15464,0.0,0.0,0.0,2638,61856,39570,-22286
15465,0.0,0.0,0.0,2638,61860,39570,-22290
15466,0.0,0.0,0.0,2638,61864,39570,-22294
15467,0.0,0.0,0.0,2638,61868,39570,-22298
15468,0.0,0.0,0.0,2638,61872,39570,-22302
15469,0.0,0.0,0.0,2638,61876,39570,-22306
15470,0.0,0.0,0.0,2638,61880,39570,-22310
15471,0.0,0.0,0.0,2638,61884,39570,-22314
15472,0.0,0.0,0.0,2638,61888,39570,-22318
15473,0.0,0.0,0.0,2638,61892,39570,-22322
15474,0.0,0.0,0.0,2638,61896,39570,-22326
15475,1.0,1.0,1.0,2639,61900,39585,-22315
15476,0.0,0.0,0.0,2639,61904,39585,-22319
15477,0.0,0.0,0.0,2639,61908,39585,-22323
15478,0.0,0.0,0.0,2639,61912,39585,-22327
15479,0.0,0.0,0.0,2639,61916,39585,-22331
15480,0.0,0.0,0.0,2639,61920,39585,-22335
15481,0.0,0.0,0.0,2639,61924,39585,-22339
15482,0.0,0.0,0.0,2639,61928,39585,-22343
15483,0.0,0.0,0.0,2639,61932,39585,-22347
15484,1.0,1.0,1.0,2640,61936,39600,-22336
15485,0.0,0.0,0.0,2640,61940,39600,-22340
15486,0.0,0.0,0.0,2640,61944,39600,-22344
15487,0.0,0.0,0.0,2640,61948,39600,-22348
15488,0.0,0.0,0.0,2640,61952,39600,-22352
15489,0.0,0.0,0.0,2640,61956,39600,-22356
15490,0.0,0.0,0.0,2640,61960,39600,-22360
15491,0.0,0.0,0.0,2640,61964,39600,-22364
15492,0.0,0.0,0.0,2640,61968,39600,-22368
15493,0.0,0.0,0.0,2640,61972,39600,-22372
15494,0.0,0.0,0.0,2640,61976,39600,-22376
15495,0.0,0.0,0.0,2640,61980,39600,-22380
15496,0.0,0.0,0.5,2640,61984,39600,-22384
15497,0.0,0.0,0.0,2640,61988,39600,-22388
15498,0.0,0.0,0.0,2640,61992,39600,-22392
15499,1.0,1.0,0.6,2641,61996,39615,-22381
15500,0.0,0.0,0.0,2641,62000,39615,-22385
15501,0.0,0.0,0.0,2641,62004,39615,-22389
15502,0.0,0.0,0.0,2641,62008,39615,-22393
15503,0.0,0.0,0.0,2641,62012,39615,-22397
15504,0.0,0.0,0.0,2641,62016,39615,-22401
15505,1.0,1.0,1.0,2642,62020,39630,-22390
15506,0.0,0.0,0.3333333333333333,2642,62024,39630,-22394
15507,0.0,0.0,0.0,2642,62028,39630,-22398
15508,0.0,0.0,0.0,2642,62032,39630,-22402
15509,0.0,0.0,0.0,2642,62036,39630,-22406
15510,0.0,0.0,0.0,2642,62040,39630,-22410
15511,0.0,0.0,0.0,2642,62044,39630,-22414
15512,0.0,0.0,0.0,2642,62048,39630,-22418
15513,0.0,0.0,0.0,2642,62052,39630,-22422
15514,0.0,0.0,0.0,2642,62056,39630,-22426
15515,1.0,1.0,1.0,2643,62060,39645,-22415
15516,0.0,0.0,0.0,2643,62064,39645,-22419
15517,0.0,0.0,0.0,2643,62068,39645,-22423
15518,0.0,0.0,0.0,2643,62072,39645,-22427
15519,0.0,0.0,0.0,2643,62076,39645,-22431
15520,0.0,0.0,0.0,2643,62080,39645,-22435
15521,0.0,0.0,0.0,2643,62084,39645,-22439
15522,1.0,1.0,1.0,2644,62088,39660,-22428
15523,0.0,0.0,0.0,2644,62092,39660,-22432
15524,0.0,0.0,0.0,2644,62096,39660,-22436
15525,0.0,0.0,0.0,2644,62100,39660,-22440
15526,0.0,0.0,0.0,2644,62104,39660,-22444
15527,0.0,0.0,0.0,2644,62108,39660,-22448
15528,0.0,0.0,0.0,2644,62112,39660,-22452
15529,0.0,0.0,0.0,2644,62116,39660,-22456
15530,0.0,0.0,0.0,2644,62120,39660,-22460
15531,0.0,0.0,0.0,2644,62124,39660,-22464
15532,0.0,0.0,0.0,2644,62128,39660,-22468
15533,0.0,0.0,0.0,2644,62132,39660,-22472
15534,0.0,0.0,0.0,2644,62136,39660,-22476
15535,0.0,0.0,0.0,2644,62140,39660,-22480
15536,0.0,0.0,0.0,2644,62144,39660,-22484
15537,0.0,0.0,0.0,2644,62148,39660,-22488
15538,1.0,1.0,1.0,2645,62152,39675,-22477
15539,0.0,0.0,0.0,2645,62156,39675,-22481
15540,0.0,0.0,0.0,2645,62160,39675,-22485
15541,0.0,0.0,0.0,2645,62164,39675,-22489
15542,0.0,0.0,0.0,2645,62168,39675,-22493
15543,0.0,0.0,0.0,2645,62172,39675,-22497
15544,1.0,1.0,1.0,2646,62176,39690,-22486
15545,1.0,1.0,0.6666666666666666,2647,62180,39705,-22475
15546,0.0,0.0,0.0,2647,62184,39705,-22479
15547,0.0,0.0,0.25,2647,62188,39705,-22483
15548,0.0,0.0,0.0,2647,62192,39705,-22487
15549,0.0,0.0,0.0,2647,62196,39705,-22491
15550,0.0,0.0,0.0,2647,62200,39705,-22495
15551,0.0,0.0,0.0,2647,62204,39705,-22499
15552,0.0,0.0,0.0,2647,62208,39705,-22503
15553,1.0,1.0,1.0,2648,62212,39720,-22492
15554,0.0,0.0,0.0,2648,62216,39720,-22496
15555,0.0,0.0,0.0,2648,62220,39720,-22500
15556,0.0,0.0,0.0,2648,62224,39720,-22504
15557,1.0,1.0,0.6,2649,62228,39735,-22493
15558,1.0,1.0,1.0,2650,62232,39750,-22482
15559,1.0,1.0,1.0,2651,62236,39765,-22471
15560,0.0,0.0,0.0,2651,62240,39765,-22475
15561,1.0,1.0,1.0,2652,62244,39780,-22464
15562,0.0,0.0,0.0,2652,62248,39780,-22468
15563,0.0,0.0,0.0,2652,62252,39780,-22472
15564,0.0,0.0,0.0,2652,62256,39780,-22476
15565,0.0,0.0,0.0,2652,62260,39780,-22480
15566,0.0,0.0,0.0,2652,62264,39780,-22484
15567,0.0,0.0,0.0,2652,62268,39780,-22488
15568,1.0,1.0,1.0,2653,62272,39795,-22477
15569,0.0,0.0,0.0,2653,62276,39795,-22481
15570,0.0,0.0,0.0,2653,62280,39795,-22485
15571,1.0,0.0,0.3333333333333333,2654,62284,39810,-22474
15572,1.0,1.0,1.0,2655,62288,39825,-22463
15573,0.0,0.0,0.0,2655,62292,39825,-22467
15574,0.0,0.0,0.0,2655,62296,39825,-22471
15575,0.0,0.0,0.0,2655,62300,39825,-22475
15576,0.0,0.0,0.0,2655,62304,39825,-22479
15577,0.0,0.0,0.0,2655,62308,39825,-22483
15578,0.0,0.0,0.0,2655,62312,39825,-22487
15579,0.0,0.0,0.0,2655,62316,39825,-22491
15580,0.0,0.0,0.0,2655,62320,39825,-22495
15581,0.0,0.0,0.0,2655,62324,39825,-22499
15582,0.0,0.0,0.0,2655,62328,39825,-22503
15583,0.0,0.0,0.0,2655,62332,39825,-22507
15584,0.0,0.0,0.0,2655,62336,39825,-22511
15585,0.0,0.0,0.0,2655,62340,39825,-22515
15586,0.0,0.0,0.0,2655,62344,39825,-22519
15587,0.0,0.0,0.0,2655,62348,39825,-22523
15588,0.0,0.0,0.0,2655,62352,39825,-22527
15589,1.0,1.0,1.0,2656,62356,39840,-22516
15590,0.0,0.0,0.0,2656,62360,39840,-22520
15591,0.0,0.0,0.0,2656,62364,39840,-22524
15592,0.0,0.0,0.0,2656,62368,39840,-22528
15593,0.0,0.0,0.0,2656,62372,39840,-22532
15594,0.0,0.0,0.0,2656,62376,39840,-22536
15595,0.0,0.0,0.0,2656,62380,39840,-22540
15596,1.0,1.0,1.0,2657,62384,39855,-22529
15597,0.0,0.0,0.0,2657,62388,39855,-22533
15598,0.0,0.0,0.0,2657,62392,39855,-22537
15599,0.0,0.0,0.0,2657,62396,39855,-22541
15600,0.0,0.0,0.0,2657,62400,39855,-22545
15601,0.0,0.0,0.0,2657,62404,39855,-22549
15602,0.0,0.0,0.0,2657,62408,39855,-22553
15603,0.0,0.0,0.0,2657,62412,39855,-22557
15604,0.0,0.0,0.0,2657,62416,39855,-22561
15605,0.0,0.0,0.0,2657,62420,39855,-22565
15606,0.0,0.0,0.0,2657,62424,39855,-22569
15607,0.0,0.0,0.0,2657,62428,39855,-22573
15608,0.0,0.0,0.0,2657,62432,39855,-22577
15609,1.0,1.0,1.0,2658,62436,39870,-22566
15610,0.0,0.0,0.0,2658,62440,39870,-22570
15611,1.0,0.0,0.25,2659,62444,39885,-22559
15612,0.0,0.0,0.0,2659,62448,39885,-22563
15613,0.0,0.0,0.0,2659,62452,39885,-22567
15614,1.0,1.0,1.0,2660,62456,39900,-22556
15615,0.0,0.0,0.0,2660,62460,39900,-22560
15616,0.0,0.0,0.0,2660,62464,39900,-22564
15617,0.0,0.0,0.0,2660,62468,39900,-22568
15618,0.0,0.0,0.0,2660,62472,39900,-22572
15619,0.0,0.0,0.0,2660,62476,39900,-22576
15620,0.0,0.0,0.0,2660,62480,39900,-22580
15621,1.0,1.0,1.0,2661,62484,39915,-22569
15622,0.0,0.0,0.0,2661,62488,39915,-22573
15623,1.0,1.0,0.75,2662,62492,39930,-22562
15624,0.0,0.0,0.0,2662,62496,39930,-22566
15625,0.0,0.0,0.4,2662,62500,39930,-22570
15626,0.0,0.0,0.0,2662,62504,39930,-22574
15627,0.0,0.0,0.0,2662,62508,39930,-22578
15628,1.0,1.0,1.0,2663,62512,39945,-22567
15629,0.0,0.0,0.0,2663,62516,39945,-22571
15630,0.0,1.0,0.6,2663,62520,39945,-22575
15631,1.0,1.0,0.6666666666666666,2664,62524,39960,-22564
15632,1.0,1.0,1.0,2665,62528,39975,-22553
15633,0.0,0.0,0.0,2665,62532,39975,-22557
15634,0.0,0.0,0.0,2665,62536,39975,-22561
15635,1.0,1.0,1.0,2666,62540,39990,-22550
15636,0.0,0.0,0.0,2666,62544,39990,-22554
15637,1.0,1.0,1.0,2667,62548,40005,-22543
15638,0.0,0.0,0.0,2667,62552,40005,-22547
15639,0.0,0.0,0.0,2667,62556,40005,-22551
15640,1.0,1.0,0.6666666666666666,2668,62560,40020,-22540
15641,1.0,1.0,1.0,2669,62564,40035,-22529
15642,1.0,0.0,0.5,2670,62568,40050,-22518
15643,0.0,0.0,0.0,2670,62572,40050,-22522
15644,0.0,0.0,0.0,2670,62576,40050,-22526
15645,0.0,0.0,0.0,2670,62580,40050,-22530
15646,0.0,0.0,0.0,2670,62584,40050,-22534
15647,0.0,0.0,0.0,2670,62588,40050,-22538
15648,0.0,0.0,0.0,2670,62592,40050,-22542
15649,0.0,0.0,0.0,2670,62596,40050,-22546
15650,0.0,0.0,0.0,2670,62600,40050,-22550
15651,1.0,0.0,0.3333333333333333,2671,62604,40065,-22539
15652,0.0,0.0,0.0,2671,62608,40065,-22543
15653,0.0,0.0,0.0,2671,62612,40065,-22547
15654,0.0,0.0,0.0,2671,62616,40065,-22551
15655,0.0,0.0,0.0,2671,62620,40065,-22555
15656,0.0,0.0,0.0,2671,62624,40065,-22559
15657,0.0,0.0,0.0,2671,62628,40065,-22563
15658,0.0,0.0,0.0,2671,62632,40065,-22567
15659,0.0,0.0,0.0,2671,62636,40065,-22571
15660,0.0,0.0,0.0,2671,62640,40065,-22575
15661,0.0,0.0,0.0,2671,62644,40065,-22579
15662,0.0,0.0,0.4,2671,62648,40065,-22583
15663,0.0,0.0,0.0,2671,62652,40065,-22587
15664,0.0,0.0,0.0,2671,62656,40065,-22591
15665,0.0,0.0,0.0,2671,62660,40065,-22595
15666,0.0,0.0,0.0,2671,62664,40065,-22599
15667,0.0,0.0,0.0,2671,62668,40065,-22603
15668,0.0,0.0,0.0,2671,62672,40065,-22607
15669,0.0,0.0,0.0,2671,62676,40065,-22611
15670,0.0,0.0,0.0,2671,62680,40065,-22615
15671,0.0,0.0,0.0,2671,62684,40065,-22619
15672,0.0,0.0,0.0,2671,62688,40065,-22623
15673,0.0,0.0,0.0,2671,62692,40065,-22627
15674,0.0,0.0,0.0,2671,62696,40065,-22631
15675,0.0,0.0,0.0,2671,62700,40065,-22635
15676,0.0,0.0,0.0,2671,62704,40065,-22639
15677,0.0,0.0,0.0,2671,62708,40065,-22643
15678,0.0,0.0,0.0,2671,62712,40065,-22647
15679,0.0,0.0,0.0,2671,62716,40065,-22651
15680,0.0,0.0,0.0,2671,62720,40065,-22655
15681,0.0,0.0,0.0,2671,62724,40065,-22659
15682,1.0,1.0,1.0,2672,62728,40080,-22648
15683,0.0,0.0,0.0,2672,62732,40080,-22652
15684,0.0,0.0,0.0,2672,62736,40080,-22656
15685,0.0,0.0,0.3333333333333333,2672,62740,40080,-22660
15686,0.0,0.0,0.0,2672,62744,40080,-22664
15687,0.0,0.0,0.0,2672,62748,40080,-22668
15688,1.0,1.0,1.0,2673,62752,40095,-22657
15689,0.0,0.0,0.0,2673,62756,40095,-22661
15690,1.0,1.0,0.6666666666666666,2674,62760,40110,-22650
15691,0.0,0.0,0.0,2674,62764,40110,-22654
15692,0.0,0.0,0.0,2674,62768,40110,-22658
15693,1.0,1.0,1.0,2675,62772,40125,-22647
15694,1.0,1.0,1.0,2676,62776,40140,-22636
15695,1.0,1.0,1.0,2677,62780,40155,-22625
15696,0.0,0.0,0.0,2677,62784,40155,-22629
15697,0.0,0.0,0.4,2677,62788,40155,-22633
15698,0.0,0.0,0.0,2677,62792,40155,-22637
15699,0.0,0.0,0.0,2677,62796,40155,-22641
15700,0.0,0.0,0.0,2677,62800,40155,-22645
15701,0.0,0.0,0.0,2677,62804,40155,-22649
15702,0.0,0.0,0.0,2677,62808,40155,-22653
15703,0.0,0.0,0.0,2677,62812,40155,-22657
15704,0.0,0.0,0.0,2677,62816,40155,-22661
15705,0.0,0.0,0.0,2677,62820,40155,-22665
15706,0.0,0.0,0.0,2677,62824,40155,-22669
15707,0.0,0.0,0.0,2677,62828,40155,-22673
15708,0.0,0.0,0.0,2677,62832,40155,-22677
15709,1.0,0.0,0.3333333333333333,2678,62836,40170,-22666
15710,0.0,0.0,0.0,2678,62840,40170,-22670
15711,0.0,0.0,0.0,2678,62844,40170,-22674
15712,0.0,1.0,0.6666666666666666,2678,62848,40170,-22678
15713,0.0,0.0,0.0,2678,62852,40170,-22682
15714,1.0,1.0,0.6,2679,62856,40185,-22671
15715,0.0,0.0,0.0,2679,62860,40185,-22675
15716,0.0,0.0,0.0,2679,62864,40185,-22679
15717,0.0,0.0,0.0,2679,62868,40185,-22683
15718,0.0,0.0,0.0,2679,62872,40185,-22687
15719,0.0,0.0,0.0,2679,62876,40185,-22691
15720,1.0,1.0,0.6666666666666666,2680,62880,40200,-22680
15721,1.0,1.0,1.0,2681,62884,40215,-22669
15722,0.0,0.0,0.0,2681,62888,40215,-22673
15723,0.0,0.0,0.0,2681,62892,40215,-22677
15724,1.0,1.0,1.0,2682,62896,40230,-22666
15725,0.0,0.0,0.0,2682,62900,40230,-22670
15726,0.0,0.0,0.0,2682,62904,40230,-22674
15727,0.0,0.0,0.0,2682,62908,40230,-22678
15728,0.0,0.0,0.0,2682,62912,40230,-22682
15729,0.0,0.0,0.0,2682,62916,40230,-22686
15730,0.0,0.0,0.0,2682,62920,40230,-22690
15731,0.0,0.0,0.0,2682,62924,40230,-22694
15732,0.0,0.0,0.0,2682,62928,40230,-22698
15733,0.0,0.0,0.0,2682,62932,40230,-22702
15734,0.0,0.0,0.0,2682,62936,40230,-22706
15735,0.0,0.0,0.0,2682,62940,40230,-22710
15736,1.0,1.0,0.75,2683,62944,40245,-22699
15737,0.0,0.0,0.0,2683,62948,40245,-22703
15738,0.0,0.0,0.0,2683,62952,40245,-22707
15739,0.0,0.0,0.0,2683,62956,40245,-22711
15740,1.0,1.0,1.0,2684,62960,40260,-22700
15741,1.0,1.0,1.0,2685,62964,40275,-22689
15742,0.0,0.0,0.0,2685,62968,40275,-22693
15743,0.0,0.0,0.0,2685,62972,40275,-22697
15744,0.0,0.0,0.0,2685,62976,40275,-22701
15745,0.0,0.0,0.0,2685,62980,40275,-22705
15746,0.0,0.0,0.0,2685,62984,40275,-22709
15747,0.0,0.0,0.0,2685,62988,40275,-22713
15748,0.0,0.0,0.0,2685,62992,40275,-22717
15749,0.0,0.0,0.25,2685,62996,40275,-22721
15750,1.0,1.0,1.0,2686,63000,40290,-22710
15751,0.0,0.0,0.0,2686,63004,40290,-22714
15752,0.0,0.0,0.0,2686,63008,40290,-22718
15753,1.0,1.0,1.0,2687,63012,40305,-22707
15754,0.0,0.0,0.0,2687,63016,40305,-22711
15755,0.0,0.0,0.0,2687,63020,40305,-22715
15756,0.0,0.0,0.0,2687,63024,40305,-22719
15757,0.0,1.0,0.6666666666666666,2687,63028,40305,-22723
15758,0.0,0.0,0.0,2687,63032,40305,-22727
15759,0.0,0.0,0.0,2687,63036,40305,-22731
15760,0.0,0.0,0.0,2687,63040,40305,-22735
15761,0.0,0.0,0.0,2687,63044,40305,-22739
15762,0.0,0.0,0.0,2687,63048,40305,-22743
15763,0.0,0.0,0.0,2687,63052,40305,-22747
15764,1.0,1.0,1.0,2688,63056,40320,-22736
15765,1.0,1.0,0.6666666666666666,2689,63060,40335,-22725
15766,0.0,0.0,0.0,2689,63064,40335,-22729
15767,1.0,1.0,1.0,2690,63068,40350,-22718
15768,0.0,0.0,0.0,2690,63072,40350,-22722
15769,0.0,0.0,0.0,2690,63076,40350,-22726
15770,0.0,0.0,0.0,2690,63080,40350,-22730
15771,1.0,1.0,0.6666666666666666,2691,63084,40365,-22719
15772,0.0,0.0,0.0,2691,63088,40365,-22723
15773,0.0,0.0,0.0,2691,63092,40365,-22727
15774,1.0,1.0,1.0,2692,63096,40380,-22716
15775,0.0,0.0,0.0,2692,63100,40380,-22720
15776,0.0,0.0,0.0,2692,63104,40380,-22724
15777,0.0,0.0,0.0,2692,63108,40380,-22728
15778,1.0,1.0,1.0,2693,63112,40395,-22717
15779,1.0,1.0,0.75,2694,63116,40410,-22706
15780,0.0,0.0,0.0,2694,63120,40410,-22710
15781,0.0,0.0,0.0,2694,63124,40410,-22714
15782,0.0,0.0,0.0,2694,63128,40410,-22718
15783,0.0,0.0,0.0,2694,63132,40410,-22722
15784,0.0,0.0,0.0,2694,63136,40410,-22726
15785,0.0,0.0,0.0,2694,63140,40410,-22730
15786,0.0,0.0,0.0,2694,63144,40410,-22734
15787,1.0,1.0,1.0,2695,63148,40425,-22723
15788,1.0,1.0,1.0,2696,63152,40440,-22712
15789,0.0,0.0,0.0,2696,63156,40440,-22716
15790,0.0,0.0,0.0,2696,63160,40440,-22720
15791,0.0,0.0,0.0,2696,63164,40440,-22724
15792,1.0,1.0,1.0,2697,63168,40455,-22713
15793,0.0,0.0,0.0,2697,63172,40455,-22717
15794,0.0,0.0,0.0,2697,63176,40455,-22721
15795,0.0,0.0,0.0,2697,63180,40455,-22725
15796,0.0,0.0,0.0,2697,63184,40455,-22729
15797,0.0,0.0,0.0,2697,63188,40455,-22733
15798,0.0,0.0,0.3333333333333333,2697,63192,40455,-22737
15799,0.0,0.0,0.0,2697,63196,40455,-22741
15800,1.0,1.0,1.0,2698,63200,40470,-22730
15801,0.0,0.0,0.0,2698,63204,40470,-22734
15802,0.0,0.0,0.0,2698,63208,40470,-22738
15803,0.0,0.0,0.0,2698,63212,40470,-22742
15804,1.0,1.0,1.0,2699,63216,40485,-22731
15805,0.0,0.0,0.0,2699,63220,40485,-22735
15806,0.0,0.0,0.0,2699,63224,40485,-22739
15807,0.0,0.0,0.0,2699,63228,40485,-22743
15808,0.0,0.0,0.0,2699,63232,40485,-22747
15809,0.0,0.0,0.0,2699,63236,40485,-22751
15810,0.0,0.0,0.0,2699,63240,40485,-22755
15811,1.0,1.0,1.0,2700,63244,40500,-22744
15812,0.0,0.0,0.0,2700,63248,40500,-22748
15813,1.0,1.0,1.0,2701,63252,40515,-22737
15814,0.0,0.0,0.0,2701,63256,40515,-22741
15815,0.0,0.0,0.0,2701,63260,40515,-22745
15816,0.0,0.0,0.0,2701,63264,40515,-22749
15817,1.0,1.0,0.6666666666666666,2702,63268,40530,-22738
15818,0.0,1.0,0.6666666666666666,2702,63272,40530,-22742
15819,0.0,0.0,0.0,2702,63276,40530,-22746
15820,0.0,0.0,0.0,2702,63280,40530,-22750
15821,0.0,0.0,0.0,2702,63284,40530,-22754
15822,0.0,0.0,0.0,2702,63288,40530,-22758
15823,0.0,0.0,0.0,2702,63292,40530,-22762
15824,0.0,0.0,0.0,2702,63296,40530,-22766
15825,0.0,0.0,0.0,2702,63300,40530,-22770
15826,0.0,0.0,0.0,2702,63304,40530,-22774
15827,0.0,0.0,0.0,2702,63308,40530,-22778
15828,0.0,0.0,0.0,2702,63312,40530,-22782
15829,0.0,0.0,0.0,2702,63316,40530,-22786
15830,0.0,0.0,0.3333333333333333,2702,63320,40530,-22790
15831,0.0,0.0,0.0,2702,63324,40530,-22794
15832,0.0,0.0,0.0,2702,63328,40530,-22798
15833,0.0,0.0,0.0,2702,63332,40530,-22802
15834,0.0,0.0,0.0,2702,63336,40530,-22806
15835,1.0,1.0,1.0,2703,63340,40545,-22795
15836,1.0,1.0,1.0,2704,63344,40560,-22784
15837,0.0,0.0,0.0,2704,63348,40560,-22788
15838,0.0,0.0,0.0,2704,63352,40560,-22792
15839,1.0,0.0,0.3333333333333333,2705,63356,40575,-22781
15840,0.0,0.0,0.0,2705,63360,40575,-22785
15841,0.0,0.0,0.0,2705,63364,40575,-22789
15842,1.0,1.0,1.0,2706,63368,40590,-22778
15843,1.0,1.0,1.0,2707,63372,40605,-22767
15844,0.0,0.0,0.3333333333333333,2707,63376,40605,-22771
15845,0.0,0.0,0.0,2707,63380,40605,-22775
15846,0.0,0.0,0.0,2707,63384,40605,-22779
15847,1.0,1.0,1.0,2708,63388,40620,-22768
15848,0.0,0.0,0.0,2708,63392,40620,-22772
15849,0.0,0.0,0.0,2708,63396,40620,-22776
15850,0.0,0.0,0.0,2708,63400,40620,-22780
15851,0.0,0.0,0.0,2708,63404,40620,-22784
15852,1.0,1.0,1.0,2709,63408,40635,-22773
15853,0.0,0.0,0.0,2709,63412,40635,-22777
15854,0.0,0.0,0.0,2709,63416,40635,-22781
15855,0.0,0.0,0.0,2709,63420,40635,-22785
15856,1.0,1.0,1.0,2710,63424,40650,-22774
15857,0.0,0.0,0.0,2710,63428,40650,-22778
15858,1.0,1.0,1.0,2711,63432,40665,-22767
15859,0.0,0.0,0.0,2711,63436,40665,-22771
15860,0.0,0.0,0.5,2711,63440,40665,-22775
15861,0.0,0.0,0.0,2711,63444,40665,-22779
15862,0.0,0.0,0.0,2711,63448,40665,-22783
15863,0.0,0.0,0.0,2711,63452,40665,-22787
15864,0.0,0.0,0.0,2711,63456,40665,-22791
15865,0.0,0.0,0.0,2711,63460,40665,-22795
15866,0.0,0.0,0.0,2711,63464,40665,-22799
15867,0.0,0.0,0.0,2711,63468,40665,-22803
15868,0.0,0.0,0.0,2711,63472,40665,-22807
15869,0.0,0.0,0.0,2711,63476,40665,-22811
15870,0.0,0.0,0.0,2711,63480,40665,-22815
15871,0.0,0.0,0.0,2711,63484,40665,-22819
15872,0.0,0.0,0.0,2711,63488,40665,-22823
15873,0.0,0.0,0.0,2711,63492,40665,-22827
15874,0.0,0.0,0.0,2711,63496,40665,-22831
15875,0.0,0.0,0.0,2711,63500,40665,-22835
15876,1.0,1.0,1.0,2712,63504,40680,-22824
15877,0.0,0.0,0.0,2712,63508,40680,-22828
15878,0.0,0.0,0.0,2712,63512,40680,-22832
15879,0.0,0.0,0.0,2712,63516,40680,-22836
15880,0.0,0.0,0.0,2712,63520,40680,-22840
15881,0.0,0.0,0.0,2712,63524,40680,-22844
15882,0.0,0.0,0.0,2712,63528,40680,-22848
15883,1.0,1.0,1.0,2713,63532,40695,-22837
15884,0.0,0.0,0.0,2713,63536,40695,-22841
15885,0.0,0.0,0.0,2713,63540,40695,-22845
15886,0.0,0.0,0.0,2713,63544,40695,-22849
15887,0.0,0.0,0.0,2713,63548,40695,-22853
15888,0.0,0.0,0.0,2713,63552,40695,-22857
15889,0.0,0.0,0.0,2713,63556,40695,-22861
15890,0.0,0.0,0.0,2713,63560,40695,-22865
15891,0.0,0.0,0.0,2713,63564,40695,-22869
15892,0.0,0.0,0.0,2713,63568,40695,-22873
15893,0.0,0.0,0.0,2713,63572,40695,-22877
15894,0.0,0.0,0.0,2713,63576,40695,-22881
15895,0.0,0.0,0.0,2713,63580,40695,-22885
15896,0.0,0.0,0.0,2713,63584,40695,-22889
15897,0.0,0.0,0.0,2713,63588,40695,-22893
15898,0.0,0.0,0.0,2713,63592,40695,-22897
15899,1.0,1.0,0.6666666666666666,2714,63596,40710,-22886
15900,0.0,0.0,0.0,2714,63600,40710,-22890
15901,1.0,1.0,1.0,2715,63604,40725,-22879
15902,0.0,0.0,0.0,2715,63608,40725,-22883
15903,0.0,0.0,0.0,2715,63612,40725,-22887
15904,0.0,0.0,0.0,2715,63616,40725,-22891
15905,0.0,0.0,0.0,2715,63620,40725,-22895
15906,0.0,0.0,0.0,2715,63624,40725,-22899
15907,0.0,0.0,0.0,2715,63628,40725,-22903
15908,0.0,0.0,0.3333333333333333,2715,63632,40725,-22907
15909,0.0,0.0,0.3333333333333333,2715,63636,40725,-22911
15910,0.0,0.0,0.0,2715,63640,40725,-22915
15911,1.0,1.0,1.0,2716,63644,40740,-22904
15912,0.0,0.0,0.0,2716,63648,40740,-22908
15913,0.0,0.0,0.0,2716,63652,40740,-22912
15914,0.0,0.0,0.0,2716,63656,40740,-22916
15915,0.0,0.0,0.0,2716,63660,40740,-22920
15916,0.0,0.0,0.0,2716,63664,40740,-22924
15917,0.0,0.0,0.0,2716,63668,40740,-22928
15918,0.0,0.0,0.0,2716,63672,40740,-22932
15919,0.0,0.0,0.0,2716,63676,40740,-22936
15920,0.0,1.0,0.6666666666666666,2716,63680,40740,-22940
15921,0.0,0.0,0.0,2716,63684,40740,-22944
15922,0.0,0.0,0.0,2716,63688,40740,-22948
15923,0.0,0.0,0.0,2716,63692,40740,-22952
15924,0.0,0.0,0.0,2716,63696,40740,-22956
15925,0.0,0.0,0.0,2716,63700,40740,-22960
15926,0.0,0.0,0.0,2716,63704,40740,-22964
15927,0.0,0.0,0.0,2716,63708,40740,-22968
15928,0.0,0.0,0.0,2716,63712,40740,-22972
15929,0.0,0.0,0.0,2716,63716,40740,-22976
15930,0.0,0.0,0.0,2716,63720,40740,-22980
15931,0.0,0.0,0.0,2716,63724,40740,-22984
15932,0.0,0.0,0.0,2716,63728,40740,-22988
15933,0.0,0.0,0.0,2716,63732,40740,-22992
15934,0.0,0.0,0.0,2716,63736,40740,-22996
15935,0.0,0.0,0.0,2716,63740,40740,-23000
15936,0.0,0.0,0.0,2716,63744,40740,-23004
15937,0.0,0.0,0.0,2716,63748,40740,-23008
15938,0.0,0.0,0.0,2716,63752,40740,-23012
15939,0.0,0.0,0.0,2716,63756,40740,-23016
15940,0.0,0.0,0.0,2716,63760,40740,-23020
15941,0.0,0.0,0.0,2716,63764,40740,-23024
15942,0.0,0.0,0.0,2716,63768,40740,-23028
15943,0.0,0.0,0.0,2716,63772,40740,-23032
15944,1.0,1.0,1.0,2717,63776,40755,-23021
15945,0.0,0.0,0.0,2717,63780,40755,-23025
15946,0.0,0.0,0.0,2717,63784,40755,-23029
15947,0.0,1.0,0.6666666666666666,2717,63788,40755,-23033
15948,0.0,0.0,0.0,2717,63792,40755,-23037
15949,0.0,0.0,0.0,2717,63796,40755,-23041
15950,0.0,0.0,0.0,2717,63800,40755,-23045
15951,0.0,0.0,0.3333333333333333,2717,63804,40755,-23049
15952,1.0,1.0,1.0,2718,63808,40770,-23038
15953,0.0,0.0,0.0,2718,63812,40770,-23042
15954,0.0,0.0,0.0,2718,63816,40770,-23046
15955,0.0,0.0,0.0,2718,63820,40770,-23050
15956,0.0,0.0,0.0,2718,63824,40770,-23054
15957,1.0,1.0,1.0,2719,63828,40785,-23043
15958,1.0,1.0,1.0,2720,63832,40800,-23032
15959,1.0,1.0,1.0,2721,63836,40815,-23021
15960,1.0,1.0,1.0,2722,63840,40830,-23010
15961,1.0,1.0,1.0,2723,63844,40845,-22999
15962,1.0,1.0,1.0,2724,63848,40860,-22988
15963,0.0,0.0,0.0,2724,63852,40860,-22992
15964,0.0,0.0,0.0,2724,63856,40860,-22996
15965,0.0,0.0,0.0,2724,63860,40860,-23000
15966,0.0,0.0,0.0,2724,63864,40860,-23004
15967,1.0,1.0,1.0,2725,63868,40875,-22993
15968,0.0,0.0,0.0,2725,63872,40875,-22997
15969,1.0,1.0,1.0,2726,63876,40890,-22986
15970,0.0,0.0,0.0,2726,63880,40890,-22990
15971,0.0,0.0,0.0,2726,63884,40890,-22994
15972,0.0,0.0,0.0,2726,63888,40890,-22998
15973,0.0,0.0,0.0,2726,63892,40890,-23002
15974,0.0,0.0,0.0,2726,63896,40890,-23006
15975,0.0,0.0,0.0,2726,63900,40890,-23010
15976,0.0,0.0,0.0,2726,63904,40890,-23014
15977,0.0,0.0,0.0,2726,63908,40890,-23018
15978,0.0,0.0,0.0,2726,63912,40890,-23022
15979,1.0,1.0,1.0,2727,63916,40905,-23011
15980,0.0,0.0,0.0,2727,63920,40905,-23015
15981,0.0,0.0,0.0,2727,63924,40905,-23019
15982,0.0,0.0,0.0,2727,63928,40905,-23023
15983,0.0,0.0,0.0,2727,63932,40905,-23027
15984,0.0,0.0,0.0,2727,63936,40905,-23031
15985,0.0,0.0,0.0,2727,63940,40905,-23035
15986,0.0,0.0,0.0,2727,63944,40905,-23039
15987,0.0,0.0,0.0,2727,63948,40905,-23043
15988,0.0,0.0,0.0,2727,63952,40905,-23047
15989,0.0,0.0,0.0,2727,63956,40905,-23051
15990,0.0,0.0,0.0,2727,63960,40905,-23055
15991,0.0,0.0,0.0,2727,63964,40905,-23059
15992,1.0,1.0,1.0,2728,63968,40920,-23048
15993,1.0,1.0,1.0,2729,63972,40935,-23037
15994,0.0,0.0,0.0,2729,63976,40935,-23041
15995,1.0,1.0,0.75,2730,63980,40950,-23030
15996,0.0,0.0,0.0,2730,63984,40950,-23034
15997,1.0,1.0,1.0,2731,63988,40965,-23023
15998,0.0,0.0,0.0,2731,63992,40965,-23027
15999,0.0,0.0,0.0,2731,63996,40965,-23031
16000,0.0,0.0,0.0,2731,64000,40965,-23035
16001,0.0,0.0,0.0,2731,64004,40965,-23039
16002,0.0,0.0,0.0,2731,64008,40965,-23043
16003,0.0,0.0,0.0,2731,64012,40965,-23047
16004,0.0,0.0,0.0,2731,64016,40965,-23051
16005,0.0,0.0,0.0,2731,64020,40965,-23055
16006,0.0,0.0,0.0,2731,64024,40965,-23059
16007,0.0,0.0,0.0,2731,64028,40965,-23063
16008,0.0,0.0,0.0,2731,64032,40965,-23067
16009,1.0,1.0,1.0,2732,64036,40980,-23056
16010,0.0,0.0,0.0,2732,64040,40980,-23060
16011,0.0,0.0,0.0,2732,64044,40980,-23064
16012,0.0,1.0,0.6666666666666666,2732,64048,40980,-23068
16013,0.0,0.0,0.0,2732,64052,40980,-23072
16014,0.0,0.0,0.0,2732,64056,40980,-23076
16015,1.0,0.0,0.25,2733,64060,40995,-23065
16016,0.0,0.0,0.0,2733,64064,40995,-23069
16017,0.0,0.0,0.0,2733,64068,40995,-23073
16018,1.0,1.0,1.0,2734,64072,41010,-23062
16019,0.0,0.0,0.2,2734,64076,41010,-23066
16020,0.0,0.0,0.0,2734,64080,41010,-23070
16021,1.0,1.0,1.0,2735,64084,41025,-23059
16022,0.0,0.0,0.0,2735,64088,41025,-23063
16023,0.0,0.0,0.0,2735,64092,41025,-23067
16024,0.0,0.0,0.0,2735,64096,41025,-23071
16025,0.0,0.0,0.0,2735,64100,41025,-23075
16026,0.0,0.0,0.0,2735,64104,41025,-23079
16027,0.0,0.0,0.0,2735,64108,41025,-23083
16028,1.0,1.0,1.0,2736,64112,41040,-23072
16029,0.0,0.0,0.0,2736,64116,41040,-23076
16030,0.0,0.0,0.0,2736,64120,41040,-23080
16031,0.0,0.0,0.0,2736,64124,41040,-23084
16032,1.0,1.0,1.0,2737,64128,41055,-23073
16033,0.0,0.0,0.0,2737,64132,41055,-23077
16034,0.0,0.0,0.0,2737,64136,41055,-23081
16035,1.0,1.0,1.0,2738,64140,41070,-23070
16036,0.0,0.0,0.0,2738,64144,41070,-23074
16037,0.0,0.0,0.0,2738,64148,41070,-23078
16038,1.0,1.0,1.0,2739,64152,41085,-23067
16039,1.0,1.0,1.0,2740,64156,41100,-23056
16040,0.0,0.0,0.0,2740,64160,41100,-23060
16041,0.0,0.0,0.0,2740,64164,41100,-23064
16042,0.0,0.0,0.0,2740,64168,41100,-23068
16043,0.0,0.0,0.0,2740,64172,41100,-23072
16044,0.0,0.0,0.0,2740,64176,41100,-23076
16045,0.0,0.0,0.0,2740,64180,41100,-23080
16046,0.0,0.0,0.0,2740,64184,41100,-23084
16047,0.0,0.0,0.0,2740,64188,41100,-23088
16048,0.0,0.0,0.0,2740,64192,41100,-23092
16049,0.0,0.0,0.0,2740,64196,41100,-23096
16050,0.0,0.0,0.25,2740,64200,41100,-23100
16051,1.0,1.0,1.0,2741,64204,41115,-23089
16052,0.0,0.0,0.0,2741,64208,41115,-23093
16053,0.0,0.0,0.0,2741,64212,41115,-23097
16054,0.0,0.0,0.0,2741,64216,41115,-23101
16055,0.0,0.0,0.0,2741,64220,41115,-23105
16056,0.0,0.0,0.0,2741,64224,41115,-23109
16057,0.0,0.0,0.0,2741,64228,41115,-23113
16058,0.0,0.0,0.0,2741,64232,41115,-23117
16059,0.0,0.0,0.0,2741,64236,41115,-23121
16060,0.0,0.0,0.0,2741,64240,41115,-23125
16061,1.0,1.0,1.0,2742,64244,41130,-23114
16062,0.0,0.0,0.0,2742,64248,41130,-23118
16063,1.0,0.0,0.5,2743,64252,41145,-23107
16064,0.0,0.0,0.0,2743,64256,41145,-23111
16065,0.0,0.0,0.0,2743,64260,41145,-23115
16066,0.0,0.0,0.25,2743,64264,41145,-23119
16067,0.0,0.0,0.0,2743,64268,41145,-23123
16068,0.0,1.0,0.6666666666666666,2743,64272,41145,-23127
16069,0.0,0.0,0.0,2743,64276,41145,-23131
16070,0.0,0.0,0.0,2743,64280,41145,-23135
16071,0.0,0.0,0.0,2743,64284,41145,-23139
16072,1.0,1.0,1.0,2744,64288,41160,-23128
16073,0.0,0.0,0.0,2744,64292,41160,-23132
16074,0.0,0.0,0.0,2744,64296,41160,-23136
16075,0.0,0.0,0.0,2744,64300,41160,-23140
16076,1.0,1.0,1.0,2745,64304,41175,-23129
16077,0.0,0.0,0.0,2745,64308,41175,-23133
16078,0.0,0.0,0.0,2745,64312,41175,-23137
16079,0.0,0.0,0.0,2745,64316,41175,-23141
16080,0.0,0.0,0.0,2745,64320,41175,-23145
16081,0.0,0.0,0.3333333333333333,2745,64324,41175,-23149
16082,0.0,0.0,0.0,2745,64328,41175,-23153
16083,0.0,0.0,0.0,2745,64332,41175,-23157
16084,0.0,0.0,0.0,2745,64336,41175,-23161
16085,1.0,0.0,0.3333333333333333,2746,64340,41190,-23150
16086,0.0,0.0,0.0,2746,64344,41190,-23154
16087,0.0,0.0,0.0,2746,64348,41190,-23158
16088,1.0,1.0,1.0,2747,64352,41205,-23147
16089,0.0,0.0,0.0,2747,64356,41205,-23151
16090,0.0,0.0,0.0,2747,64360,41205,-23155
16091,1.0,1.0,1.0,2748,64364,41220,-23144
16092,0.0,0.0,0.3333333333333333,2748,64368,41220,-23148
16093,0.0,0.0,0.0,2748,64372,41220,-23152
16094,0.0,0.0,0.0,2748,64376,41220,-23156
16095,0.0,0.0,0.0,2748,64380,41220,-23160
16096,0.0,0.0,0.0,2748,64384,41220,-23164
16097,0.0,0.0,0.0,2748,64388,41220,-23168
16098,0.0,0.0,0.0,2748,64392,41220,-23172
16099,0.0,0.0,0.0,2748,64396,41220,-23176
16100,0.0,0.0,0.0,2748,64400,41220,-23180
16101,0.0,0.0,0.0,2748,64404,41220,-23184
16102,0.0,0.0,0.0,2748,64408,41220,-23188
16103,0.0,0.0,0.0,2748,64412,41220,-23192
16104,0.0,0.0,0.0,2748,64416,41220,-23196
16105,1.0,1.0,0.8,2749,64420,41235,-23185
16106,0.0,0.0,0.0,2749,64424,41235,-23189
16107,0.0,1.0,0.6666666666666666,2749,64428,41235,-23193
16108,0.0,0.0,0.0,2749,64432,41235,-23197
16109,0.0,0.0,0.0,2749,64436,41235,-23201
16110,0.0,0.0,0.0,2749,64440,41235,-23205
16111,0.0,0.0,0.3333333333333333,2749,64444,41235,-23209
16112,0.0,0.0,0.0,2749,64448,41235,-23213
16113,1.0,1.0,0.75,2750,64452,41250,-23202
16114,1.0,1.0,1.0,2751,64456,41265,-23191
16115,0.0,0.0,0.0,2751,64460,41265,-23195
16116,1.0,1.0,0.75,2752,64464,41280,-23184
16117,0.0,0.0,0.0,2752,64468,41280,-23188
16118,1.0,1.0,0.6666666666666666,2753,64472,41295,-23177
16119,0.0,0.0,0.0,2753,64476,41295,-23181
16120,0.0,0.0,0.0,2753,64480,41295,-23185
16121,0.0,0.0,0.0,2753,64484,41295,-23189
16122,0.0,0.0,0.0,2753,64488,41295,-23193
16123,0.0,0.0,0.0,2753,64492,41295,-23197
16124,0.0,0.0,0.0,2753,64496,41295,-23201
16125,0.0,0.0,0.0,2753,64500,41295,-23205
16126,0.0,0.0,0.0,2753,64504,41295,-23209
16127,0.0,0.0,0.0,2753,64508,41295,-23213
16128,0.0,0.0,0.0,2753,64512,41295,-23217
16129,1.0,1.0,1.0,2754,64516,41310,-23206
16130,1.0,1.0,1.0,2755,64520,41325,-23195
16131,0.0,0.0,0.0,2755,64524,41325,-23199
16132,1.0,1.0,1.0,2756,64528,41340,-23188
16133,1.0,1.0,1.0,2757,64532,41355,-23177
16134,0.0,0.0,0.3333333333333333,2757,64536,41355,-23181
16135,1.0,1.0,1.0,2758,64540,41370,-23170
16136,0.0,0.0,0.3333333333333333,2758,64544,41370,-23174
16137,0.0,0.0,0.0,2758,64548,41370,-23178
16138,1.0,1.0,1.0,2759,64552,41385,-23167
16139,1.0,1.0,1.0,2760,64556,41400,-23156
16140,1.0,1.0,1.0,2761,64560,41415,-23145
16141,0.0,0.0,0.0,2761,64564,41415,-23149
16142,0.0,0.0,0.0,2761,64568,41415,-23153
16143,1.0,1.0,1.0,2762,64572,41430,-23142
16144,0.0,0.0,0.25,2762,64576,41430,-23146
16145,0.0,0.0,0.0,2762,64580,41430,-23150
16146,0.0,0.0,0.0,2762,64584,41430,-23154
16147,0.0,0.0,0.0,2762,64588,41430,-23158
16148,0.0,0.0,0.0,2762,64592,41430,-23162
16149,0.0,0.0,0.0,2762,64596,41430,-23166
16150,0.0,0.0,0.0,2762,64600,41430,-23170
16151,0.0,0.0,0.0,2762,64604,41430,-23174
16152,1.0,1.0,1.0,2763,64608,41445,-23163
16153,0.0,0.0,0.0,2763,64612,41445,-23167
16154,0.0,0.0,0.0,2763,64616,41445,-23171
16155,1.0,1.0,1.0,2764,64620,41460,-23160
16156,0.0,0.0,0.0,2764,64624,41460,-23164
16157,0.0,0.0,0.0,2764,64628,41460,-23168
16158,0.0,0.0,0.0,2764,64632,41460,-23172
16159,0.0,0.0,0.0,2764,64636,41460,-23176
16160,0.0,0.0,0.0,2764,64640,41460,-23180
16161,0.0,0.0,0.0,2764,64644,41460,-23184
16162,1.0,1.0,0.6666666666666666,2765,64648,41475,-23173
16163,0.0,0.0,0.0,2765,64652,41475,-23177
16164,0.0,0.0,0.0,2765,64656,41475,-23181
16165,0.0,0.0,0.0,2765,64660,41475,-23185
16166,0.0,0.0,0.0,2765,64664,41475,-23189
16167,0.0,0.0,0.0,2765,64668,41475,-23193
16168,1.0,1.0,0.6666666666666666,2766,64672,41490,-23182
16169,0.0,0.0,0.0,2766,64676,41490,-23186
16170,0.0,0.0,0.0,2766,64680,41490,-23190
16171,0.0,0.0,0.0,2766,64684,41490,-23194
16172,0.0,0.0,0.0,2766,64688,41490,-23198
16173,0.0,0.0,0.0,2766,64692,41490,-23202
16174,0.0,0.0,0.0,2766,64696,41490,-23206
16175,1.0,0.0,0.3333333333333333,2767,64700,41505,-23195
16176,0.0,0.0,0.0,2767,64704,41505,-23199
16177,1.0,1.0,1.0,2768,64708,41520,-23188
16178,0.0,0.0,0.0,2768,64712,41520,-23192
16179,1.0,1.0,1.0,2769,64716,41535,-23181
16180,0.0,0.0,0.0,2769,64720,41535,-23185
16181,0.0,0.0,0.0,2769,64724,41535,-23189
16182,0.0,0.0,0.0,2769,64728,41535,-23193
16183,0.0,0.0,0.0,2769,64732,41535,-23197
16184,0.0,0.0,0.0,2769,64736,41535,-23201
16185,0.0,0.0,0.0,2769,64740,41535,-23205
16186,0.0,0.0,0.0,2769,64744,41535,-23209
16187,0.0,0.0,0.0,2769,64748,41535,-23213
16188,0.0,0.0,0.0,2769,64752,41535,-23217
16189,0.0,0.0,0.0,2769,64756,41535,-23221
16190,0.0,0.0,0.3333333333333333,2769,64760,41535,-23225
16191,1.0,1.0,1.0,2770,64764,41550,-23214
16192,1.0,1.0,1.0,2771,64768,41565,-23203
16193,0.0,0.0,0.0,2771,64772,41565,-23207
16194,0.0,0.0,0.0,2771,64776,41565,-23211
16195,0.0,0.0,0.0,2771,64780,41565,-23215
16196,0.0,0.0,0.0,2771,64784,41565,-23219
16197,0.0,0.0,0.0,2771,64788,41565,-23223
16198,0.0,0.0,0.0,2771,64792,41565,-23227
16199,0.0,0.0,0.2,2771,64796,41565,-23231
16200,0.0,0.0,0.0,2771,64800,41565,-23235
16201,0.0,0.0,0.0,2771,64804,41565,-23239
16202,0.0,0.0,0.0,2771,64808,41565,-23243
16203,0.0,0.0,0.0,2771,64812,41565,-23247
16204,0.0,0.0,0.0,2771,64816,41565,-23251
16205,0.0,0.0,0.3333333333333333,2771,64820,41565,-23255
16206,0.0,0.0,0.0,2771,64824,41565,-23259
16207,0.0,0.0,0.0,2771,64828,41565,-23263
16208,0.0,0.0,0.0,2771,64832,41565,-23267
16209,0.0,0.0,0.0,2771,64836,41565,-23271
16210,0.0,0.0,0.0,2771,64840,41565,-23275
16211,0.0,0.0,0.0,2771,64844,41565,-23279
16212,0.0,0.0,0.0,2771,64848,41565,-23283
16213,1.0,1.0,1.0,2772,64852,41580,-23272
16214,0.0,0.0,0.0,2772,64856,41580,-23276
16215,1.0,1.0,1.0,2773,64860,41595,-23265
16216,0.0,0.0,0.0,2773,64864,41595,-23269
16217,1.0,1.0,1.0,2774,64868,41610,-23258
16218,0.0,0.0,0.0,2774,64872,41610,-23262
16219,0.0,0.0,0.0,2774,64876,41610,-23266
16220,0.0,0.0,0.0,2774,64880,41610,-23270
16221,1.0,1.0,0.6666666666666666,2775,64884,41625,-23259
16222,0.0,0.0,0.0,2775,64888,41625,-23263
16223,0.0,0.0,0.0,2775,64892,41625,-23267
16224,0.0,0.0,0.0,2775,64896,41625,-23271
16225,0.0,0.0,0.0,2775,64900,41625,-23275
16226,0.0,0.0,0.0,2775,64904,41625,-23279
16227,0.0,0.0,0.0,2775,64908,41625,-23283
16228,0.0,0.0,0.0,2775,64912,41625,-23287
16229,0.0,0.0,0.3333333333333333,2775,64916,41625,-23291
16230,1.0,1.0,1.0,2776,64920,41640,-23280
16231,0.0,0.0,0.0,2776,64924,41640,-23284
16232,0.0,0.0,0.0,2776,64928,41640,-23288
16233,0.0,0.0,0.0,2776,64932,41640,-23292
16234,1.0,1.0,0.6666666666666666,2777,64936,41655,-23281
16235,0.0,0.0,0.0,2777,64940,41655,-23285
16236,1.0,1.0,1.0,2778,64944,41670,-23274
16237,1.0,1.0,1.0,2779,64948,41685,-23263
16238,0.0,0.0,0.0,2779,64952,41685,-23267
16239,0.0,0.0,0.0,2779,64956,41685,-23271
16240,0.0,0.0,0.0,2779,64960,41685,-23275
16241,0.0,0.0,0.0,2779,64964,41685,-23279
16242,1.0,1.0,1.0,2780,64968,41700,-23268
16243,1.0,0.0,0.25,2781,64972,41715,-23257
16244,1.0,1.0,1.0,2782,64976,41730,-23246
16245,0.0,0.0,0.0,2782,64980,41730,-23250
16246,1.0,1.0,1.0,2783,64984,41745,-23239
16247,1.0,1.0,0.6,2784,64988,41760,-23228
16248,1.0,1.0,1.0,2785,64992,41775,-23217
16249,0.0,0.0,0.0,2785,64996,41775,-23221
16250,0.0,0.0,0.0,2785,65000,41775,-23225
16251,0.0,0.0,0.0,2785,65004,41775,-23229
16252,1.0,1.0,0.8,2786,65008,41790,-23218
16253,0.0,0.0,0.3333333333333333,2786,65012,41790,-23222
16254,0.0,0.0,0.0,2786,65016,41790,-23226
16255,1.0,1.0,1.0,2787,65020,41805,-23215
16256,0.0,0.0,0.0,2787,65024,41805,-23219
16257,0.0,0.0,0.0,2787,65028,41805,-23223
16258,0.0,0.0,0.3333333333333333,2787,65032,41805,-23227
16259,0.0,0.0,0.0,2787,65036,41805,-23231
16260,1.0,1.0,0.75,2788,65040,41820,-23220
16261,0.0,0.0,0.0,2788,65044,41820,-23224
16262,0.0,0.0,0.0,2788,65048,41820,-23228
16263,0.0,0.0,0.0,2788,65052,41820,-23232
16264,0.0,0.0,0.0,2788,65056,41820,-23236
16265,1.0,1.0,1.0,2789,65060,41835,-23225
16266,0.0,0.0,0.0,2789,65064,41835,-23229
16267,0.0,0.0,0.4,2789,65068,41835,-23233
16268,0.0,0.0,0.0,2789,65072,41835,-23237
16269,0.0,0.0,0.0,2789,65076,41835,-23241
16270,0.0,0.0,0.0,2789,65080,41835,-23245
16271,1.0,1.0,1.0,2790,65084,41850,-23234
16272,1.0,1.0,1.0,2791,65088,41865,-23223
16273,1.0,1.0,1.0,2792,65092,41880,-23212
16274,0.0,0.0,0.0,2792,65096,41880,-23216
16275,1.0,1.0,1.0,2793,65100,41895,-23205
16276,0.0,0.0,0.0,2793,65104,41895,-23209
16277,0.0,0.0,0.0,2793,65108,41895,-23213
16278,0.0,0.0,0.0,2793,65112,41895,-23217
16279,0.0,0.0,0.0,2793,65116,41895,-23221
16280,1.0,1.0,1.0,2794,65120,41910,-23210
16281,0.0,0.0,0.0,2794,65124,41910,-23214
16282,0.0,0.0,0.0,2794,65128,41910,-23218
16283,0.0,0.0,0.0,2794,65132,41910,-23222
16284,0.0,0.0,0.0,2794,65136,41910,-23226
16285,0.0,0.0,0.0,2794,65140,41910,-23230
16286,1.0,1.0,1.0,2795,65144,41925,-23219
16287,0.0,0.0,0.0,2795,65148,41925,-23223
16288,0.0,0.0,0.0,2795,65152,41925,-23227
16289,0.0,0.0,0.0,2795,65156,41925,-23231
16290,0.0,0.0,0.0,2795,65160,41925,-23235
16291,0.0,0.0,0.0,2795,65164,41925,-23239
16292,0.0,0.0,0.0,2795,65168,41925,-23243
16293,0.0,0.0,0.0,2795,65172,41925,-23247
16294,0.0,0.0,0.0,2795,65176,41925,-23251
16295,0.0,0.0,0.0,2795,65180,41925,-23255
16296,1.0,1.0,1.0,2796,65184,41940,-23244
16297,0.0,0.0,0.0,2796,65188,41940,-23248
16298,0.0,0.0,0.0,2796,65192,41940,-23252
16299,0.0,0.0,0.0,2796,65196,41940,-23256
16300,0.0,0.0,0.0,2796,65200,41940,-23260
16301,1.0,1.0,1.0,2797,65204,41955,-23249
16302,0.0,0.0,0.0,2797,65208,41955,-23253
16303,1.0,1.0,1.0,2798,65212,41970,-23242
16304,0.0,1.0,0.6666666666666666,2798,65216,41970,-23246
16305,1.0,1.0,1.0,2799,65220,41985,-23235
16306,0.0,0.0,0.0,2799,65224,41985,-23239
16307,0.0,0.0,0.0,2799,65228,41985,-23243
16308,0.0,0.0,0.4,2799,65232,41985,-23247
16309,1.0,1.0,1.0,2800,65236,42000,-23236
16310,0.0,0.0,0.0,2800,65240,42000,-23240
16311,1.0,1.0,1.0,2801,65244,42015,-23229
16312,0.0,0.0,0.0,2801,65248,42015,-23233
16313,1.0,1.0,0.6666666666666666,2802,65252,42030,-23222
16314,0.0,0.0,0.0,2802,65256,42030,-23226
16315,0.0,0.0,0.0,2802,65260,42030,-23230
16316,0.0,0.0,0.0,2802,65264,42030,-23234
16317,1.0,1.0,0.75,2803,65268,42045,-23223
16318,0.0,0.0,0.0,2803,65272,42045,-23227
16319,0.0,0.0,0.0,2803,65276,42045,-23231
16320,0.0,0.0,0.0,2803,65280,42045,-23235
16321,0.0,0.0,0.0,2803,65284,42045,-23239
16322,0.0,0.0,0.0,2803,65288,42045,-23243
16323,0.0,0.0,0.3333333333333333,2803,65292,42045,-23247
16324,0.0,0.0,0.0,2803,65296,42045,-23251
16325,1.0,1.0,1.0,2804,65300,42060,-23240
16326,0.0,0.0,0.0,2804,65304,42060,-23244
16327,0.0,0.0,0.0,2804,65308,42060,-23248
16328,1.0,1.0,0.6666666666666666,2805,65312,42075,-23237
16329,0.0,0.0,0.0,2805,65316,42075,-23241
16330,0.0,0.0,0.0,2805,65320,42075,-23245
16331,0.0,0.0,0.0,2805,65324,42075,-23249
16332,0.0,0.0,0.0,2805,65328,42075,-23253
16333,0.0,0.0,0.0,2805,65332,42075,-23257
16334,0.0,0.0,0.0,2805,65336,42075,-23261
16335,0.0,0.0,0.0,2805,65340,42075,-23265
16336,0.0,0.0,0.0,2805,65344,42075,-23269
16337,0.0,0.0,0.0,2805,65348,42075,-23273
16338,1.0,1.0,0.8,2806,65352,42090,-23262
16339,0.0,0.0,0.0,2806,65356,42090,-23266
16340,0.0,0.0,0.0,2806,65360,42090,-23270
16341,0.0,0.0,0.0,2806,65364,42090,-23274
16342,1.0,1.0,1.0,2807,65368,42105,-23263
16343,0.0,0.0,0.0,2807,65372,42105,-23267
16344,0.0,0.0,0.0,2807,65376,42105,-23271
16345,0.0,0.0,0.0,2807,65380,42105,-23275
16346,0.0,0.0,0.0,2807,65384,42105,-23279
16347,0.0,0.0,0.0,2807,65388,42105,-23283
16348,0.0,0.0,0.0,2807,65392,42105,-23287
16349,0.0,0.0,0.0,2807,65396,42105,-23291
16350,0.0,0.0,0.0,2807,65400,42105,-23295
16351,0.0,0.0,0.0,2807,65404,42105,-23299
16352,0.0,0.0,0.0,2807,65408,42105,-23303
16353,0.0,0.0,0.0,2807,65412,42105,-23307
16354,0.0,0.0,0.0,2807,65416,42105,-23311
16355,0.0,0.0,0.0,2807,65420,42105,-23315
16356,0.0,0.0,0.0,2807,65424,42105,-23319
16357,0.0,0.0,0.0,2807,65428,42105,-23323
16358,0.0,0.0,0.0,2807,65432,42105,-23327
16359,0.0,0.0,0.0,2807,65436,42105,-23331
16360,1.0,1.0,1.0,2808,65440,42120,-23320
16361,0.0,0.0,0.0,2808,65444,42120,-23324
16362,0.0,0.0,0.0,2808,65448,42120,-23328
16363,0.0,0.0,0.0,2808,65452,42120,-23332
16364,0.0,0.0,0.0,2808,65456,42120,-23336
16365,0.0,0.0,0.0,2808,65460,42120,-23340
16366,0.0,0.0,0.0,2808,65464,42120,-23344
16367,0.0,0.0,0.0,2808,65468,42120,-23348
16368,0.0,0.0,0.0,2808,65472,42120,-23352
16369,0.0,0.0,0.0,2808,65476,42120,-23356
16370,1.0,1.0,1.0,2809,65480,42135,-23345
16371,1.0,1.0,1.0,2810,65484,42150,-23334
16372,0.0,0.0,0.0,2810,65488,42150,-23338
16373,0.0,0.0,0.0,2810,65492,42150,-23342
16374,1.0,1.0,1.0,2811,65496,42165,-23331
16375,0.0,0.0,0.0,2811,65500,42165,-23335
16376,0.0,0.0,0.0,2811,65504,42165,-23339
16377,1.0,1.0,1.0,2812,65508,42180,-23328
16378,0.0,0.0,0.0,2812,65512,42180,-23332
16379,0.0,0.0,0.0,2812,65516,42180,-23336
16380,0.0,0.0,0.0,2812,65520,42180,-23340
16381,0.0,0.0,0.0,2812,65524,42180,-23344
16382,0.0,1.0,0.8,2812,65528,42180,-23348
16383,0.0,0.0,0.0,2812,65532,42180,-23352
16384,1.0,1.0,1.0,2813,65536,42195,-23341
16385,0.0,0.0,0.0,2813,65540,42195,-23345
16386,0.0,0.0,0.25,2813,65544,42195,-23349
16387,0.0,0.0,0.0,2813,65548,42195,-23353
16388,0.0,0.0,0.0,2813,65552,42195,-23357
16389,0.0,0.0,0.0,2813,65556,42195,-23361
16390,0.0,0.0,0.0,2813,65560,42195,-23365
16391,0.0,0.0,0.0,2813,65564,42195,-23369
16392,0.0,0.0,0.0,2813,65568,42195,-23373
16393,0.0,0.0,0.0,2813,65572,42195,-23377
16394,1.0,1.0,1.0,2814,65576,42210,-23366
16395,1.0,1.0,1.0,2815,65580,42225,-23355
16396,1.0,1.0,0.6666666666666666,2816,65584,42240,-23344
16397,0.0,0.0,0.0,2816,65588,42240,-23348
16398,0.0,0.0,0.0,2816,65592,42240,-23352
16399,0.0,0.0,0.0,2816,65596,42240,-23356
16400,0.0,1.0,0.8,2816,65600,42240,-23360
16401,0.0,0.0,0.0,2816,65604,42240,-23364
16402,0.0,0.0,0.0,2816,65608,42240,-23368
16403,0.0,0.0,0.0,2816,65612,42240,-23372
16404,0.0,0.0,0.0,2816,65616,42240,-23376
16405,0.0,0.0,0.0,2816,65620,42240,-23380
16406,0.0,0.0,0.0,2816,65624,42240,-23384
16407,0.0,0.0,0.0,2816,65628,42240,-23388
16408,0.0,0.0,0.0,2816,65632,42240,-23392
16409,0.0,0.0,0.0,2816,65636,42240,-23396
16410,0.0,0.0,0.3333333333333333,2816,65640,42240,-23400
16411,0.0,0.0,0.0,2816,65644,42240,-23404
16412,0.0,0.0,0.0,2816,65648,42240,-23408
16413,0.0,0.0,0.0,2816,65652,42240,-23412
16414,0.0,0.0,0.0,2816,65656,42240,-23416
16415,0.0,0.0,0.25,2816,65660,42240,-23420
16416,0.0,1.0,0.6666666666666666,2816,65664,42240,-23424
16417,1.0,1.0,1.0,2817,65668,42255,-23413
16418,0.0,0.0,0.0,2817,65672,42255,-23417
16419,0.0,0.0,0.0,2817,65676,42255,-23421
16420,0.0,1.0,0.6666666666666666,2817,65680,42255,-23425
16421,0.0,0.0,0.0,2817,65684,42255,-23429
16422,0.0,0.0,0.0,2817,65688,42255,-23433
16423,0.0,0.0,0.0,2817,65692,42255,-23437
16424,1.0,1.0,1.0,2818,65696,42270,-23426
16425,1.0,0.0,0.5,2819,65700,42285,-23415
16426,1.0,0.0,0.3333333333333333,2820,65704,42300,-23404
16427,0.0,0.0,0.0,2820,65708,42300,-23408
16428,0.0,0.0,0.0,2820,65712,42300,-23412
16429,0.0,0.0,0.0,2820,65716,42300,-23416
16430,1.0,1.0,1.0,2821,65720,42315,-23405
16431,0.0,0.0,0.2,2821,65724,42315,-23409
16432,1.0,1.0,1.0,2822,65728,42330,-23398
16433,0.0,0.0,0.0,2822,65732,42330,-23402
16434,0.0,0.0,0.0,2822,65736,42330,-23406
16435,0.0,0.0,0.0,2822,65740,42330,-23410
16436,0.0,0.0,0.0,2822,65744,42330,-23414
16437,0.0,0.0,0.0,2822,65748,42330,-23418
16438,1.0,1.0,1.0,2823,65752,42345,-23407
16439,0.0,0.0,0.0,2823,65756,42345,-23411
16440,0.0,0.0,0.0,2823,65760,42345,-23415
16441,1.0,1.0,0.6666666666666666,2824,65764,42360,-23404
16442,0.0,0.0,0.0,2824,65768,42360,-23408
16443,0.0,0.0,0.0,2824,65772,42360,-23412
16444,0.0,0.0,0.0,2824,65776,42360,-23416
16445,1.0,1.0,1.0,2825,65780,42375,-23405
16446,1.0,0.0,0.3333333333333333,2826,65784,42390,-23394
16447,1.0,1.0,1.0,2827,65788,42405,-23383
16448,1.0,1.0,0.6666666666666666,2828,65792,42420,-23372
16449,0.0,0.0,0.0,2828,65796,42420,-23376
16450,0.0,0.0,0.0,2828,65800,42420,-23380
16451,0.0,0.0,0.0,2828,65804,42420,-23384
16452,1.0,1.0,1.0,2829,65808,42435,-23373
16453,0.0,0.0,0.0,2829,65812,42435,-23377
16454,0.0,0.0,0.0,2829,65816,42435,-23381
16455,0.0,0.0,0.0,2829,65820,42435,-23385
16456,1.0,1.0,0.75,2830,65824,42450,-23374
16457,0.0,0.0,0.0,2830,65828,42450,-23378
16458,0.0,0.0,0.0,2830,65832,42450,-23382
16459,1.0,1.0,1.0,2831,65836,42465,-23371
16460,0.0,0.0,0.0,2831,65840,42465,-23375
16461,0.0,0.0,0.0,2831,65844,42465,-23379
16462,1.0,1.0,1.0,2832,65848,42480,-23368
16463,0.0,0.0,0.0,2832,65852,42480,-23372
16464,1.0,0.0,0.2,2833,65856,42495,-23361
16465,0.0,0.0,0.0,2833,65860,42495,-23365
16466,1.0,1.0,0.6666666666666666,2834,65864,42510,-23354
16467,0.0,0.0,0.0,2834,65868,42510,-23358
16468,0.0,0.0,0.0,2834,65872,42510,-23362
16469,0.0,0.0,0.2,2834,65876,42510,-23366
16470,0.0,0.0,0.0,2834,65880,42510,-23370
16471,0.0,0.0,0.0,2834,65884,42510,-23374
16472,0.0,0.0,0.0,2834,65888,42510,-23378
16473,0.0,0.0,0.0,2834,65892,42510,-23382
16474,0.0,0.0,0.0,2834,65896,42510,-23386
16475,1.0,1.0,1.0,2835,65900,42525,-23375
16476,0.0,0.0,0.0,2835,65904,42525,-23379
16477,0.0,0.0,0.0,2835,65908,42525,-23383
16478,0.0,0.0,0.0,2835,65912,42525,-23387
16479,0.0,0.0,0.0,2835,65916,42525,-23391
16480,0.0,0.0,0.0,2835,65920,42525,-23395
16481,0.0,0.0,0.0,2835,65924,42525,-23399
16482,0.0,0.0,0.0,2835,65928,42525,-23403
16483,1.0,1.0,1.0,2836,65932,42540,-23392
16484,0.0,0.0,0.0,2836,65936,42540,-23396
16485,1.0,1.0,1.0,2837,65940,42555,-23385
16486,1.0,1.0,1.0,2838,65944,42570,-23374
16487,1.0,1.0,1.0,2839,65948,42585,-23363
16488,0.0,0.0,0.0,2839,65952,42585,-23367
16489,0.0,0.0,0.0,2839,65956,42585,-23371
16490,0.0,0.0,0.3333333333333333,2839,65960,42585,-23375
16491,0.0,0.0,0.0,2839,65964,42585,-23379
16492,0.0,1.0,0.75,2839,65968,42585,-23383
16493,0.0,1.0,0.6666666666666666,2839,65972,42585,-23387
16494,0.0,0.0,0.0,2839,65976,42585,-23391
16495,1.0,1.0,1.0,2840,65980,42600,-23380
16496,0.0,0.0,0.0,2840,65984,42600,-23384
16497,1.0,1.0,1.0,2841,65988,42615,-23373
16498,0.0,0.0,0.0,2841,65992,42615,-23377
16499,1.0,1.0,1.0,2842,65996,42630,-23366
16500,0.0,0.0,0.0,2842,66000,42630,-23370
16501,0.0,0.0,0.0,2842,66004,42630,-23374
16502,0.0,0.0,0.0,2842,66008,42630,-23378
16503,0.0,0.0,0.0,2842,66012,42630,-23382
16504,0.0,0.0,0.0,2842,66016,42630,-23386
16505,1.0,0.0,0.3333333333333333,2843,66020,42645,-23375
16506,1.0,1.0,1.0,2844,66024,42660,-23364
16507,0.0,0.0,0.0,2844,66028,42660,-23368
16508,0.0,0.0,0.0,2844,66032,42660,-23372
16509,1.0,1.0,0.75,2845,66036,42675,-23361
16510,0.0,0.0,0.5,2845,66040,42675,-23365
16511,0.0,0.0,0.0,2845,66044,42675,-23369
16512,0.0,0.0,0.0,2845,66048,42675,-23373
16513,0.0,0.0,0.0,2845,66052,42675,-23377
16514,0.0,0.0,0.0,2845,66056,42675,-23381
16515,0.0,0.0,0.25,2845,66060,42675,-23385
16516,0.0,0.0,0.0,2845,66064,42675,-23389
16517,0.0,0.0,0.0,2845,66068,42675,-23393
16518,0.0,0.0,0.0,2845,66072,42675,-23397
16519,0.0,0.0,0.0,2845,66076,42675,-23401
16520,1.0,1.0,1.0,2846,66080,42690,-23390
16521,0.0,0.0,0.3333333333333333,2846,66084,42690,-23394
16522,0.0,1.0,0.6666666666666666,2846,66088,42690,-23398
16523,0.0,0.0,0.0,2846,66092,42690,-23402
16524,0.0,0.0,0.0,2846,66096,42690,-23406
16525,0.0,0.0,0.0,2846,66100,42690,-23410
16526,0.0,0.0,0.0,2846,66104,42690,-23414
16527,1.0,1.0,1.0,2847,66108,42705,-23403
16528,0.0,0.0,0.0,2847,66112,42705,-23407
16529,0.0,0.0,0.0,2847,66116,42705,-23411
16530,0.0,0.0,0.0,2847,66120,42705,-23415
16531,0.0,0.0,0.0,2847,66124,42705,-23419
16532,0.0,0.0,0.0,2847,66128,42705,-23423
16533,0.0,0.0,0.0,2847,66132,42705,-23427
16534,0.0,0.0,0.0,2847,66136,42705,-23431
16535,0.0,0.0,0.0,2847,66140,42705,-23435
16536,0.0,0.0,0.0,2847,66144,42705,-23439
16537,0.0,0.0,0.0,2847,66148,42705,-23443
16538,1.0,1.0,1.0,2848,66152,42720,-23432
16539,0.0,0.0,0.3333333333333333,2848,66156,42720,-23436
16540,0.0,0.0,0.0,2848,66160,42720,-23440
16541,0.0,0.0,0.0,2848,66164,42720,-23444
16542,0.0,0.0,0.0,2848,66168,42720,-23448
16543,0.0,0.0,0.0,2848,66172,42720,-23452
16544,0.0,0.0,0.0,2848,66176,42720,-23456
16545,0.0,0.0,0.0,2848,66180,42720,-23460
16546,0.0,0.0,0.3333333333333333,2848,66184,42720,-23464
16547,0.0,0.0,0.0,2848,66188,42720,-23468
16548,0.0,0.0,0.0,2848,66192,42720,-23472
16549,1.0,1.0,1.0,2849,66196,42735,-23461
16550,1.0,1.0,1.0,2850,66200,42750,-23450
16551,0.0,0.0,0.0,2850,66204,42750,-23454
16552,0.0,0.0,0.0,2850,66208,42750,-23458
16553,0.0,0.0,0.4,2850,66212,42750,-23462
16554,0.0,0.0,0.0,2850,66216,42750,-23466
16555,0.0,0.0,0.0,2850,66220,42750,-23470
16556,0.0,0.0,0.0,2850,66224,42750,-23474
16557,0.0,0.0,0.0,2850,66228,42750,-23478
16558,0.0,0.0,0.0,2850,66232,42750,-23482
16559,0.0,0.0,0.0,2850,66236,42750,-23486
16560,1.0,1.0,1.0,2851,66240,42765,-23475
16561,0.0,0.0,0.0,2851,66244,42765,-23479
16562,1.0,1.0,1.0,2852,66248,42780,-23468
16563,0.0,0.0,0.0,2852,66252,42780,-23472
16564,0.0,0.0,0.0,2852,66256,42780,-23476
16565,0.0,0.0,0.0,2852,66260,42780,-23480
16566,0.0,0.0,0.0,2852,66264,42780,-23484
16567,1.0,1.0,1.0,2853,66268,42795,-23473
16568,0.0,0.0,0.0,2853,66272,42795,-23477
16569,1.0,1.0,0.8,2854,66276,42810,-23466
16570,0.0,0.0,0.0,2854,66280,42810,-23470
16571,0.0,0.0,0.0,2854,66284,42810,-23474
16572,0.0,0.0,0.0,2854,66288,42810,-23478
16573,1.0,1.0,1.0,2855,66292,42825,-23467
16574,0.0,0.0,0.0,2855,66296,42825,-23471
16575,0.0,0.0,0.0,2855,66300,42825,-23475
16576,0.0,0.0,0.0,2855,66304,42825,-23479
16577,0.0,0.0,0.0,2855,66308,42825,-23483
16578,0.0,0.0,0.3333333333333333,2855,66312,42825,-23487
16579,0.0,0.0,0.0,2855,66316,42825,-23491
16580,1.0,1.0,1.0,2856,66320,42840,-23480
16581,0.0,0.0,0.0,2856,66324,42840,-23484
16582,0.0,0.0,0.0,2856,66328,42840,-23488
16583,0.0,0.0,0.0,2856,66332,42840,-23492
16584,0.0,0.0,0.0,2856,66336,42840,-23496
16585,0.0,0.0,0.0,2856,66340,42840,-23500
16586,0.0,0.0,0.0,2856,66344,42840,-23504
16587,0.0,0.0,0.0,2856,66348,42840,-23508
16588,0.0,0.0,0.0,2856,66352,42840,-23512
16589,0.0,0.0,0.0,2856,66356,42840,-23516
16590,0.0,0.0,0.0,2856,66360,42840,-23520
16591,0.0,0.0,0.0,2856,66364,42840,-23524
16592,0.0,0.0,0.0,2856,66368,42840,-23528
16593,0.0,0.0,0.0,2856,66372,42840,-23532
16594,1.0,1.0,1.0,2857,66376,42855,-23521
16595,0.0,0.0,0.2,2857,66380,42855,-23525
16596,0.0,0.0,0.0,2857,66384,42855,-23529
16597,0.0,0.0,0.0,2857,66388,42855,-23533
16598,1.0,1.0,1.0,2858,66392,42870,-23522
16599,1.0,1.0,1.0,2859,66396,42885,-23511
16600,0.0,0.0,0.0,2859,66400,42885,-23515
16601,0.0,0.0,0.0,2859,66404,42885,-23519
16602,1.0,1.0,1.0,2860,66408,42900,-23508
16603,0.0,0.0,0.0,2860,66412,42900,-23512
16604,0.0,0.0,0.0,2860,66416,42900,-23516
16605,0.0,0.0,0.0,2860,66420,42900,-23520
16606,0.0,0.0,0.0,2860,66424,42900,-23524
16607,1.0,1.0,1.0,2861,66428,42915,-23513
16608,0.0,0.0,0.0,2861,66432,42915,-23517
16609,1.0,1.0,1.0,2862,66436,42930,-23506
16610,0.0,0.0,0.0,2862,66440,42930,-23510
16611,0.0,0.0,0.0,2862,66444,42930,-23514
16612,0.0,0.0,0.0,2862,66448,42930,-23518
16613,0.0,0.0,0.0,2862,66452,42930,-23522
16614,1.0,0.0,0.3333333333333333,2863,66456,42945,-23511
16615,1.0,1.0,1.0,2864,66460,42960,-23500
16616,1.0,0.0,0.2,2865,66464,42975,-23489
16617,0.0,0.0,0.0,2865,66468,42975,-23493
16618,0.0,0.0,0.0,2865,66472,42975,-23497
16619,0.0,0.0,0.0,2865,66476,42975,-23501
16620,1.0,1.0,1.0,2866,66480,42990,-23490
16621,0.0,0.0,0.0,2866,66484,42990,-23494
16622,0.0,0.0,0.0,2866,66488,42990,-23498
16623,1.0,1.0,1.0,2867,66492,43005,-23487
16624,1.0,1.0,1.0,2868,66496,43020,-23476
16625,0.0,0.0,0.0,2868,66500,43020,-23480
16626,0.0,0.0,0.0,2868,66504,43020,-23484
16627,0.0,0.0,0.0,2868,66508,43020,-23488
16628,1.0,1.0,0.75,2869,66512,43035,-23477
16629,0.0,0.0,0.0,2869,66516,43035,-23481
16630,0.0,0.0,0.0,2869,66520,43035,-23485
16631,0.0,0.0,0.0,2869,66524,43035,-23489
16632,0.0,0.0,0.0,2869,66528,43035,-23493
16633,0.0,0.0,0.0,2869,66532,43035,-23497
16634,0.0,0.0,0.0,2869,66536,43035,-23501
16635,0.0,0.0,0.0,2869,66540,43035,-23505
16636,0.0,0.0,0.0,2869,66544,43035,-23509
16637,0.0,0.0,0.0,2869,66548,43035,-23513
16638,1.0,1.0,1.0,2870,66552,43050,-23502
16639,0.0,0.0,0.0,2870,66556,43050,-23506
16640,0.0,0.0,0.0,2870,66560,43050,-23510
16641,0.0,0.0,0.0,2870,66564,43050,-23514
16642,1.0,1.0,1.0,2871,66568,43065,-23503
16643,0.0,0.0,0.0,2871,66572,43065,-23507
16644,1.0,1.0,1.0,2872,66576,43080,-23496
16645,0.0,0.0,0.3333333333333333,2872,66580,43080,-23500
16646,0.0,0.0,0.3333333333333333,2872,66584,43080,-23504
16647,0.0,0.0,0.0,2872,66588,43080,-23508
16648,0.0,0.0,0.0,2872,66592,43080,-23512
16649,0.0,0.0,0.0,2872,66596,43080,-23516
16650,0.0,0.0,0.0,2872,66600,43080,-23520
16651,0.0,0.0,0.0,2872,66604,43080,-23524
16652,0.0,0.0,0.0,2872,66608,43080,-23528
16653,0.0,0.0,0.0,2872,66612,43080,-23532
16654,0.0,0.0,0.0,2872,66616,43080,-23536
16655,0.0,0.0,0.0,2872,66620,43080,-23540
16656,1.0,1.0,1.0,2873,66624,43095,-23529
16657,0.0,0.0,0.0,2873,66628,43095,-23533
16658,0.0,0.0,0.0,2873,66632,43095,-23537
16659,0.0,0.0,0.0,2873,66636,43095,-23541
16660,0.0,0.0,0.0,2873,66640,43095,-23545
16661,1.0,1.0,0.6666666666666666,2874,66644,43110,-23534
16662,1.0,1.0,1.0,2875,66648,43125,-23523
16663,0.0,0.0,0.4,2875,66652,43125,-23527
16664,0.0,0.0,0.0,2875,66656,43125,-23531
16665,0.0,0.0,0.0,2875,66660,43125,-23535
16666,0.0,0.0,0.0,2875,66664,43125,-23539
16667,0.0,0.0,0.0,2875,66668,43125,-23543
16668,0.0,0.0,0.0,2875,66672,43125,-23547
16669,0.0,0.0,0.0,2875,66676,43125,-23551
16670,0.0,0.0,0.0,2875,66680,43125,-23555
16671,1.0,1.0,1.0,2876,66684,43140,-23544
16672,0.0,0.0,0.0,2876,66688,43140,-23548
16673,0.0,0.0,0.0,2876,66692,43140,-23552
16674,1.0,1.0,1.0,2877,66696,43155,-23541
16675,1.0,1.0,1.0,2878,66700,43170,-23530
16676,0.0,0.0,0.0,2878,66704,43170,-23534
16677,1.0,1.0,0.6666666666666666,2879,66708,43185,-23523
16678,0.0,0.0,0.0,2879,66712,43185,-23527
16679,0.0,0.0,0.0,2879,66716,43185,-23531
16680,0.0,0.0,0.0,2879,66720,43185,-23535
16681,0.0,0.0,0.0,2879,66724,43185,-23539
16682,0.0,0.0,0.0,2879,66728,43185,-23543
16683,1.0,1.0,1.0,2880,66732,43200,-23532
16684,0.0,0.0,0.0,2880,66736,43200,-23536
16685,1.0,1.0,1.0,2881,66740,43215,-23525
16686,0.0,0.0,0.0,2881,66744,43215,-23529
16687,0.0,0.0,0.0,2881,66748,43215,-23533
16688,0.0,0.0,0.0,2881,66752,43215,-23537
16689,0.0,0.0,0.0,2881,66756,43215,-23541
16690,1.0,1.0,1.0,2882,66760,43230,-23530
16691,1.0,1.0,1.0,2883,66764,43245,-23519
16692,0.0,0.0,0.0,2883,66768,43245,-23523
16693,0.0,0.0,0.0,2883,66772,43245,-23527
16694,0.0,0.0,0.0,2883,66776,43245,-23531
16695,0.0,0.0,0.0,2883,66780,43245,-23535
16696,0.0,0.0,0.0,2883,66784,43245,-23539
16697,0.0,0.0,0.0,2883,66788,43245,-23543
16698,0.0,0.0,0.0,2883,66792,43245,-23547
16699,0.0,0.0,0.0,2883,66796,43245,-23551
16700,0.0,0.0,0.0,2883,66800,43245,-23555
16701,1.0,1.0,1.0,2884,66804,43260,-23544
16702,0.0,0.0,0.0,2884,66808,43260,-23548
16703,0.0,0.0,0.0,2884,66812,43260,-23552
16704,0.0,0.0,0.0,2884,66816,43260,-23556
16705,0.0,0.0,0.0,2884,66820,43260,-23560
16706,1.0,1.0,0.6,2885,66824,43275,-23549
16707,1.0,1.0,1.0,2886,66828,43290,-23538
16708,0.0,0.0,0.0,2886,66832,43290,-23542
16709,1.0,1.0,0.6666666666666666,2887,66836,43305,-23531
16710,0.0,0.0,0.0,2887,66840,43305,-23535
16711,0.0,0.0,0.0,2887,66844,43305,-23539
16712,0.0,0.0,0.0,2887,66848,43305,-23543
16713,0.0,0.0,0.0,2887,66852,43305,-23547
16714,1.0,1.0,1.0,2888,66856,43320,-23536
16715,0.0,0.0,0.0,2888,66860,43320,-23540
16716,0.0,0.0,0.0,2888,66864,43320,-23544
16717,0.0,0.0,0.0,2888,66868,43320,-23548
16718,0.0,0.0,0.0,2888,66872,43320,-23552
16719,0.0,0.0,0.0,2888,66876,43320,-23556
16720,1.0,1.0,1.0,2889,66880,43335,-23545
16721,0.0,0.0,0.0,2889,66884,43335,-23549
16722,0.0,0.0,0.0,2889,66888,43335,-23553
16723,1.0,1.0,1.0,2890,66892,43350,-23542
16724,0.0,0.0,0.0,2890,66896,43350,-23546
16725,1.0,1.0,1.0,2891,66900,43365,-23535
16726,0.0,0.0,0.0,2891,66904,43365,-23539
16727,0.0,0.0,0.0,2891,66908,43365,-23543
16728,0.0,0.0,0.0,2891,66912,43365,-23547
16729,0.0,0.0,0.0,2891,66916,43365,-23551
16730,0.0,0.0,0.0,2891,66920,43365,-23555
16731,0.0,0.0,0.0,2891,66924,43365,-23559
16732,0.0,0.0,0.25,2891,66928,43365,-23563
16733,0.0,0.0,0.0,2891,66932,43365,-23567
16734,1.0,1.0,0.6666666666666666,2892,66936,43380,-23556
16735,1.0,1.0,1.0,2893,66940,43395,-23545
16736,1.0,1.0,1.0,2894,66944,43410,-23534
16737,1.0,1.0,1.0,2895,66948,43425,-23523
16738,0.0,0.0,0.0,2895,66952,43425,-23527
16739,0.0,0.0,0.0,2895,66956,43425,-23531
16740,0.0,0.0,0.0,2895,66960,43425,-23535
16741,0.0,0.0,0.0,2895,66964,43425,-23539
16742,0.0,0.0,0.0,2895,66968,43425,-23543
16743,0.0,0.0,0.0,2895,66972,43425,-23547
16744,0.0,0.0,0.0,2895,66976,43425,-23551
16745,0.0,0.0,0.0,2895,66980,43425,-23555
16746,0.0,0.0,0.25,2895,66984,43425,-23559
16747,0.0,0.0,0.0,2895,66988,43425,-23563
16748,0.0,0.0,0.0,2895,66992,43425,-23567
16749,1.0,1.0,1.0,2896,66996,43440,-23556
16750,1.0,0.0,0.25,2897,67000,43455,-23545
16751,1.0,0.0,0.3333333333333333,2898,67004,43470,-23534
16752,0.0,0.0,0.0,2898,67008,43470,-23538
16753,1.0,1.0,0.6666666666666666,2899,67012,43485,-23527
16754,0.0,0.0,0.0,2899,67016,43485,-23531
16755,0.0,0.0,0.0,2899,67020,43485,-23535
16756,0.0,0.0,0.0,2899,67024,43485,-23539
16757,1.0,1.0,1.0,2900,67028,43500,-23528
16758,0.0,0.0,0.0,2900,67032,43500,-23532
16759,0.0,0.0,0.0,2900,67036,43500,-23536
16760,0.0,0.0,0.0,2900,67040,43500,-23540
16761,1.0,1.0,0.6666666666666666,2901,67044,43515,-23529
16762,0.0,0.0,0.0,2901,67048,43515,-23533
16763,1.0,1.0,1.0,2902,67052,43530,-23522
16764,1.0,1.0,1.0,2903,67056,43545,-23511
16765,0.0,0.0,0.0,2903,67060,43545,-23515
16766,0.0,0.0,0.0,2903,67064,43545,-23519
16767,1.0,1.0,1.0,2904,67068,43560,-23508
16768,0.0,0.0,0.0,2904,67072,43560,-23512
16769,0.0,0.0,0.0,2904,67076,43560,-23516
16770,0.0,0.0,0.0,2904,67080,43560,-23520
16771,0.0,0.0,0.0,2904,67084,43560,-23524
16772,0.0,0.0,0.0,2904,67088,43560,-23528
16773,1.0,1.0,0.6666666666666666,2905,67092,43575,-23517
16774,0.0,0.0,0.0,2905,67096,43575,-23521
16775,0.0,0.0,0.0,2905,67100,43575,-23525
16776,0.0,0.0,0.0,2905,67104,43575,-23529
16777,0.0,0.0,0.3333333333333333,2905,67108,43575,-23533
16778,1.0,1.0,1.0,2906,67112,43590,-23522
16779,0.0,0.0,0.4,2906,67116,43590,-23526
16780,0.0,0.0,0.0,2906,67120,43590,-23530
16781,1.0,1.0,0.75,2907,67124,43605,-23519
16782,0.0,0.0,0.0,2907,67128,43605,-23523
16783,0.0,0.0,0.0,2907,67132,43605,-23527
16784,0.0,0.0,0.0,2907,67136,43605,-23531
16785,0.0,0.0,0.0,2907,67140,43605,-23535
16786,0.0,0.0,0.0,2907,67144,43605,-23539
16787,0.0,0.0,0.0,2907,67148,43605,-23543
16788,0.0,0.0,0.0,2907,67152,43605,-23547
16789,0.0,0.0,0.0,2907,67156,43605,-23551
16790,0.0,0.0,0.0,2907,67160,43605,-23555
16791,1.0,1.0,0.8,2908,67164,43620,-23544
16792,0.0,0.0,0.0,2908,67168,43620,-23548
16793,0.0,0.0,0.3333333333333333,2908,67172,43620,-23552
16794,1.0,1.0,1.0,2909,67176,43635,-23541
16795,1.0,0.0,0.5,2910,67180,43650,-23530
16796,0.0,0.0,0.4,2910,67184,43650,-23534
16797,0.0,0.0,0.0,2910,67188,43650,-23538
16798,0.0,0.0,0.0,2910,67192,43650,-23542
16799,0.0,0.0,0.0,2910,67196,43650,-23546
16800,0.0,0.0,0.0,2910,67200,43650,-23550
16801,0.0,0.0,0.0,2910,67204,43650,-23554
16802,0.0,0.0,0.0,2910,67208,43650,-23558
16803,1.0,1.0,0.8,2911,67212,43665,-23547
16804,0.0,0.0,0.0,2911,67216,43665,-23551
16805,0.0,0.0,0.0,2911,67220,43665,-23555
16806,0.0,0.0,0.0,2911,67224,43665,-23559
16807,0.0,0.0,0.0,2911,67228,43665,-23563
16808,0.0,0.0,0.0,2911,67232,43665,-23567
16809,0.0,0.0,0.0,2911,67236,43665,-23571
16810,0.0,0.0,0.0,2911,67240,43665,-23575
16811,0.0,0.0,0.0,2911,67244,43665,-23579
16812,1.0,1.0,1.0,2912,67248,43680,-23568
16813,0.0,0.0,0.0,2912,67252,43680,-23572
16814,1.0,1.0,0.6666666666666666,2913,67256,43695,-23561
16815,0.0,0.0,0.0,2913,67260,43695,-23565
16816,1.0,1.0,0.6,2914,67264,43710,-23554
16817,0.0,0.0,0.0,2914,67268,43710,-23558
16818,0.0,0.0,0.3333333333333333,2914,67272,43710,-23562
16819,0.0,0.0,0.0,2914,67276,43710,-23566
16820,1.0,1.0,1.0,2915,67280,43725,-23555
16821,0.0,0.0,0.0,2915,67284,43725,-23559
16822,0.0,0.0,0.0,2915,67288,43725,-23563
16823,0.0,0.0,0.0,2915,67292,43725,-23567
16824,0.0,0.0,0.0,2915,67296,43725,-23571
16825,0.0,0.0,0.0,2915,67300,43725,-23575
16826,0.0,0.0,0.0,2915,67304,43725,-23579
16827,0.0,0.0,0.0,2915,67308,43725,-23583
16828,0.0,0.0,0.0,2915,67312,43725,-23587
16829,0.0,0.0,0.0,2915,67316,43725,-23591
16830,1.0,1.0,1.0,2916,67320,43740,-23580
16831,0.0,0.0,0.0,2916,67324,43740,-23584
16832,0.0,0.0,0.0,2916,67328,43740,-23588
16833,0.0,0.0,0.0,2916,67332,43740,-23592
16834,0.0,0.0,0.0,2916,67336,43740,-23596
16835,0.0,0.0,0.0,2916,67340,43740,-23600
16836,0.0,0.0,0.0,2916,67344,43740,-23604
16837,0.0,0.0,0.0,2916,67348,43740,-23608
16838,0.0,0.0,0.0,2916,67352,43740,-23612
16839,0.0,0.0,0.0,2916,67356,43740,-23616
16840,1.0,1.0,1.0,2917,67360,43755,-23605
16841,0.0,0.0,0.0,2917,67364,43755,-23609
16842,0.0,0.0,0.0,2917,67368,43755,-23613
16843,0.0,0.0,0.0,2917,67372,43755,-23617
16844,1.0,1.0,1.0,2918,67376,43770,-23606
16845,1.0,1.0,1.0,2919,67380,43785,-23595
16846,0.0,0.0,0.0,2919,67384,43785,-23599
16847,0.0,1.0,0.6666666666666666,2919,67388,43785,-23603
16848,0.0,0.0,0.0,2919,67392,43785,-23607
16849,0.0,0.0,0.0,2919,67396,43785,-23611
16850,1.0,1.0,1.0,2920,67400,43800,-23600
16851,0.0,1.0,0.6666666666666666,2920,67404,43800,-23604
16852,0.0,0.0,0.0,2920,67408,43800,-23608
16853,0.0,0.0,0.0,2920,67412,43800,-23612
16854,0.0,0.0,0.0,2920,67416,43800,-23616
16855,0.0,0.0,0.0,2920,67420,43800,-23620
16856,0.0,0.0,0.0,2920,67424,43800,-23624
16857,1.0,1.0,1.0,2921,67428,43815,-23613
16858,0.0,0.0,0.3333333333333333,2921,67432,43815,-23617
16859,0.0,0.0,0.0,2921,67436,43815,-23621
16860,0.0,0.0,0.0,2921,67440,43815,-23625
16861,0.0,0.0,0.0,2921,67444,43815,-23629
16862,0.0,0.0,0.0,2921,67448,43815,-23633
16863,1.0,1.0,1.0,2922,67452,43830,-23622
16864,0.0,0.0,0.0,2922,67456,43830,-23626
16865,0.0,0.0,0.0,2922,67460,43830,-23630
16866,0.0,0.0,0.0,2922,67464,43830,-23634
16867,0.0,0.0,0.0,2922,67468,43830,-23638
16868,0.0,0.0,0.0,2922,67472,43830,-23642
16869,0.0,0.0,0.0,2922,67476,43830,-23646
16870,0.0,0.0,0.0,2922,67480,43830,-23650
16871,0.0,0.0,0.0,2922,67484,43830,-23654
16872,0.0,0.0,0.0,2922,67488,43830,-23658
16873,0.0,0.0,0.0,2922,67492,43830,-23662
16874,0.0,0.0,0.0,2922,67496,43830,-23666
16875,0.0,0.0,0.0,2922,67500,43830,-23670
16876,0.0,0.0,0.0,2922,67504,43830,-23674
16877,0.0,0.0,0.0,2922,67508,43830,-23678
16878,0.0,0.0,0.0,2922,67512,43830,-23682
16879,0.0,0.0,0.0,2922,67516,43830,-23686
16880,0.0,0.0,0.0,2922,67520,43830,-23690
16881,1.0,1.0,1.0,2923,67524,43845,-23679
16882,0.0,0.0,0.0,2923,67528,43845,-23683
16883,0.0,0.0,0.0,2923,67532,43845,-23687
16884,0.0,0.0,0.0,2923,67536,43845,-23691
16885,0.0,0.0,0.0,2923,67540,43845,-23695
16886,0.0,0.0,0.0,2923,67544,43845,-23699
16887,0.0,0.0,0.0,2923,67548,43845,-23703
16888,0.0,0.0,0.0,2923,67552,43845,-23707
16889,0.0,0.0,0.0,2923,67556,43845,-23711
16890,0.0,0.0,0.0,2923,67560,43845,-23715
16891,0.0,0.0,0.0,2923,67564,43845,-23719
16892,0.0,0.0,0.0,2923,67568,43845,-23723
16893,0.0,0.0,0.0,2923,67572,43845,-23727
16894,0.0,1.0,0.75,2923,67576,43845,-23731
16895,0.0,0.0,0.0,2923,67580,43845,-23735
16896,0.0,0.0,0.0,2923,67584,43845,-23739
16897,0.0,0.0,0.0,2923,67588,43845,-23743
16898,0.0,0.0,0.0,2923,67592,43845,-23747
16899,0.0,0.0,0.0,2923,67596,43845,-23751
16900,0.0,0.0,0.3333333333333333,2923,67600,43845,-23755
16901,0.0,0.0,0.0,2923,67604,43845,-23759
16902,0.0,0.0,0.0,2923,67608,43845,-23763
16903,0.0,0.0,0.0,2923,67612,43845,-23767
16904,0.0,0.0,0.0,2923,67616,43845,-23771
16905,0.0,0.0,0.0,2923,67620,43845,-23775
16906,0.0,0.0,0.0,2923,67624,43845,-23779
16907,0.0,0.0,0.0,2923,67628,43845,-23783
16908,0.0,0.0,0.0,2923,67632,43845,-23787
16909,0.0,0.0,0.0,2923,67636,43845,-23791
16910,0.0,0.0,0.0,2923,67640,43845,-23795
16911,0.0,0.0,0.0,2923,67644,43845,-23799
16912,0.0,0.0,0.0,2923,67648,43845,-23803
16913,0.0,0.0,0.0,2923,67652,43845,-23807
16914,1.0,1.0,1.0,2924,67656,43860,-23796
16915,1.0,1.0,0.6666666666666666,2925,67660,43875,-23785
16916,0.0,0.0,0.0,2925,67664,43875,-23789
16917,0.0,0.0,0.0,2925,67668,43875,-23793
16918,1.0,0.0,0.5,2926,67672,43890,-23782
16919,0.0,0.0,0.0,2926,67676,43890,-23786
16920,1.0,1.0,1.0,2927,67680,43905,-23775
16921,0.0,0.0,0.0,2927,67684,43905,-23779
16922,0.0,0.0,0.0,2927,67688,43905,-23783
16923,0.0,0.0,0.0,2927,67692,43905,-23787
16924,0.0,0.0,0.0,2927,67696,43905,-23791
16925,0.0,0.0,0.0,2927,67700,43905,-23795
16926,0.0,0.0,0.0,2927,67704,43905,-23799
16927,0.0,0.0,0.0,2927,67708,43905,-23803
16928,0.0,0.0,0.0,2927,67712,43905,-23807
16929,0.0,0.0,0.0,2927,67716,43905,-23811
16930,0.0,0.0,0.0,2927,67720,43905,-23815
16931,0.0,0.0,0.0,2927,67724,43905,-23819
16932,0.0,0.0,0.0,2927,67728,43905,-23823
16933,0.0,0.0,0.0,2927,67732,43905,-23827
16934,0.0,0.0,0.0,2927,67736,43905,-23831
16935,0.0,0.0,0.0,2927,67740,43905,-23835
16936,0.0,0.0,0.0,2927,67744,43905,-23839
16937,0.0,0.0,0.0,2927,67748,43905,-23843
16938,0.0,0.0,0.0,2927,67752,43905,-23847
16939,0.0,0.0,0.0,2927,67756,43905,-23851
16940,1.0,1.0,1.0,2928,67760,43920,-23840
16941,0.0,0.0,0.0,2928,67764,43920,-23844
16942,1.0,1.0,1.0,2929,67768,43935,-23833
16943,0.0,0.0,0.0,2929,67772,43935,-23837
16944,0.0,1.0,0.6666666666666666,2929,67776,43935,-23841
16945,1.0,1.0,1.0,2930,67780,43950,-23830
16946,0.0,0.0,0.0,2930,67784,43950,-23834
16947,0.0,0.0,0.0,2930,67788,43950,-23838
16948,0.0,0.0,0.0,2930,67792,43950,-23842
16949,0.0,0.0,0.0,2930,67796,43950,-23846
16950,1.0,1.0,1.0,2931,67800,43965,-23835
16951,0.0,0.0,0.0,2931,67804,43965,-23839
16952,0.0,0.0,0.0,2931,67808,43965,-23843
16953,0.0,0.0,0.0,2931,67812,43965,-23847
16954,0.0,0.0,0.0,2931,67816,43965,-23851
16955,0.0,0.0,0.0,2931,67820,43965,-23855
16956,0.0,0.0,0.0,2931,67824,43965,-23859
16957,0.0,0.0,0.0,2931,67828,43965,-23863
16958,1.0,1.0,1.0,2932,67832,43980,-23852
16959,1.0,1.0,1.0,2933,67836,43995,-23841
16960,0.0,0.0,0.0,2933,67840,43995,-23845
16961,0.0,0.0,0.0,2933,67844,43995,-23849
16962,0.0,0.0,0.0,2933,67848,43995,-23853
16963,0.0,0.0,0.0,2933,67852,43995,-23857
16964,0.0,0.0,0.0,2933,67856,43995,-23861
16965,0.0,0.0,0.0,2933,67860,43995,-23865
16966,0.0,0.0,0.0,2933,67864,43995,-23869
16967,0.0,0.0,0.0,2933,67868,43995,-23873
16968,0.0,0.0,0.0,2933,67872,43995,-23877
16969,0.0,0.0,0.0,2933,67876,43995,-23881
16970,0.0,0.0,0.0,2933,67880,43995,-23885
16971,0.0,0.0,0.0,2933,67884,43995,-23889
16972,0.0,0.0,0.0,2933,67888,43995,-23893
16973,1.0,1.0,1.0,2934,67892,44010,-23882
16974,0.0,0.0,0.0,2934,67896,44010,-23886
16975,1.0,1.0,1.0,2935,67900,44025,-23875
16976,0.0,0.0,0.0,2935,67904,44025,-23879
16977,1.0,1.0,1.0,2936,67908,44040,-23868
16978,0.0,0.0,0.0,2936,67912,44040,-23872
16979,0.0,0.0,0.0,2936,67916,44040,-23876
16980,0.0,0.0,0.0,2936,67920,44040,-23880
16981,0.0,0.0,0.0,2936,67924,44040,-23884
16982,1.0,0.0,0.3333333333333333,2937,67928,44055,-23873
16983,0.0,0.0,0.0,2937,67932,44055,-23877
16984,0.0,0.0,0.0,2937,67936,44055,-23881
16985,0.0,0.0,0.0,2937,67940,44055,-23885
16986,0.0,0.0,0.0,2937,67944,44055,-23889
16987,1.0,1.0,0.6666666666666666,2938,67948,44070,-23878
16988,0.0,0.0,0.5,2938,67952,44070,-23882
16989,0.0,0.0,0.0,2938,67956,44070,-23886
16990,0.0,0.0,0.0,2938,67960,44070,-23890
16991,0.0,0.0,0.0,2938,67964,44070,-23894
16992,0.0,0.0,0.0,2938,67968,44070,-23898
16993,1.0,1.0,1.0,2939,67972,44085,-23887
16994,0.0,0.0,0.0,2939,67976,44085,-23891
16995,1.0,1.0,1.0,2940,67980,44100,-23880
16996,0.0,0.0,0.0,2940,67984,44100,-23884
16997,0.0,0.0,0.0,2940,67988,44100,-23888
16998,0.0,0.0,0.0,2940,67992,44100,-23892
16999,0.0,0.0,0.0,2940,67996,44100,-23896
17000,0.0,0.0,0.0,2940,68000,44100,-23900
17001,0.0,0.0,0.0,2940,68004,44100,-23904
17002,0.0,0.0,0.0,2940,68008,44100,-23908
17003,0.0,0.0,0.0,2940,68012,44100,-23912
17004,0.0,0.0,0.2,2940,68016,44100,-23916
17005,0.0,0.0,0.0,2940,68020,44100,-23920
17006,0.0,0.0,0.0,2940,68024,44100,-23924
17007,0.0,0.0,0.0,2940,68028,44100,-23928
17008,0.0,0.0,0.0,2940,68032,44100,-23932
17009,0.0,0.0,0.0,2940,68036,44100,-23936
17010,0.0,0.0,0.0,2940,68040,44100,-23940
17011,0.0,0.0,0.0,2940,68044,44100,-23944
17012,0.0,0.0,0.0,2940,68048,44100,-23948
17013,0.0,0.0,0.0,2940,68052,44100,-23952
17014,0.0,0.0,0.0,2940,68056,44100,-23956
17015,0.0,1.0,0.6666666666666666,2940,68060,44100,-23960
17016,0.0,0.0,0.0,2940,68064,44100,-23964
17017,1.0,1.0,1.0,2941,68068,44115,-23953
17018,0.0,0.0,0.0,2941,68072,44115,-23957
17019,0.0,0.0,0.0,2941,68076,44115,-23961
17020,0.0,0.0,0.0,2941,68080,44115,-23965
17021,1.0,1.0,1.0,2942,68084,44130,-23954
17022,0.0,0.0,0.0,2942,68088,44130,-23958
17023,0.0,0.0,0.0,2942,68092,44130,-23962
17024,0.0,0.0,0.0,2942,68096,44130,-23966
17025,0.0,0.0,0.0,2942,68100,44130,-23970
17026,0.0,1.0,0.75,2942,68104,44130,-23974
17027,0.0,0.0,0.0,2942,68108,44130,-23978
17028,0.0,0.0,0.0,2942,68112,44130,-23982
17029,0.0,0.0,0.0,2942,68116,44130,-23986
17030,0.0,0.0,0.0,2942,68120,44130,-23990
17031,0.0,0.0,0.0,2942,68124,44130,-23994
17032,0.0,0.0,0.4,2942,68128,44130,-23998
17033,0.0,0.0,0.0,2942,68132,44130,-24002
17034,0.0,0.0,0.0,2942,68136,44130,-24006
17035,0.0,0.0,0.0,2942,68140,44130,-24010
17036,0.0,0.0,0.0,2942,68144,44130,-24014
17037,0.0,0.0,0.3333333333333333,2942,68148,44130,-24018
17038,0.0,0.0,0.0,2942,68152,44130,-24022
17039,0.0,0.0,0.0,2942,68156,44130,-24026
17040,0.0,0.0,0.0,2942,68160,44130,-24030
17041,0.0,0.0,0.0,2942,68164,44130,-24034
17042,0.0,0.0,0.0,2942,68168,44130,-24038
17043,0.0,0.0,0.0,2942,68172,44130,-24042
17044,0.0,0.0,0.0,2942,68176,44130,-24046
17045,0.0,0.0,0.0,2942,68180,44130,-24050
17046,1.0,1.0,1.0,2943,68184,44145,-24039
17047,0.0,0.0,0.0,2943,68188,44145,-24043
17048,0.0,0.0,0.0,2943,68192,44145,-24047
17049,0.0,0.0,0.0,2943,68196,44145,-24051
17050,1.0,1.0,1.0,2944,68200,44160,-24040
17051,0.0,0.0,0.0,2944,68204,44160,-24044
17052,1.0,1.0,0.6666666666666666,2945,68208,44175,-24033
17053,0.0,0.0,0.4,2945,68212,44175,-24037
17054,0.0,0.0,0.0,2945,68216,44175,-24041
17055,0.0,0.0,0.0,2945,68220,44175,-24045
17056,0.0,0.0,0.0,2945,68224,44175,-24049
17057,0.0,0.0,0.0,2945,68228,44175,-24053
17058,0.0,0.0,0.0,2945,68232,44175,-24057
17059,1.0,1.0,1.0,2946,68236,44190,-24046
17060,0.0,0.0,0.0,2946,68240,44190,-24050
17061,1.0,1.0,1.0,2947,68244,44205,-24039
17062,1.0,1.0,1.0,2948,68248,44220,-24028
17063,0.0,0.0,0.0,2948,68252,44220,-24032
17064,0.0,0.0,0.0,2948,68256,44220,-24036
17065,0.0,0.0,0.3333333333333333,2948,68260,44220,-24040
17066,0.0,0.0,0.0,2948,68264,44220,-24044
17067,0.0,0.0,0.0,2948,68268,44220,-24048
17068,0.0,0.0,0.0,2948,68272,44220,-24052
17069,0.0,0.0,0.0,2948,68276,44220,-24056
17070,0.0,0.0,0.0,2948,68280,44220,-24060
17071,0.0,0.0,0.0,2948,68284,44220,-24064
17072,0.0,0.0,0.0,2948,68288,44220,-24068
17073,0.0,0.0,0.0,2948,68292,44220,-24072
17074,0.0,0.0,0.0,2948,68296,44220,-24076
17075,0.0,0.0,0.0,2948,68300,44220,-24080
17076,0.0,0.0,0.0,2948,68304,44220,-24084
17077,0.0,0.0,0.0,2948,68308,44220,-24088
17078,0.0,0.0,0.0,2948,68312,44220,-24092
17079,0.0,0.0,0.0,2948,68316,44220,-24096
17080,0.0,0.0,0.0,2948,68320,44220,-24100
17081,0.0,0.0,0.0,2948,68324,44220,-24104
17082,0.0,0.0,0.0,2948,68328,44220,-24108
17083,0.0,0.0,0.0,2948,68332,44220,-24112
17084,0.0,0.0,0.0,2948,68336,44220,-24116
17085,0.0,0.0,0.0,2948,68340,44220,-24120
17086,0.0,0.0,0.0,2948,68344,44220,-24124
17087,1.0,1.0,1.0,2949,68348,44235,-24113
17088,0.0,1.0,0.75,2949,68352,44235,-24117
17089,0.0,0.0,0.25,2949,68356,44235,-24121
17090,0.0,0.0,0.25,2949,68360,44235,-24125
17091,0.0,0.0,0.0,2949,68364,44235,-24129
17092,0.0,0.0,0.0,2949,68368,44235,-24133
17093,0.0,0.0,0.0,2949,68372,44235,-24137
17094,0.0,0.0,0.0,2949,68376,44235,-24141
17095,0.0,0.0,0.0,2949,68380,44235,-24145
17096,0.0,0.0,0.0,2949,68384,44235,-24149
17097,0.0,0.0,0.0,2949,68388,44235,-24153
17098,0.0,0.0,0.0,2949,68392,44235,-24157
17099,0.0,0.0,0.0,2949,68396,44235,-24161
17100,1.0,1.0,1.0,2950,68400,44250,-24150
17101,0.0,0.0,0.0,2950,68404,44250,-24154
17102,0.0,0.0,0.0,2950,68408,44250,-24158
17103,0.0,0.0,0.0,2950,68412,44250,-24162
17104,1.0,0.0,0.2,2951,68416,44265,-24151
17105,0.0,0.0,0.0,2951,68420,44265,-24155
17106,1.0,1.0,1.0,2952,68424,44280,-24144
17107,0.0,0.0,0.0,2952,68428,44280,-24148
17108,0.0,0.0,0.0,2952,68432,44280,-24152
17109,0.0,0.0,0.4,2952,68436,44280,-24156
17110,0.0,0.0,0.0,2952,68440,44280,-24160
17111,0.0,0.0,0.0,2952,68444,44280,-24164
17112,0.0,0.0,0.0,2952,68448,44280,-24168
17113,0.0,0.0,0.0,2952,68452,44280,-24172
17114,0.0,0.0,0.0,2952,68456,44280,-24176
17115,0.0,0.0,0.0,2952,68460,44280,-24180
17116,0.0,0.0,0.0,2952,68464,44280,-24184
17117,0.0,0.0,0.0,2952,68468,44280,-24188
17118,0.0,0.0,0.0,2952,68472,44280,-24192
17119,0.0,0.0,0.0,2952,68476,44280,-24196
17120,0.0,0.0,0.0,2952,68480,44280,-24200
17121,0.0,0.0,0.0,2952,68484,44280,-24204
17122,0.0,0.0,0.0,2952,68488,44280,-24208
17123,0.0,0.0,0.0,2952,68492,44280,-24212
17124,0.0,0.0,0.0,2952,68496,44280,-24216
17125,1.0,1.0,1.0,2953,68500,44295,-24205
17126,0.0,0.0,0.0,2953,68504,44295,-24209
17127,0.0,0.0,0.0,2953,68508,44295,-24213
17128,0.0,0.0,0.0,2953,68512,44295,-24217
17129,0.0,0.0,0.0,2953,68516,44295,-24221
17130,1.0,1.0,1.0,2954,68520,44310,-24210
17131,1.0,1.0,0.6666666666666666,2955,68524,44325,-24199
17132,0.0,0.0,0.0,2955,68528,44325,-24203
17133,0.0,0.0,0.0,2955,68532,44325,-24207
17134,0.0,0.0,0.0,2955,68536,44325,-24211
17135,0.0,0.0,0.0,2955,68540,44325,-24215
17136,0.0,0.0,0.0,2955,68544,44325,-24219
17137,0.0,0.0,0.0,2955,68548,44325,-24223
17138,0.0,0.0,0.0,2955,68552,44325,-24227
17139,0.0,0.0,0.0,2955,68556,44325,-24231
17140,1.0,1.0,1.0,2956,68560,44340,-24220
17141,0.0,0.0,0.0,2956,68564,44340,-24224
17142,0.0,0.0,0.0,2956,68568,44340,-24228
17143,0.0,0.0,0.0,2956,68572,44340,-24232
17144,0.0,0.0,0.0,2956,68576,44340,-24236
17145,0.0,0.0,0.0,2956,68580,44340,-24240
17146,0.0,0.0,0.0,2956,68584,44340,-24244
17147,0.0,0.0,0.0,2956,68588,44340,-24248
17148,0.0,0.0,0.0,2956,68592,44340,-24252
17149,0.0,0.0,0.0,2956,68596,44340,-24256
17150,0.0,0.0,0.0,2956,68600,44340,-24260
17151,0.0,0.0,0.0,2956,68604,44340,-24264
17152,0.0,0.0,0.0,2956,68608,44340,-24268
17153,1.0,1.0,1.0,2957,68612,44355,-24257
17154,0.0,0.0,0.0,2957,68616,44355,-24261
17155,1.0,1.0,1.0,2958,68620,44370,-24250
17156,0.0,0.0,0.0,2958,68624,44370,-24254
17157,1.0,1.0,1.0,2959,68628,44385,-24243
17158,0.0,0.0,0.0,2959,68632,44385,-24247
17159,0.0,0.0,0.0,2959,68636,44385,-24251
17160,1.0,1.0,0.8,2960,68640,44400,-24240
17161,0.0,0.0,0.0,2960,68644,44400,-24244
17162,0.0,0.0,0.0,2960,68648,44400,-24248
17163,0.0,0.0,0.0,2960,68652,44400,-24252
17164,0.0,0.0,0.0,2960,68656,44400,-24256
17165,0.0,0.0,0.0,2960,68660,44400,-24260
17166,0.0,0.0,0.0,2960,68664,44400,-24264
17167,0.0,0.0,0.0,2960,68668,44400,-24268
17168,0.0,0.0,0.0,2960,68672,44400,-24272
17169,0.0,0.0,0.0,2960,68676,44400,-24276
17170,0.0,0.0,0.0,2960,68680,44400,-24280
17171,0.0,0.0,0.0,2960,68684,44400,-24284
17172,0.0,0.0,0.0,2960,68688,44400,-24288
17173,0.0,0.0,0.3333333333333333,2960,68692,44400,-24292
17174,0.0,0.0,0.0,2960,68696,44400,-24296
17175,0.0,0.0,0.0,2960,68700,44400,-24300
17176,0.0,0.0,0.0,2960,68704,44400,-24304
17177,0.0,0.0,0.0,2960,68708,44400,-24308
17178,0.0,0.0,0.0,2960,68712,44400,-24312
17179,0.0,0.0,0.0,2960,68716,44400,-24316
17180,0.0,0.0,0.0,2960,68720,44400,-24320
17181,1.0,1.0,1.0,2961,68724,44415,-24309
17182,0.0,0.0,0.2,2961,68728,44415,-24313
17183,1.0,1.0,1.0,2962,68732,44430,-24302
17184,0.0,0.0,0.0,2962,68736,44430,-24306
17185,0.0,0.0,0.0,2962,68740,44430,-24310
17186,0.0,0.0,0.0,2962,68744,44430,-24314
17187,0.0,0.0,0.0,2962,68748,44430,-24318
17188,0.0,0.0,0.0,2962,68752,44430,-24322
17189,1.0,1.0,1.0,2963,68756,44445,-24311
17190,0.0,0.0,0.0,2963,68760,44445,-24315
17191,1.0,1.0,0.8,2964,68764,44460,-24304
17192,0.0,0.0,0.0,2964,68768,44460,-24308
17193,1.0,1.0,1.0,2965,68772,44475,-24297
17194,1.0,0.0,0.3333333333333333,2966,68776,44490,-24286
17195,0.0,0.0,0.0,2966,68780,44490,-24290
17196,0.0,0.0,0.0,2966,68784,44490,-24294
17197,0.0,0.0,0.0,2966,68788,44490,-24298
17198,0.0,1.0,0.6,2966,68792,44490,-24302
17199,0.0,0.0,0.0,2966,68796,44490,-24306
17200,0.0,0.0,0.0,2966,68800,44490,-24310
17201,0.0,0.0,0.0,2966,68804,44490,-24314
17202,0.0,0.0,0.0,2966,68808,44490,-24318
17203,0.0,0.0,0.0,2966,68812,44490,-24322
17204,0.0,0.0,0.0,2966,68816,44490,-24326
17205,1.0,1.0,0.6666666666666666,2967,68820,44505,-24315
17206,0.0,0.0,0.0,2967,68824,44505,-24319
17207,0.0,0.0,0.0,2967,68828,44505,-24323
17208,1.0,1.0,1.0,2968,68832,44520,-24312
17209,0.0,0.0,0.0,2968,68836,44520,-24316
17210,0.0,0.0,0.0,2968,68840,44520,-24320
17211,0.0,0.0,0.0,2968,68844,44520,-24324
17212,0.0,0.0,0.0,2968,68848,44520,-24328
17213,0.0,0.0,0.0,2968,68852,44520,-24332
17214,0.0,0.0,0.0,2968,68856,44520,-24336
17215,1.0,1.0,1.0,2969,68860,44535,-24325
17216,0.0,0.0,0.0,2969,68864,44535,-24329
17217,0.0,0.0,0.0,2969,68868,44535,-24333
17218,0.0,0.0,0.0,2969,68872,44535,-24337
17219,0.0,0.0,0.0,2969,68876,44535,-24341
17220,0.0,0.0,0.0,2969,68880,44535,-24345
17221,0.0,0.0,0.0,2969,68884,44535,-24349
17222,0.0,0.0,0.0,2969,68888,44535,-24353
17223,1.0,1.0,1.0,2970,68892,44550,-24342
17224,0.0,1.0,0.75,2970,68896,44550,-24346
17225,0.0,0.0,0.0,2970,68900,44550,-24350
17226,0.0,0.0,0.0,2970,68904,44550,-24354
17227,0.0,0.0,0.0,2970,68908,44550,-24358
17228,0.0,0.0,0.2,2970,68912,44550,-24362
17229,0.0,0.0,0.0,2970,68916,44550,-24366
17230,0.0,0.0,0.0,2970,68920,44550,-24370
17231,0.0,0.0,0.0,2970,68924,44550,-24374
17232,0.0,0.0,0.0,2970,68928,44550,-24378
17233,0.0,0.0,0.0,2970,68932,44550,-24382
17234,0.0,0.0,0.0,2970,68936,44550,-24386
17235,0.0,0.0,0.0,2970,68940,44550,-24390
17236,1.0,1.0,1.0,2971,68944,44565,-24379
17237,1.0,1.0,1.0,2972,68948,44580,-24368
17238,1.0,1.0,1.0,2973,68952,44595,-24357
17239,0.0,0.0,0.0,2973,68956,44595,-24361
17240,0.0,0.0,0.0,2973,68960,44595,-24365
17241,0.0,0.0,0.0,2973,68964,44595,-24369
17242,0.0,0.0,0.0,2973,68968,44595,-24373
17243,1.0,1.0,1.0,2974,68972,44610,-24362
17244,0.0,0.0,0.0,2974,68976,44610,-24366
17245,1.0,1.0,1.0,2975,68980,44625,-24355
17246,0.0,0.0,0.0,2975,68984,44625,-24359
17247,0.0,0.0,0.0,2975,68988,44625,-24363
17248,1.0,0.0,0.4,2976,68992,44640,-24352
17249,0.0,0.0,0.0,2976,68996,44640,-24356
17250,0.0,0.0,0.0,2976,69000,44640,-24360
17251,0.0,0.0,0.0,2976,69004,44640,-24364
17252,1.0,1.0,1.0,2977,69008,44655,-24353
17253,0.0,0.0,0.0,2977,69012,44655,-24357
17254,0.0,0.0,0.0,2977,69016,44655,-24361
17255,0.0,0.0,0.0,2977,69020,44655,-24365
17256,0.0,0.0,0.0,2977,69024,44655,-24369
17257,0.0,0.0,0.0,2977,69028,44655,-24373
17258,0.0,0.0,0.0,2977,69032,44655,-24377
17259,1.0,1.0,1.0,2978,69036,44670,-24366
17260,0.0,0.0,0.0,2978,69040,44670,-24370
17261,0.0,0.0,0.0,2978,69044,44670,-24374
17262,0.0,0.0,0.0,2978,69048,44670,-24378
17263,1.0,1.0,1.0,2979,69052,44685,-24367
17264,0.0,0.0,0.0,2979,69056,44685,-24371
17265,0.0,0.0,0.0,2979,69060,44685,-24375
17266,0.0,1.0,0.6666666666666666,2979,69064,44685,-24379
17267,0.0,0.0,0.0,2979,69068,44685,-24383
17268,0.0,0.0,0.3333333333333333,2979,69072,44685,-24387
17269,0.0,0.0,0.0,2979,69076,44685,-24391
17270,0.0,0.0,0.3333333333333333,2979,69080,44685,-24395
17271,0.0,0.0,0.0,2979,69084,44685,-24399
17272,0.0,0.0,0.0,2979,69088,44685,-24403
17273,0.0,0.0,0.0,2979,69092,44685,-24407
17274,0.0,0.0,0.0,2979,69096,44685,-24411
17275,0.0,0.0,0.3333333333333333,2979,69100,44685,-24415
17276,0.0,0.0,0.0,2979,69104,44685,-24419
17277,1.0,1.0,1.0,2980,69108,44700,-24408
17278,0.0,0.0,0.0,2980,69112,44700,-24412
17279,0.0,0.0,0.0,2980,69116,44700,-24416
17280,0.0,0.0,0.0,2980,69120,44700,-24420
17281,0.0,1.0,0.75,2980,69124,44700,-24424
17282,0.0,0.0,0.0,2980,69128,44700,-24428
17283,0.0,0.0,0.0,2980,69132,44700,-24432
17284,0.0,0.0,0.0,2980,69136,44700,-24436
17285,1.0,1.0,0.6666666666666666,2981,69140,44715,-24425
17286,0.0,0.0,0.0,2981,69144,44715,-24429
17287,0.0,0.0,0.5,2981,69148,44715,-24433
17288,0.0,0.0,0.0,2981,69152,44715,-24437
17289,0.0,0.0,0.0,2981,69156,44715,-24441
17290,0.0,0.0,0.0,2981,69160,44715,-24445
17291,1.0,1.0,1.0,2982,69164,44730,-24434
17292,0.0,0.0,0.0,2982,69168,44730,-24438
17293,0.0,0.0,0.0,2982,69172,44730,-24442
17294,0.0,0.0,0.0,2982,69176,44730,-24446
17295,0.0,0.0,0.0,2982,69180,44730,-24450
17296,0.0,0.0,0.0,2982,69184,44730,-24454
17297,1.0,1.0,1.0,2983,69188,44745,-24443
17298,0.0,0.0,0.0,2983,69192,44745,-24447
17299,0.0,0.0,0.0,2983,69196,44745,-24451
17300,0.0,0.0,0.0,2983,69200,44745,-24455
17301,1.0,1.0,0.6666666666666666,2984,69204,44760,-24444
17302,0.0,0.0,0.0,2984,69208,44760,-24448
17303,1.0,1.0,0.6666666666666666,2985,69212,44775,-24437
17304,0.0,0.0,0.0,2985,69216,44775,-24441
17305,0.0,0.0,0.0,2985,69220,44775,-24445
17306,0.0,0.0,0.0,2985,69224,44775,-24449
17307,0.0,0.0,0.0,2985,69228,44775,-24453
17308,1.0,1.0,1.0,2986,69232,44790,-24442
17309,0.0,0.0,0.0,2986,69236,44790,-24446
17310,1.0,1.0,1.0,2987,69240,44805,-24435
17311,0.0,0.0,0.0,2987,69244,44805,-24439
17312,0.0,0.0,0.0,2987,69248,44805,-24443
17313,0.0,0.0,0.0,2987,69252,44805,-24447
17314,0.0,0.0,0.0,2987,69256,44805,-24451
17315,0.0,0.0,0.0,2987,69260,44805,-24455
17316,0.0,0.0,0.0,2987,69264,44805,-24459
17317,1.0,1.0,1.0,2988,69268,44820,-24448
17318,0.0,0.0,0.0,2988,69272,44820,-24452
17319,1.0,1.0,0.6666666666666666,2989,69276,44835,-24441
17320,0.0,0.0,0.0,2989,69280,44835,-24445
17321,0.0,0.0,0.0,2989,69284,44835,-24449
17322,0.0,0.0,0.0,2989,69288,44835,-24453
17323,0.0,0.0,0.0,2989,69292,44835,-24457
17324,0.0,0.0,0.0,2989,69296,44835,-24461
17325,0.0,0.0,0.0,2989,69300,44835,-24465
17326,0.0,0.0,0.0,2989,69304,44835,-24469
17327,0.0,0.0,0.0,2989,69308,44835,-24473
17328,1.0,0.0,0.3333333333333333,2990,69312,44850,-24462
17329,0.0,0.0,0.0,2990,69316,44850,-24466
17330,0.0,0.0,0.0,2990,69320,44850,-24470
17331,0.0,0.0,0.0,2990,69324,44850,-24474
17332,0.0,0.0,0.4,2990,69328,44850,-24478
17333,0.0,0.0,0.0,2990,69332,44850,-24482
17334,0.0,0.0,0.0,2990,69336,44850,-24486
17335,0.0,0.0,0.2,2990,69340,44850,-24490
17336,0.0,0.0,0.0,2990,69344,44850,-24494
17337,0.0,0.0,0.0,2990,69348,44850,-24498
17338,0.0,0.0,0.0,2990,69352,44850,-24502
17339,0.0,0.0,0.0,2990,69356,44850,-24506
17340,1.0,1.0,1.0,2991,69360,44865,-24495
17341,0.0,0.0,0.0,2991,69364,44865,-24499
17342,0.0,0.0,0.0,2991,69368,44865,-24503
17343,0.0,0.0,0.0,2991,69372,44865,-24507
17344,0.0,0.0,0.0,2991,69376,44865,-24511
17345,0.0,0.0,0.0,2991,69380,44865,-24515
17346,0.0,0.0,0.0,2991,69384,44865,-24519
17347,0.0,0.0,0.0,2991,69388,44865,-24523
17348,0.0,0.0,0.0,2991,69392,44865,-24527
17349,0.0,0.0,0.0,2991,69396,44865,-24531
17350,1.0,1.0,1.0,2992,69400,44880,-24520
17351,0.0,0.0,0.0,2992,69404,44880,-24524
17352,0.0,0.0,0.0,2992,69408,44880,-24528
17353,0.0,0.0,0.0,2992,69412,44880,-24532
17354,0.0,0.0,0.0,2992,69416,44880,-24536
17355,0.0,0.0,0.0,2992,69420,44880,-24540
17356,0.0,0.0,0.0,2992,69424,44880,-24544
17357,0.0,0.0,0.0,2992,69428,44880,-24548
17358,0.0,0.0,0.0,2992,69432,44880,-24552
17359,0.0,0.0,0.0,2992,69436,44880,-24556
17360,0.0,0.0,0.0,2992,69440,44880,-24560
17361,0.0,0.0,0.0,2992,69444,44880,-24564
17362,0.0,0.0,0.0,2992,69448,44880,-24568
17363,0.0,0.0,0.0,2992,69452,44880,-24572
17364,0.0,0.0,0.0,2992,69456,44880,-24576
17365,0.0,0.0,0.0,2992,69460,44880,-24580
17366,0.0,0.0,0.0,2992,69464,44880,-24584
17367,0.0,0.0,0.0,2992,69468,44880,-24588
17368,1.0,1.0,1.0,2993,69472,44895,-24577
17369,0.0,0.0,0.0,2993,69476,44895,-24581
17370,0.0,0.0,0.0,2993,69480,44895,-24585
17371,0.0,0.0,0.0,2993,69484,44895,-24589
17372,0.0,0.0,0.0,2993,69488,44895,-24593
17373,0.0,0.0,0.0,2993,69492,44895,-24597
17374,0.0,0.0,0.0,2993,69496,44895,-24601
17375,0.0,0.0,0.0,2993,69500,44895,-24605
17376,0.0,0.0,0.0,2993,69504,44895,-24609
17377,0.0,0.0,0.0,2993,69508,44895,-24613
17378,1.0,1.0,1.0,2994,69512,44910,-24602
17379,0.0,0.0,0.0,2994,69516,44910,-24606
17380,0.0,0.0,0.0,2994,69520,44910,-24610
17381,0.0,0.0,0.0,2994,69524,44910,-24614
17382,0.0,0.0,0.0,2994,69528,44910,-24618
17383,0.0,0.0,0.0,2994,69532,44910,-24622
17384,0.0,0.0,0.0,2994,69536,44910,-24626
17385,0.0,0.0,0.0,2994,69540,44910,-24630
17386,1.0,0.0,0.5,2995,69544,44925,-24619
17387,1.0,1.0,1.0,2996,69548,44940,-24608
17388,0.0,0.0,0.0,2996,69552,44940,-24612
17389,0.0,0.0,0.0,2996,69556,44940,-24616
17390,0.0,0.0,0.0,2996,69560,44940,-24620
17391,0.0,0.0,0.0,2996,69564,44940,-24624
17392,0.0,0.0,0.0,2996,69568,44940,-24628
17393,0.0,0.0,0.0,2996,69572,44940,-24632
17394,0.0,0.0,0.0,2996,69576,44940,-24636
17395,0.0,0.0,0.0,2996,69580,44940,-24640
17396,0.0,0.0,0.0,2996,69584,44940,-24644
17397,0.0,0.0,0.0,2996,69588,44940,-24648
17398,0.0,1.0,0.6666666666666666,2996,69592,44940,-24652
17399,0.0,0.0,0.0,2996,69596,44940,-24656
17400,0.0,0.0,0.0,2996,69600,44940,-24660
17401,0.0,0.0,0.0,2996,69604,44940,-24664
17402,0.0,0.0,0.0,2996,69608,44940,-24668
17403,0.0,0.0,0.0,2996,69612,44940,-24672
17404,0.0,0.0,0.0,2996,69616,44940,-24676
17405,0.0,0.0,0.0,2996,69620,44940,-24680
17406,0.0,0.0,0.0,2996,69624,44940,-24684
17407,0.0,0.0,0.0,2996,69628,44940,-24688
17408,1.0,1.0,1.0,2997,69632,44955,-24677
17409,0.0,0.0,0.0,2997,69636,44955,-24681
17410,0.0,0.0,0.0,2997,69640,44955,-24685
17411,0.0,0.0,0.0,2997,69644,44955,-24689
17412,0.0,0.0,0.0,2997,69648,44955,-24693
17413,0.0,0.0,0.0,2997,69652,44955,-24697
17414,0.0,0.0,0.0,2997,69656,44955,-24701
17415,0.0,0.0,0.0,2997,69660,44955,-24705
17416,0.0,0.0,0.0,2997,69664,44955,-24709
17417,0.0,0.0,0.0,2997,69668,44955,-24713
17418,0.0,0.0,0.0,2997,69672,44955,-24717
17419,0.0,0.0,0.0,2997,69676,44955,-24721
17420,0.0,0.0,0.0,2997,69680,44955,-24725
17421,0.0,0.0,0.0,2997,69684,44955,-24729
17422,0.0,0.0,0.0,2997,69688,44955,-24733
17423,0.0,0.0,0.0,2997,69692,44955,-24737
17424,0.0,0.0,0.0,2997,69696,44955,-24741
17425,0.0,0.0,0.0,2997,69700,44955,-24745
17426,0.0,0.0,0.0,2997,69704,44955,-24749
17427,0.0,0.0,0.0,2997,69708,44955,-24753
17428,1.0,1.0,1.0,2998,69712,44970,-24742
17429,0.0,0.0,0.0,2998,69716,44970,-24746
17430,0.0,0.0,0.0,2998,69720,44970,-24750
17431,0.0,0.0,0.0,2998,69724,44970,-24754
17432,0.0,0.0,0.0,2998,69728,44970,-24758
17433,0.0,0.0,0.0,2998,69732,44970,-24762
17434,0.0,0.0,0.0,2998,69736,44970,-24766
17435,1.0,1.0,0.75,2999,69740,44985,-24755
17436,0.0,0.0,0.0,2999,69744,44985,-24759
17437,0.0,0.0,0.0,2999,69748,44985,-24763
17438,1.0,1.0,1.0,3000,69752,45000,-24752
17439,0.0,0.0,0.0,3000,69756,45000,-24756
17440,0.0,0.0,0.0,3000,69760,45000,-24760
17441,0.0,0.0,0.0,3000,69764,45000,-24764
17442,0.0,0.0,0.0,3000,69768,45000,-24768
17443,0.0,0.0,0.0,3000,69772,45000,-24772
17444,0.0,0.0,0.0,3000,69776,45000,-24776
17445,1.0,1.0,0.6666666666666666,3001,69780,45015,-24765
17446,1.0,1.0,1.0,3002,69784,45030,-24754
17447,0.0,0.0,0.0,3002,69788,45030,-24758
17448,1.0,1.0,1.0,3003,69792,45045,-24747
17449,0.0,0.0,0.0,3003,69796,45045,-24751
17450,0.0,0.0,0.0,3003,69800,45045,-24755
17451,1.0,1.0,0.75,3004,69804,45060,-24744
17452,1.0,1.0,0.6666666666666666,3005,69808,45075,-24733
17453,1.0,1.0,1.0,3006,69812,45090,-24722
17454,0.0,0.0,0.0,3006,69816,45090,-24726
17455,0.0,0.0,0.0,3006,69820,45090,-24730
17456,1.0,1.0,1.0,3007,69824,45105,-24719
17457,0.0,0.0,0.2,3007,69828,45105,-24723
17458,0.0,0.0,0.0,3007,69832,45105,-24727
17459,1.0,1.0,1.0,3008,69836,45120,-24716
17460,0.0,0.0,0.0,3008,69840,45120,-24720
17461,0.0,0.0,0.0,3008,69844,45120,-24724
17462,0.0,0.0,0.25,3008,69848,45120,-24728
17463,0.0,0.0,0.0,3008,69852,45120,-24732
17464,0.0,0.0,0.0,3008,69856,45120,-24736
17465,0.0,0.0,0.0,3008,69860,45120,-24740
17466,0.0,0.0,0.0,3008,69864,45120,-24744
17467,0.0,0.0,0.0,3008,69868,45120,-24748
17468,0.0,0.0,0.0,3008,69872,45120,-24752
17469,0.0,0.0,0.0,3008,69876,45120,-24756
17470,0.0,0.0,0.0,3008,69880,45120,-24760
17471,0.0,0.0,0.0,3008,69884,45120,-24764
17472,0.0,0.0,0.0,3008,69888,45120,-24768
17473,0.0,0.0,0.0,3008,69892,45120,-24772
17474,0.0,0.0,0.0,3008,69896,45120,-24776
17475,0.0,0.0,0.0,3008,69900,45120,-24780
17476,0.0,0.0,0.0,3008,69904,45120,-24784
17477,0.0,0.0,0.0,3008,69908,45120,-24788
17478,0.0,0.0,0.0,3008,69912,45120,-24792
17479,0.0,0.0,0.0,3008,69916,45120,-24796
17480,0.0,0.0,0.0,3008,69920,45120,-24800
17481,1.0,1.0,1.0,3009,69924,45135,-24789
17482,0.0,0.0,0.0,3009,69928,45135,-24793
17483,0.0,0.0,0.0,3009,69932,45135,-24797
17484,0.0,0.0,0.0,3009,69936,45135,-24801
17485,0.0,0.0,0.0,3009,69940,45135,-24805
17486,0.0,0.0,0.0,3009,69944,45135,-24809
17487,1.0,1.0,1.0,3010,69948,45150,-24798
17488,0.0,0.0,0.0,3010,69952,45150,-24802
17489,0.0,0.0,0.2,3010,69956,45150,-24806
17490,0.0,0.0,0.0,3010,69960,45150,-24810
17491,0.0,0.0,0.0,3010,69964,45150,-24814
17492,0.0,0.0,0.0,3010,69968,45150,-24818
17493,1.0,0.0,0.3333333333333333,3011,69972,45165,-24807
17494,1.0,1.0,1.0,3012,69976,45180,-24796
17495,0.0,0.0,0.0,3012,69980,45180,-24800
17496,0.0,0.0,0.0,3012,69984,45180,-24804
17497,0.0,0.0,0.0,3012,69988,45180,-24808
17498,1.0,1.0,0.6666666666666666,3013,69992,45195,-24797
17499,0.0,0.0,0.0,3013,69996,45195,-24801
17500,1.0,1.0,0.6666666666666666,3014,70000,45210,-24790
17501,0.0,0.0,0.0,3014,70004,45210,-24794
17502,0.0,0.0,0.0,3014,70008,45210,-24798
17503,1.0,1.0,0.75,3015,70012,45225,-24787
17504,0.0,0.0,0.0,3015,70016,45225,-24791
17505,0.0,0.0,0.0,3015,70020,45225,-24795
17506,0.0,0.0,0.0,3015,70024,45225,-24799
17507,0.0,0.0,0.0,3015,70028,45225,-24803
17508,0.0,0.0,0.0,3015,70032,45225,-24807
17509,0.0,0.0,0.0,3015,70036,45225,-24811
17510,0.0,0.0,0.0,3015,70040,45225,-24815
17511,0.0,0.0,0.0,3015,70044,45225,-24819
17512,1.0,1.0,1.0,3016,70048,45240,-24808
17513,0.0,0.0,0.0,3016,70052,45240,-24812
17514,0.0,0.0,0.0,3016,70056,45240,-24816
17515,0.0,0.0,0.0,3016,70060,45240,-24820
17516,0.0,0.0,0.0,3016,70064,45240,-24824
17517,0.0,0.0,0.0,3016,70068,45240,-24828
17518,0.0,0.0,0.0,3016,70072,45240,-24832
17519,1.0,1.0,1.0,3017,70076,45255,-24821
17520,0.0,0.0,0.0,3017,70080,45255,-24825
17521,0.0,0.0,0.0,3017,70084,45255,-24829
17522,0.0,0.0,0.0,3017,70088,45255,-24833
17523,0.0,0.0,0.0,3017,70092,45255,-24837
17524,0.0,0.0,0.25,3017,70096,45255,-24841
17525,1.0,1.0,1.0,3018,70100,45270,-24830
17526,0.0,0.0,0.0,3018,70104,45270,-24834
17527,0.0,0.0,0.0,3018,70108,45270,-24838
17528,0.0,0.0,0.0,3018,70112,45270,-24842
17529,0.0,0.0,0.0,3018,70116,45270,-24846
17530,0.0,0.0,0.0,3018,70120,45270,-24850
17531,0.0,0.0,0.0,3018,70124,45270,-24854
17532,1.0,1.0,1.0,3019,70128,45285,-24843
17533,0.0,0.0,0.0,3019,70132,45285,-24847
17534,0.0,0.0,0.0,3019,70136,45285,-24851
17535,0.0,0.0,0.0,3019,70140,45285,-24855
17536,0.0,0.0,0.0,3019,70144,45285,-24859
17537,0.0,0.0,0.0,3019,70148,45285,-24863
17538,0.0,0.0,0.0,3019,70152,45285,-24867
17539,0.0,0.0,0.0,3019,70156,45285,-24871
17540,1.0,1.0,1.0,3020,70160,45300,-24860
17541,0.0,0.0,0.0,3020,70164,45300,-24864
17542,0.0,1.0,0.6666666666666666,3020,70168,45300,-24868
17543,1.0,1.0,1.0,3021,70172,45315,-24857
17544,1.0,1.0,1.0,3022,70176,45330,-24846
17545,0.0,0.0,0.0,3022,70180,45330,-24850
17546,1.0,1.0,0.6,3023,70184,45345,-24839
17547,1.0,1.0,1.0,3024,70188,45360,-24828
17548,0.0,0.0,0.0,3024,70192,45360,-24832
17549,0.0,0.0,0.0,3024,70196,45360,-24836
17550,0.0,0.0,0.0,3024,70200,45360,-24840
17551,0.0,0.0,0.0,3024,70204,45360,-24844
17552,0.0,0.0,0.0,3024,70208,45360,-24848
17553,0.0,0.0,0.0,3024,70212,45360,-24852
17554,0.0,0.0,0.0,3024,70216,45360,-24856
17555,1.0,1.0,1.0,3025,70220,45375,-24845
17556,1.0,1.0,1.0,3026,70224,45390,-24834
17557,0.0,0.0,0.0,3026,70228,45390,-24838
17558,0.0,0.0,0.0,3026,70232,45390,-24842
17559,0.0,0.0,0.0,3026,70236,45390,-24846
17560,0.0,0.0,0.0,3026,70240,45390,-24850
17561,0.0,0.0,0.0,3026,70244,45390,-24854
17562,0.0,0.0,0.0,3026,70248,45390,-24858
17563,0.0,0.0,0.0,3026,70252,45390,-24862
17564,0.0,0.0,0.0,3026,70256,45390,-24866
17565,0.0,0.0,0.0,3026,70260,45390,-24870
17566,0.0,0.0,0.0,3026,70264,45390,-24874
17567,0.0,0.0,0.2,3026,70268,45390,-24878
17568,0.0,0.0,0.0,3026,70272,45390,-24882
17569,0.0,0.0,0.0,3026,70276,45390,-24886
17570,0.0,0.0,0.0,3026,70280,45390,-24890
17571,0.0,0.0,0.0,3026,70284,45390,-24894
17572,0.0,0.0,0.0,3026,70288,45390,-24898
17573,0.0,0.0,0.0,3026,70292,45390,-24902
17574,0.0,0.0,0.0,3026,70296,45390,-24906
17575,1.0,1.0,1.0,3027,70300,45405,-24895
17576,0.0,0.0,0.0,3027,70304,45405,-24899
17577,0.0,0.0,0.0,3027,70308,45405,-24903
17578,0.0,0.0,0.0,3027,70312,45405,-24907
17579,0.0,0.0,0.3333333333333333,3027,70316,45405,-24911
17580,0.0,0.0,0.0,3027,70320,45405,-24915
17581,0.0,0.0,0.0,3027,70324,45405,-24919
17582,0.0,0.0,0.0,3027,70328,45405,-24923
17583,0.0,0.0,0.0,3027,70332,45405,-24927
17584,0.0,0.0,0.0,3027,70336,45405,-24931
17585,0.0,1.0,0.6666666666666666,3027,70340,45405,-24935
17586,0.0,0.0,0.3333333333333333,3027,70344,45405,-24939
17587,0.0,0.0,0.0,3027,70348,45405,-24943
17588,1.0,0.0,0.4,3028,70352,45420,-24932
17589,0.0,0.0,0.0,3028,70356,45420,-24936
17590,0.0,1.0,0.75,3028,70360,45420,-24940
17591,0.0,0.0,0.0,3028,70364,45420,-24944
17592,1.0,1.0,0.6,3029,70368,45435,-24933
17593,0.0,0.0,0.0,3029,70372,45435,-24937
17594,0.0,0.0,0.0,3029,70376,45435,-24941
17595,0.0,0.0,0.0,3029,70380,45435,-24945
17596,1.0,1.0,1.0,3030,70384,45450,-24934
17597,0.0,0.0,0.0,3030,70388,45450,-24938
17598,1.0,0.0,0.3333333333333333,3031,70392,45465,-24927
17599,0.0,0.0,0.0,3031,70396,45465,-24931
17600,0.0,0.0,0.0,3031,70400,45465,-24935
17601,0.0,0.0,0.0,3031,70404,45465,-24939
17602,0.0,0.0,0.0,3031,70408,45465,-24943
17603,0.0,0.0,0.0,3031,70412,45465,-24947
17604,0.0,0.0,0.0,3031,70416,45465,-24951
17605,0.0,0.0,0.0,3031,70420,45465,-24955
17606,1.0,1.0,1.0,3032,70424,45480,-24944
17607,0.0,0.0,0.0,3032,70428,45480,-24948
17608,0.0,0.0,0.0,3032,70432,45480,-24952
17609,0.0,0.0,0.0,3032,70436,45480,-24956
17610,0.0,0.0,0.0,3032,70440,45480,-24960
17611,0.0,0.0,0.0,3032,70444,45480,-24964
17612,0.0,0.0,0.0,3032,70448,45480,-24968
17613,0.0,0.0,0.0,3032,70452,45480,-24972
17614,0.0,0.0,0.0,3032,70456,45480,-24976
17615,0.0,0.0,0.0,3032,70460,45480,-24980
17616,1.0,1.0,1.0,3033,70464,45495,-24969
17617,1.0,1.0,1.0,3034,70468,45510,-24958
17618,0.0,0.0,0.0,3034,70472,45510,-24962
17619,0.0,0.0,0.0,3034,70476,45510,-24966
17620,0.0,0.0,0.0,3034,70480,45510,-24970
17621,0.0,0.0,0.0,3034,70484,45510,-24974
17622,0.0,0.0,0.0,3034,70488,45510,-24978
17623,1.0,1.0,0.6666666666666666,3035,70492,45525,-24967
17624,0.0,0.0,0.3333333333333333,3035,70496,45525,-24971
17625,0.0,0.0,0.0,3035,70500,45525,-24975
17626,0.0,0.0,0.0,3035,70504,45525,-24979
17627,0.0,0.0,0.0,3035,70508,45525,-24983
17628,0.0,0.0,0.0,3035,70512,45525,-24987
17629,0.0,0.0,0.0,3035,70516,45525,-24991
17630,0.0,0.0,0.0,3035,70520,45525,-24995
17631,0.0,0.0,0.0,3035,70524,45525,-24999
17632,1.0,1.0,1.0,3036,70528,45540,-24988
17633,0.0,0.0,0.0,3036,70532,45540,-24992
17634,0.0,0.0,0.0,3036,70536,45540,-24996
17635,0.0,0.0,0.0,3036,70540,45540,-25000
17636,0.0,0.0,0.0,3036,70544,45540,-25004
17637,0.0,0.0,0.0,3036,70548,45540,-25008
17638,0.0,0.0,0.0,3036,70552,45540,-25012
17639,1.0,1.0,1.0,3037,70556,45555,-25001
17640,1.0,1.0,0.8,3038,70560,45570,-24990
17641,0.0,0.0,0.0,3038,70564,45570,-24994
17642,0.0,0.0,0.0,3038,70568,45570,-24998
17643,0.0,0.0,0.0,3038,70572,45570,-25002
17644,0.0,0.0,0.0,3038,70576,45570,-25006
17645,0.0,0.0,0.3333333333333333,3038,70580,45570,-25010
17646,1.0,0.0,0.5,3039,70584,45585,-24999
17647,0.0,0.0,0.0,3039,70588,45585,-25003
17648,0.0,0.0,0.0,3039,70592,45585,-25007
17649,0.0,0.0,0.0,3039,70596,45585,-25011
17650,0.0,0.0,0.0,3039,70600,45585,-25015
17651,0.0,0.0,0.0,3039,70604,45585,-25019
17652,0.0,0.0,0.0,3039,70608,45585,-25023
17653,0.0,0.0,0.0,3039,70612,45585,-25027
17654,0.0,0.0,0.0,3039,70616,45585,-25031
17655,1.0,1.0,0.75,3040,70620,45600,-25020
17656,1.0,1.0,1.0,3041,70624,45615,-25009
17657,0.0,0.0,0.0,3041,70628,45615,-25013
17658,0.0,0.0,0.0,3041,70632,45615,-25017
17659,0.0,0.0,0.0,3041,70636,45615,-25021
17660,0.0,0.0,0.0,3041,70640,45615,-25025
17661,0.0,0.0,0.0,3041,70644,45615,-25029
17662,1.0,1.0,1.0,3042,70648,45630,-25018
17663,0.0,0.0,0.0,3042,70652,45630,-25022
17664,0.0,0.0,0.0,3042,70656,45630,-25026
17665,0.0,0.0,0.0,3042,70660,45630,-25030
17666,0.0,0.0,0.5,3042,70664,45630,-25034
17667,0.0,0.0,0.0,3042,70668,45630,-25038
17668,0.0,0.0,0.0,3042,70672,45630,-25042
17669,0.0,0.0,0.0,3042,70676,45630,-25046
17670,0.0,0.0,0.0,3042,70680,45630,-25050
17671,0.0,0.0,0.0,3042,70684,45630,-25054
17672,0.0,0.0,0.5,3042,70688,45630,-25058
17673,0.0,0.0,0.0,3042,70692,45630,-25062
17674,0.0,0.0,0.0,3042,70696,45630,-25066
17675,1.0,1.0,0.6666666666666666,3043,70700,45645,-25055
17676,0.0,0.0,0.0,3043,70704,45645,-25059
17677,0.0,0.0,0.0,3043,70708,45645,-25063
17678,0.0,0.0,0.0,3043,70712,45645,-25067
17679,0.0,0.0,0.0,3043,70716,45645,-25071
17680,1.0,1.0,1.0,3044,70720,45660,-25060
17681,0.0,0.0,0.0,3044,70724,45660,-25064
17682,1.0,1.0,1.0,3045,70728,45675,-25053
17683,0.0,0.0,0.0,3045,70732,45675,-25057
17684,0.0,0.0,0.0,3045,70736,45675,-25061
17685,1.0,1.0,1.0,3046,70740,45690,-25050
17686,0.0,0.0,0.0,3046,70744,45690,-25054
17687,0.0,0.0,0.0,3046,70748,45690,-25058
17688,0.0,0.0,0.0,3046,70752,45690,-25062
17689,1.0,1.0,1.0,3047,70756,45705,-25051
17690,0.0,0.0,0.0,3047,70760,45705,-25055
17691,0.0,0.0,0.0,3047,70764,45705,-25059
17692,0.0,0.0,0.0,3047,70768,45705,-25063
17693,0.0,0.0,0.0,3047,70772,45705,-25067
17694,0.0,0.0,0.0,3047,70776,45705,-25071
17695,0.0,0.0,0.0,3047,70780,45705,-25075
17696,0.0,0.0,0.0,3047,70784,45705,-25079
17697,0.0,0.0,0.0,3047,70788,45705,-25083
17698,0.0,1.0,0.6666666666666666,3047,70792,45705,-25087
17699,0.0,0.0,0.0,3047,70796,45705,-25091
17700,0.0,0.0,0.0,3047,70800,45705,-25095
17701,0.0,0.0,0.0,3047,70804,45705,-25099
17702,0.0,0.0,0.0,3047,70808,45705,-25103
17703,1.0,1.0,0.8,3048,70812,45720,-25092
17704,0.0,0.0,0.0,3048,70816,45720,-25096
17705,0.0,0.0,0.0,3048,70820,45720,-25100
17706,0.0,0.0,0.0,3048,70824,45720,-25104
17707,0.0,0.0,0.0,3048,70828,45720,-25108
17708,0.0,0.0,0.0,3048,70832,45720,-25112
17709,0.0,0.0,0.0,3048,70836,45720,-25116
17710,0.0,0.0,0.0,3048,70840,45720,-25120
17711,1.0,1.0,1.0,3049,70844,45735,-25109
17712,0.0,0.0,0.0,3049,70848,45735,-25113
17713,0.0,0.0,0.0,3049,70852,45735,-25117
17714,0.0,0.0,0.0,3049,70856,45735,-25121
17715,0.0,0.0,0.0,3049,70860,45735,-25125
17716,0.0,0.0,0.0,3049,70864,45735,-25129
17717,0.0,0.0,0.0,3049,70868,45735,-25133
17718,0.0,0.0,0.0,3049,70872,45735,-25137
17719,0.0,0.0,0.0,3049,70876,45735,-25141
17720,0.0,0.0,0.0,3049,70880,45735,-25145
17721,0.0,0.0,0.0,3049,70884,45735,-25149
17722,0.0,0.0,0.0,3049,70888,45735,-25153
17723,0.0,0.0,0.0,3049,70892,45735,-25157
17724,0.0,0.0,0.0,3049,70896,45735,-25161
17725,0.0,0.0,0.0,3049,70900,45735,-25165
17726,0.0,0.0,0.0,3049,70904,45735,-25169
17727,0.0,0.0,0.0,3049,70908,45735,-25173
17728,0.0,0.0,0.0,3049,70912,45735,-25177
17729,0.0,0.0,0.4,3049,70916,45735,-25181
17730,0.0,0.0,0.0,3049,70920,45735,-25185
17731,0.0,0.0,0.0,3049,70924,45735,-25189
17732,0.0,0.0,0.0,3049,70928,45735,-25193
17733,0.0,0.0,0.0,3049,70932,45735,-25197
17734,0.0,0.0,0.0,3049,70936,45735,-25201
17735,0.0,0.0,0.3333333333333333,3049,70940,45735,-25205
17736,1.0,1.0,1.0,3050,70944,45750,-25194
17737,0.0,0.0,0.0,3050,70948,45750,-25198
17738,0.0,0.0,0.0,3050,70952,45750,-25202
17739,0.0,0.0,0.0,3050,70956,45750,-25206
17740,0.0,0.0,0.0,3050,70960,45750,-25210
17741,0.0,0.0,0.0,3050,70964,45750,-25214
17742,0.0,0.0,0.0,3050,70968,45750,-25218
17743,0.0,0.0,0.0,3050,70972,45750,-25222
17744,0.0,0.0,0.0,3050,70976,45750,-25226
17745,0.0,0.0,0.0,3050,70980,45750,-25230
17746,0.0,0.0,0.0,3050,70984,45750,-25234
17747,0.0,0.0,0.0,3050,70988,45750,-25238
17748,0.0,0.0,0.0,3050,70992,45750,-25242
17749,0.0,0.0,0.0,3050,70996,45750,-25246
17750,1.0,1.0,1.0,3051,71000,45765,-25235
17751,0.0,1.0,0.75,3051,71004,45765,-25239
17752,0.0,0.0,0.0,3051,71008,45765,-25243
17753,0.0,0.0,0.0,3051,71012,45765,-25247
17754,0.0,0.0,0.0,3051,71016,45765,-25251
17755,0.0,0.0,0.0,3051,71020,45765,-25255
17756,0.0,0.0,0.0,3051,71024,45765,-25259
17757,0.0,0.0,0.0,3051,71028,45765,-25263
17758,0.0,0.0,0.0,3051,71032,45765,-25267
17759,0.0,0.0,0.3333333333333333,3051,71036,45765,-25271
17760,1.0,1.0,0.6666666666666666,3052,71040,45780,-25260
17761,0.0,0.0,0.0,3052,71044,45780,-25264
17762,1.0,0.0,0.3333333333333333,3053,71048,45795,-25253
17763,0.0,0.0,0.0,3053,71052,45795,-25257
17764,0.0,0.0,0.0,3053,71056,45795,-25261
17765,0.0,0.0,0.0,3053,71060,45795,-25265
17766,0.0,1.0,0.8,3053,71064,45795,-25269
17767,1.0,1.0,1.0,3054,71068,45810,-25258
17768,0.0,0.0,0.0,3054,71072,45810,-25262
17769,1.0,1.0,1.0,3055,71076,45825,-25251
17770,0.0,0.0,0.0,3055,71080,45825,-25255
17771,0.0,0.0,0.0,3055,71084,45825,-25259
17772,0.0,0.0,0.3333333333333333,3055,71088,45825,-25263
17773,0.0,0.0,0.0,3055,71092,45825,-25267
17774,0.0,0.0,0.0,3055,71096,45825,-25271
17775,0.0,0.0,0.0,3055,71100,45825,-25275
17776,0.0,0.0,0.0,3055,71104,45825,-25279
17777,0.0,0.0,0.0,3055,71108,45825,-25283
17778,0.0,0.0,0.0,3055,71112,45825,-25287
17779,0.0,0.0,0.0,3055,71116,45825,-25291
17780,0.0,0.0,0.0,3055,71120,45825,-25295
17781,0.0,0.0,0.0,3055,71124,45825,-25299
17782,0.0,0.0,0.0,3055,71128,45825,-25303
17783,1.0,1.0,1.0,3056,71132,45840,-25292
17784,0.0,0.0,0.0,3056,71136,45840,-25296
17785,1.0,1.0,1.0,3057,71140,45855,-25285
17786,0.0,0.0,0.0,3057,71144,45855,-25289
17787,0.0,0.0,0.0,3057,71148,45855,-25293
17788,0.0,0.0,0.0,3057,71152,45855,-25297
17789,0.0,0.0,0.0,3057,71156,45855,-25301
17790,0.0,0.0,0.0,3057,71160,45855,-25305
17791,0.0,0.0,0.0,3057,71164,45855,-25309
17792,0.0,0.0,0.0,3057,71168,45855,-25313
17793,0.0,0.0,0.0,3057,71172,45855,-25317
17794,0.0,0.0,0.0,3057,71176,45855,-25321
17795,0.0,0.0,0.0,3057,71180,45855,-25325
17796,0.0,0.0,0.0,3057,71184,45855,-25329
17797,0.0,0.0,0.0,3057,71188,45855,-25333
17798,0.0,0.0,0.0,3057,71192,45855,-25337
17799,0.0,0.0,0.0,3057,71196,45855,-25341
17800,0.0,0.0,0.0,3057,71200,45855,-25345
17801,0.0,0.0,0.0,3057,71204,45855,-25349
17802,0.0,0.0,0.0,3057,71208,45855,-25353
17803,0.0,0.0,0.0,3057,71212,45855,-25357
17804,0.0,0.0,0.0,3057,71216,45855,-25361
17805,1.0,1.0,1.0,3058,71220,45870,-25350
17806,0.0,0.0,0.0,3058,71224,45870,-25354
17807,0.0,0.0,0.0,3058,71228,45870,-25358
17808,0.0,0.0,0.0,3058,71232,45870,-25362
17809,0.0,0.0,0.0,3058,71236,45870,-25366
17810,0.0,0.0,0.0,3058,71240,45870,-25370
17811,0.0,0.0,0.0,3058,71244,45870,-25374
17812,0.0,0.0,0.0,3058,71248,45870,-25378
17813,0.0,0.0,0.0,3058,71252,45870,-25382
17814,0.0,0.0,0.0,3058,71256,45870,-25386
17815,0.0,0.0,0.0,3058,71260,45870,-25390
17816,0.0,0.0,0.0,3058,71264,45870,-25394
17817,0.0,0.0,0.0,3058,71268,45870,-25398
17818,0.0,0.0,0.0,3058,71272,45870,-25402
17819,1.0,1.0,1.0,3059,71276,45885,-25391
17820,0.0,0.0,0.0,3059,71280,45885,-25395
17821,1.0,1.0,1.0,3060,71284,45900,-25384
17822,0.0,0.0,0.0,3060,71288,45900,-25388
17823,1.0,1.0,1.0,3061,71292,45915,-25377
17824,0.0,0.0,0.0,3061,71296,45915,-25381
17825,0.0,0.0,0.0,3061,71300,45915,-25385
17826,0.0,0.0,0.0,3061,71304,45915,-25389
17827,1.0,0.0,0.3333333333333333,3062,71308,45930,-25378
17828,0.0,0.0,0.0,3062,71312,45930,-25382
17829,0.0,0.0,0.0,3062,71316,45930,-25386
17830,1.0,1.0,1.0,3063,71320,45945,-25375
17831,0.0,0.0,0.0,3063,71324,45945,-25379
17832,0.0,0.0,0.0,3063,71328,45945,-25383
17833,0.0,0.0,0.0,3063,71332,45945,-25387
17834,0.0,0.0,0.0,3063,71336,45945,-25391
17835,1.0,1.0,1.0,3064,71340,45960,-25380
17836,0.0,0.0,0.0,3064,71344,45960,-25384
17837,0.0,0.0,0.0,3064,71348,45960,-25388
17838,1.0,1.0,0.6666666666666666,3065,71352,45975,-25377
17839,0.0,0.0,0.0,3065,71356,45975,-25381
17840,0.0,0.0,0.0,3065,71360,45975,-25385
17841,0.0,0.0,0.0,3065,71364,45975,-25389
17842,0.0,0.0,0.0,3065,71368,45975,-25393
17843,0.0,0.0,0.0,3065,71372,45975,-25397
17844,0.0,0.0,0.0,3065,71376,45975,-25401
17845,0.0,0.0,0.0,3065,71380,45975,-25405
17846,1.0,1.0,1.0,3066,71384,45990,-25394
17847,0.0,0.0,0.0,3066,71388,45990,-25398
17848,1.0,1.0,1.0,3067,71392,46005,-25387
17849,1.0,1.0,1.0,3068,71396,46020,-25376
17850,1.0,1.0,1.0,3069,71400,46035,-25365
17851,0.0,0.0,0.0,3069,71404,46035,-25369
17852,0.0,0.0,0.0,3069,71408,46035,-25373
17853,0.0,0.0,0.0,3069,71412,46035,-25377
17854,0.0,0.0,0.0,3069,71416,46035,-25381
17855,0.0,0.0,0.0,3069,71420,46035,-25385
17856,0.0,0.0,0.0,3069,71424,46035,-25389
17857,0.0,0.0,0.0,3069,71428,46035,-25393
17858,0.0,0.0,0.0,3069,71432,46035,-25397
17859,1.0,1.0,1.0,3070,71436,46050,-25386
17860,0.0,0.0,0.0,3070,71440,46050,-25390
17861,0.0,0.0,0.0,3070,71444,46050,-25394
17862,0.0,0.0,0.0,3070,71448,46050,-25398
17863,0.0,0.0,0.0,3070,71452,46050,-25402
17864,0.0,0.0,0.0,3070,71456,46050,-25406
17865,0.0,0.0,0.0,3070,71460,46050,-25410
17866,1.0,0.0,0.5,3071,71464,46065,-25399
17867,0.0,0.0,0.0,3071,71468,46065,-25403
17868,0.0,0.0,0.0,3071,71472,46065,-25407
17869,0.0,0.0,0.0,3071,71476,46065,-25411
17870,0.0,0.0,0.0,3071,71480,46065,-25415
17871,0.0,0.0,0.0,3071,71484,46065,-25419
17872,0.0,0.0,0.0,3071,71488,46065,-25423
17873,0.0,0.0,0.0,3071,71492,46065,-25427
17874,0.0,0.0,0.0,3071,71496,46065,-25431
17875,0.0,0.0,0.0,3071,71500,46065,-25435
17876,0.0,0.0,0.0,3071,71504,46065,-25439
17877,0.0,0.0,0.0,3071,71508,46065,-25443
17878,0.0,0.0,0.0,3071,71512,46065,-25447
17879,0.0,0.0,0.0,3071,71516,46065,-25451
17880,0.0,0.0,0.0,3071,71520,46065,-25455
17881,0.0,0.0,0.0,3071,71524,46065,-25459
17882,0.0,0.0,0.0,3071,71528,46065,-25463
17883,0.0,0.0,0.0,3071,71532,46065,-25467
17884,0.0,0.0,0.0,3071,71536,46065,-25471
17885,0.0,0.0,0.0,3071,71540,46065,-25475
17886,1.0,0.0,0.3333333333333333,3072,71544,46080,-25464
17887,0.0,0.0,0.0,3072,71548,46080,-25468
17888,0.0,0.0,0.0,3072,71552,46080,-25472
17889,0.0,0.0,0.0,3072,71556,46080,-25476
17890,0.0,0.0,0.0,3072,71560,46080,-25480
17891,0.0,0.0,0.0,3072,71564,46080,-25484
17892,0.0,0.0,0.0,3072,71568,46080,-25488
17893,1.0,1.0,1.0,3073,71572,46095,-25477
17894,0.0,0.0,0.0,3073,71576,46095,-25481
17895,0.0,0.0,0.0,3073,71580,46095,-25485
17896,0.0,0.0,0.0,3073,71584,46095,-25489
17897,0.0,0.0,0.0,3073,71588,46095,-25493
17898,0.0,0.0,0.0,3073,71592,46095,-25497
17899,0.0,0.0,0.0,3073,71596,46095,-25501
17900,1.0,1.0,1.0,3074,71600,46110,-25490
17901,0.0,0.0,0.0,3074,71604,46110,-25494
17902,0.0,0.0,0.0,3074,71608,46110,-25498
17903,0.0,0.0,0.0,3074,71612,46110,-25502
17904,0.0,0.0,0.0,3074,71616,46110,-25506
17905,0.0,0.0,0.0,3074,71620,46110,-25510
17906,0.0,0.0,0.0,3074,71624,46110,-25514
17907,0.0,0.0,0.0,3074,71628,46110,-25518
17908,0.0,0.0,0.0,3074,71632,46110,-25522
17909,1.0,1.0,1.0,3075,71636,46125,-25511
17910,0.0,0.0,0.0,3075,71640,46125,-25515
17911,0.0,0.0,0.0,3075,71644,46125,-25519
17912,0.0,0.0,0.0,3075,71648,46125,-25523
17913,0.0,0.0,0.0,3075,71652,46125,-25527
17914,0.0,0.0,0.0,3075,71656,46125,-25531
17915,0.0,0.0,0.0,3075,71660,46125,-25535
17916,1.0,1.0,1.0,3076,71664,46140,-25524
17917,0.0,0.0,0.3333333333333333,3076,71668,46140,-25528
17918,0.0,0.0,0.0,3076,71672,46140,-25532
17919,0.0,0.0,0.0,3076,71676,46140,-25536
17920,0.0,0.0,0.0,3076,71680,46140,-25540
17921,1.0,1.0,1.0,3077,71684,46155,-25529
17922,0.0,0.0,0.0,3077,71688,46155,-25533
17923,0.0,0.0,0.0,3077,71692,46155,-25537
17924,1.0,1.0,1.0,3078,71696,46170,-25526
17925,1.0,1.0,1.0,3079,71700,46185,-25515
17926,0.0,0.0,0.0,3079,71704,46185,-25519
17927,1.0,1.0,1.0,3080,71708,46200,-25508
17928,1.0,1.0,0.6666666666666666,3081,71712,46215,-25497
17929,0.0,0.0,0.0,3081,71716,46215,-25501
17930,0.0,0.0,0.0,3081,71720,46215,-25505
17931,1.0,1.0,1.0,3082,71724,46230,-25494
17932,1.0,1.0,1.0,3083,71728,46245,-25483
17933,0.0,0.0,0.0,3083,71732,46245,-25487
17934,0.0,0.0,0.0,3083,71736,46245,-25491
17935,1.0,1.0,1.0,3084,71740,46260,-25480
17936,1.0,1.0,1.0,3085,71744,46275,-25469
17937,0.0,0.0,0.0,3085,71748,46275,-25473
17938,0.0,0.0,0.0,3085,71752,46275,-25477
17939,0.0,0.0,0.0,3085,71756,46275,-25481
17940,0.0,0.0,0.0,3085,71760,46275,-25485
17941,1.0,1.0,1.0,3086,71764,46290,-25474
17942,0.0,0.0,0.0,3086,71768,46290,-25478
17943,0.0,0.0,0.0,3086,71772,46290,-25482
17944,0.0,0.0,0.0,3086,71776,46290,-25486
17945,0.0,0.0,0.0,3086,71780,46290,-25490
17946,0.0,0.0,0.0,3086,71784,46290,-25494
17947,0.0,0.0,0.0,3086,71788,46290,-25498
17948,0.0,0.0,0.0,3086,71792,46290,-25502
17949,0.0,0.0,0.0,3086,71796,46290,-25506
17950,0.0,0.0,0.0,3086,71800,46290,-25510
17951,1.0,1.0,1.0,3087,71804,46305,-25499
17952,0.0,0.0,0.0,3087,71808,46305,-25503
17953,0.0,0.0,0.0,3087,71812,46305,-25507
17954,0.0,0.0,0.0,3087,71816,46305,-25511
17955,0.0,0.0,0.0,3087,71820,46305,-25515
17956,0.0,0.0,0.0,3087,71824,46305,-25519
17957,0.0,0.0,0.0,3087,71828,46305,-25523
17958,0.0,0.0,0.0,3087,71832,46305,-25527
17959,0.0,0.0,0.0,3087,71836,46305,-25531
17960,0.0,0.0,0.0,3087,71840,46305,-25535
17961,1.0,1.0,1.0,3088,71844,46320,-25524
17962,0.0,0.0,0.0,3088,71848,46320,-25528
17963,0.0,0.0,0.0,3088,71852,46320,-25532
17964,0.0,0.0,0.0,3088,71856,46320,-25536
17965,0.0,0.0,0.0,3088,71860,46320,-25540
17966,0.0,0.0,0.0,3088,71864,46320,-25544
17967,0.0,0.0,0.0,3088,71868,46320,-25548
17968,0.0,0.0,0.0,3088,71872,46320,-25552
17969,0.0,0.0,0.0,3088,71876,46320,-25556
17970,0.0,0.0,0.0,3088,71880,46320,-25560
17971,1.0,1.0,1.0,3089,71884,46335,-25549
17972,0.0,0.0,0.0,3089,71888,46335,-25553
17973,0.0,0.0,0.0,3089,71892,46335,-25557
17974,0.0,0.0,0.0,3089,71896,46335,-25561
17975,0.0,0.0,0.0,3089,71900,46335,-25565
17976,0.0,0.0,0.0,3089,71904,46335,-25569
17977,0.0,0.0,0.0,3089,71908,46335,-25573
17978,0.0,0.0,0.0,3089,71912,46335,-25577
17979,0.0,0.0,0.0,3089,71916,46335,-25581
17980,0.0,0.0,0.0,3089,71920,46335,-25585
17981,0.0,0.0,0.3333333333333333,3089,71924,46335,-25589
17982,0.0,0.0,0.0,3089,71928,46335,-25593
17983,0.0,0.0,0.0,3089,71932,46335,-25597
17984,1.0,1.0,1.0,3090,71936,46350,-25586
17985,0.0,0.0,0.0,3090,71940,46350,-25590
17986,0.0,0.0,0.0,3090,71944,46350,-25594
17987,0.0,0.0,0.0,3090,71948,46350,-25598
17988,0.0,0.0,0.0,3090,71952,46350,-25602
17989,0.0,0.0,0.0,3090,71956,46350,-25606
17990,0.0,0.0,0.0,3090,71960,46350,-25610
17991,0.0,0.0,0.0,3090,71964,46350,-25614
17992,0.0,0.0,0.0,3090,71968,46350,-25618
17993,0.0,0.0,0.0,3090,71972,46350,-25622
17994,0.0,0.0,0.0,3090,71976,46350,-25626
17995,0.0,0.0,0.0,3090,71980,46350,-25630
17996,0.0,0.0,0.0,3090,71984,46350,-25634
17997,0.0,0.0,0.0,3090,71988,46350,-25638
17998,0.0,0.0,0.0,3090,71992,46350,-25642
17999,0.0,0.0,0.0,3090,71996,46350,-25646
18000,0.0,0.0,0.0,3090,72000,46350,-25650
18001,0.0,0.0,0.0,3090,72004,46350,-25654
18002,0.0,0.0,0.0,3090,72008,46350,-25658
18003,0.0,0.0,0.0,3090,72012,46350,-25662
18004,0.0,0.0,0.0,3090,72016,46350,-25666
18005,0.0,0.0,0.0,3090,72020,46350,-25670
18006,0.0,0.0,0.0,3090,72024,46350,-25674
18007,0.0,0.0,0.0,3090,72028,46350,-25678
18008,0.0,0.0,0.0,3090,72032,46350,-25682
18009,0.0,0.0,0.0,3090,72036,46350,-25686
18010,1.0,1.0,1.0,3091,72040,46365,-25675
18011,0.0,0.0,0.0,3091,72044,46365,-25679
18012,0.0,0.0,0.5,3091,72048,46365,-25683
18013,0.0,0.0,0.0,3091,72052,46365,-25687
18014,0.0,0.0,0.0,3091,72056,46365,-25691
18015,0.0,0.0,0.0,3091,72060,46365,-25695
18016,0.0,0.0,0.0,3091,72064,46365,-25699
18017,0.0,0.0,0.0,3091,72068,46365,-25703
18018,0.0,0.0,0.0,3091,72072,46365,-25707
18019,0.0,0.0,0.0,3091,72076,46365,-25711
18020,0.0,0.0,0.0,3091,72080,46365,-25715
18021,0.0,0.0,0.0,3091,72084,46365,-25719
18022,0.0,0.0,0.0,3091,72088,46365,-25723
18023,0.0,1.0,0.6,3091,72092,46365,-25727
18024,0.0,0.0,0.0,3091,72096,46365,-25731
18025,0.0,0.0,0.0,3091,72100,46365,-25735
18026,0.0,0.0,0.0,3091,72104,46365,-25739
18027,0.0,0.0,0.0,3091,72108,46365,-25743
18028,0.0,0.0,0.0,3091,72112,46365,-25747
18029,0.0,0.0,0.0,3091,72116,46365,-25751
18030,0.0,0.0,0.0,3091,72120,46365,-25755
18031,0.0,0.0,0.0,3091,72124,46365,-25759
18032,1.0,1.0,1.0,3092,72128,46380,-25748
18033,1.0,1.0,1.0,3093,72132,46395,-25737
18034,0.0,0.0,0.0,3093,72136,46395,-25741
18035,0.0,0.0,0.0,3093,72140,46395,-25745
18036,0.0,0.0,0.0,3093,72144,46395,-25749
18037,0.0,0.0,0.0,3093,72148,46395,-25753
18038,0.0,0.0,0.0,3093,72152,46395,-25757
18039,0.0,0.0,0.0,3093,72156,46395,-25761
18040,0.0,0.0,0.0,3093,72160,46395,-25765
18041,0.0,0.0,0.0,3093,72164,46395,-25769
18042,0.0,0.0,0.0,3093,72168,46395,-25773
18043,0.0,0.0,0.0,3093,72172,46395,-25777
18044,0.0,0.0,0.0,3093,72176,46395,-25781
18045,0.0,0.0,0.0,3093,72180,46395,-25785
18046,0.0,0.0,0.0,3093,72184,46395,-25789
18047,1.0,1.0,1.0,3094,72188,46410,-25778
18048,0.0,0.0,0.0,3094,72192,46410,-25782
18049,0.0,0.0,0.0,3094,72196,46410,-25786
18050,0.0,0.0,0.0,3094,72200,46410,-25790
18051,0.0,0.0,0.0,3094,72204,46410,-25794
18052,0.0,0.0,0.0,3094,72208,46410,-25798
18053,0.0,0.0,0.0,3094,72212,46410,-25802
18054,0.0,0.0,0.0,3094,72216,46410,-25806
18055,0.0,0.0,0.0,3094,72220,46410,-25810
18056,0.0,0.0,0.0,3094,72224,46410,-25814
18057,0.0,0.0,0.0,3094,72228,46410,-25818
18058,0.0,0.0,0.0,3094,72232,46410,-25822
18059,0.0,0.0,0.0,3094,72236,46410,-25826
18060,0.0,0.0,0.0,3094,72240,46410,-25830
18061,0.0,0.0,0.0,3094,72244,46410,-25834
18062,0.0,0.0,0.0,3094,72248,46410,-25838
18063,0.0,0.0,0.0,3094,72252,46410,-25842
18064,0.0,0.0,0.0,3094,72256,46410,-25846
18065,0.0,0.0,0.0,3094,72260,46410,-25850
18066,0.0,0.0,0.0,3094,72264,46410,-25854
18067,0.0,0.0,0.0,3094,72268,46410,-25858
18068,0.0,0.0,0.0,3094,72272,46410,-25862
18069,1.0,1.0,1.0,3095,72276,46425,-25851
18070,0.0,0.0,0.0,3095,72280,46425,-25855
18071,0.0,0.0,0.0,3095,72284,46425,-25859
18072,0.0,0.0,0.0,3095,72288,46425,-25863
18073,0.0,0.0,0.0,3095,72292,46425,-25867
18074,0.0,0.0,0.0,3095,72296,46425,-25871
18075,0.0,0.0,0.0,3095,72300,46425,-25875
18076,0.0,0.0,0.0,3095,72304,46425,-25879
18077,0.0,0.0,0.0,3095,72308,46425,-25883
18078,0.0,0.0,0.0,3095,72312,46425,-25887
18079,0.0,0.0,0.0,3095,72316,46425,-25891
18080,0.0,0.0,0.0,3095,72320,46425,-25895
18081,0.0,1.0,0.75,3095,72324,46425,-25899
18082,0.0,0.0,0.0,3095,72328,46425,-25903
18083,0.0,0.0,0.0,3095,72332,46425,-25907
18084,0.0,0.0,0.0,3095,72336,46425,-25911
18085,0.0,0.0,0.0,3095,72340,46425,-25915
18086,0.0,0.0,0.0,3095,72344,46425,-25919
18087,0.0,0.0,0.0,3095,72348,46425,-25923
18088,0.0,0.0,0.0,3095,72352,46425,-25927
18089,0.0,0.0,0.0,3095,72356,46425,-25931
18090,1.0,1.0,0.6666666666666666,3096,72360,46440,-25920
18091,0.0,0.0,0.0,3096,72364,46440,-25924
18092,0.0,0.0,0.0,3096,72368,46440,-25928
18093,0.0,0.0,0.0,3096,72372,46440,-25932
18094,0.0,0.0,0.0,3096,72376,46440,-25936
18095,0.0,0.0,0.0,3096,72380,46440,-25940
18096,0.0,0.0,0.0,3096,72384,46440,-25944
18097,1.0,1.0,1.0,3097,72388,46455,-25933
18098,0.0,0.0,0.0,3097,72392,46455,-25937
18099,0.0,0.0,0.0,3097,72396,46455,-25941
18100,0.0,0.0,0.0,3097,72400,46455,-25945
18101,0.0,0.0,0.0,3097,72404,46455,-25949
18102,0.0,0.0,0.0,3097,72408,46455,-25953
18103,0.0,0.0,0.0,3097,72412,46455,-25957
18104,0.0,0.0,0.0,3097,72416,46455,-25961
18105,0.0,0.0,0.0,3097,72420,46455,-25965
18106,0.0,0.0,0.0,3097,72424,46455,-25969
18107,0.0,0.0,0.0,3097,72428,46455,-25973
18108,0.0,0.0,0.25,3097,72432,46455,-25977
18109,0.0,0.0,0.0,3097,72436,46455,-25981
18110,0.0,0.0,0.0,3097,72440,46455,-25985
18111,0.0,0.0,0.0,3097,72444,46455,-25989
18112,0.0,0.0,0.0,3097,72448,46455,-25993
18113,0.0,0.0,0.0,3097,72452,46455,-25997
18114,0.0,0.0,0.0,3097,72456,46455,-26001
18115,0.0,0.0,0.0,3097,72460,46455,-26005
18116,0.0,0.0,0.0,3097,72464,46455,-26009
18117,0.0,0.0,0.0,3097,72468,46455,-26013
18118,0.0,0.0,0.0,3097,72472,46455,-26017
18119,0.0,0.0,0.0,3097,72476,46455,-26021
18120,0.0,0.0,0.0,3097,72480,46455,-26025
18121,1.0,1.0,1.0,3098,72484,46470,-26014
18122,0.0,0.0,0.0,3098,72488,46470,-26018
18123,1.0,1.0,1.0,3099,72492,46485,-26007
18124,0.0,0.0,0.0,3099,72496,46485,-26011
18125,0.0,0.0,0.0,3099,72500,46485,-26015
18126,0.0,0.0,0.0,3099,72504,46485,-26019
18127,0.0,0.0,0.0,3099,72508,46485,-26023
18128,0.0,0.0,0.0,3099,72512,46485,-26027
18129,0.0,0.0,0.0,3099,72516,46485,-26031
18130,0.0,0.0,0.0,3099,72520,46485,-26035
18131,0.0,0.0,0.0,3099,72524,46485,-26039
18132,0.0,0.0,0.0,3099,72528,46485,-26043
18133,0.0,0.0,0.3333333333333333,3099,72532,46485,-26047
18134,0.0,0.0,0.0,3099,72536,46485,-26051
18135,0.0,0.0,0.0,3099,72540,46485,-26055
18136,0.0,0.0,0.0,3099,72544,46485,-26059
18137,0.0,0.0,0.0,3099,72548,46485,-26063
18138,0.0,0.0,0.0,3099,72552,46485,-26067
18139,0.0,0.0,0.0,3099,72556,46485,-26071
18140,0.0,0.0,0.0,3099,72560,46485,-26075
18141,0.0,0.0,0.0,3099,72564,46485,-26079
18142,0.0,0.0,0.0,3099,72568,46485,-26083
18143,0.0,0.0,0.0,3099,72572,46485,-26087
18144,0.0,0.0,0.0,3099,72576,46485,-26091
18145,1.0,1.0,1.0,3100,72580,46500,-26080
18146,0.0,0.0,0.0,3100,72584,46500,-26084
18147,1.0,1.0,1.0,3101,72588,46515,-26073
18148,0.0,0.0,0.0,3101,72592,46515,-26077
18149,0.0,0.0,0.0,3101,72596,46515,-26081
18150,0.0,0.0,0.0,3101,72600,46515,-26085
18151,0.0,0.0,0.0,3101,72604,46515,-26089
18152,0.0,0.0,0.0,3101,72608,46515,-26093
18153,0.0,0.0,0.0,3101,72612,46515,-26097
18154,0.0,0.0,0.0,3101,72616,46515,-26101
18155,0.0,0.0,0.0,3101,72620,46515,-26105
18156,0.0,0.0,0.0,3101,72624,46515,-26109
18157,0.0,0.0,0.0,3101,72628,46515,-26113
18158,0.0,0.0,0.0,3101,72632,46515,-26117
18159,0.0,0.0,0.0,3101,72636,46515,-26121
18160,0.0,0.0,0.0,3101,72640,46515,-26125
18161,0.0,0.0,0.0,3101,72644,46515,-26129
18162,0.0,0.0,0.0,3101,72648,46515,-26133
18163,0.0,0.0,0.0,3101,72652,46515,-26137
18164,0.0,0.0,0.0,3101,72656,46515,-26141
18165,0.0,0.0,0.0,3101,72660,46515,-26145
18166,0.0,0.0,0.0,3101,72664,46515,-26149
18167,0.0,0.0,0.0,3101,72668,46515,-26153
18168,0.0,0.0,0.0,3101,72672,46515,-26157
18169,1.0,1.0,1.0,3102,72676,46530,-26146
18170,0.0,0.0,0.0,3102,72680,46530,-26150
18171,0.0,0.0,0.0,3102,72684,46530,-26154
18172,0.0,0.0,0.0,3102,72688,46530,-26158
18173,0.0,0.0,0.0,3102,72692,46530,-26162
18174,0.0,0.0,0.0,3102,72696,46530,-26166
18175,0.0,0.0,0.0,3102,72700,46530,-26170
18176,1.0,1.0,1.0,3103,72704,46545,-26159
18177,0.0,0.0,0.0,3103,72708,46545,-26163
18178,1.0,1.0,1.0,3104,72712,46560,-26152
18179,1.0,0.0,0.3333333333333333,3105,72716,46575,-26141
18180,0.0,0.0,0.0,3105,72720,46575,-26145
18181,0.0,0.0,0.0,3105,72724,46575,-26149
18182,0.0,0.0,0.0,3105,72728,46575,-26153
18183,1.0,1.0,1.0,3106,72732,46590,-26142
18184,0.0,0.0,0.0,3106,72736,46590,-26146
18185,0.0,0.0,0.0,3106,72740,46590,-26150
18186,0.0,0.0,0.0,3106,72744,46590,-26154
18187,0.0,0.0,0.0,3106,72748,46590,-26158
18188,0.0,0.0,0.0,3106,72752,46590,-26162
18189,0.0,0.0,0.0,3106,72756,46590,-26166
18190,0.0,0.0,0.0,3106,72760,46590,-26170
18191,0.0,0.0,0.0,3106,72764,46590,-26174
18192,0.0,0.0,0.0,3106,72768,46590,-26178
18193,0.0,0.0,0.0,3106,72772,46590,-26182
18194,0.0,0.0,0.0,3106,72776,46590,-26186
18195,0.0,0.0,0.0,3106,72780,46590,-26190
18196,0.0,0.0,0.0,3106,72784,46590,-26194
18197,0.0,0.0,0.0,3106,72788,46590,-26198
18198,0.0,0.0,0.0,3106,72792,46590,-26202
18199,0.0,0.0,0.0,3106,72796,46590,-26206
18200,0.0,0.0,0.5,3106,72800,46590,-26210
18201,0.0,0.0,0.0,3106,72804,46590,-26214
18202,1.0,1.0,1.0,3107,72808,46605,-26203
18203,0.0,0.0,0.0,3107,72812,46605,-26207
18204,0.0,0.0,0.0,3107,72816,46605,-26211
18205,0.0,0.0,0.0,3107,72820,46605,-26215
18206,0.0,0.0,0.0,3107,72824,46605,-26219
18207,0.0,0.0,0.0,3107,72828,46605,-26223
18208,0.0,0.0,0.0,3107,72832,46605,-26227
18209,0.0,0.0,0.0,3107,72836,46605,-26231
18210,0.0,0.0,0.0,3107,72840,46605,-26235
18211,0.0,0.0,0.0,3107,72844,46605,-26239
18212,1.0,1.0,0.6666666666666666,3108,72848,46620,-26228
18213,0.0,0.0,0.0,3108,72852,46620,-26232
18214,0.0,0.0,0.0,3108,72856,46620,-26236
18215,1.0,1.0,1.0,3109,72860,46635,-26225
18216,0.0,0.0,0.2,3109,72864,46635,-26229
18217,0.0,0.0,0.0,3109,72868,46635,-26233
18218,0.0,0.0,0.0,3109,72872,46635,-26237
18219,0.0,0.0,0.0,3109,72876,46635,-26241
18220,0.0,0.0,0.0,3109,72880,46635,-26245
18221,0.0,0.0,0.0,3109,72884,46635,-26249
18222,0.0,0.0,0.25,3109,72888,46635,-26253
18223,0.0,0.0,0.0,3109,72892,46635,-26257
18224,0.0,0.0,0.0,3109,72896,46635,-26261
18225,0.0,0.0,0.0,3109,72900,46635,-26265
18226,0.0,0.0,0.0,3109,72904,46635,-26269
18227,0.0,0.0,0.0,3109,72908,46635,-26273
18228,0.0,0.0,0.0,3109,72912,46635,-26277
18229,0.0,0.0,0.0,3109,72916,46635,-26281
18230,0.0,0.0,0.0,3109,72920,46635,-26285
18231,0.0,0.0,0.0,3109,72924,46635,-26289
18232,0.0,0.0,0.0,3109,72928,46635,-26293
18233,0.0,0.0,0.0,3109,72932,46635,-26297
18234,1.0,1.0,1.0,3110,72936,46650,-26286
18235,0.0,0.0,0.0,3110,72940,46650,-26290
18236,0.0,0.0,0.0,3110,72944,46650,-26294
18237,1.0,1.0,0.75,3111,72948,46665,-26283
18238,0.0,0.0,0.0,3111,72952,46665,-26287
18239,0.0,0.0,0.0,3111,72956,46665,-26291
18240,0.0,0.0,0.0,3111,72960,46665,-26295
18241,0.0,0.0,0.0,3111,72964,46665,-26299
18242,0.0,0.0,0.0,3111,72968,46665,-26303
18243,0.0,0.0,0.0,3111,72972,46665,-26307
18244,0.0,0.0,0.0,3111,72976,46665,-26311
18245,0.0,0.0,0.0,3111,72980,46665,-26315
18246,0.0,0.0,0.0,3111,72984,46665,-26319
18247,0.0,0.0,0.0,3111,72988,46665,-26323
18248,0.0,0.0,0.0,3111,72992,46665,-26327
18249,0.0,0.0,0.0,3111,72996,46665,-26331
18250,0.0,0.0,0.0,3111,73000,46665,-26335
18251,0.0,0.0,0.0,3111,73004,46665,-26339
18252,0.0,0.0,0.0,3111,73008,46665,-26343
18253,0.0,0.0,0.0,3111,73012,46665,-26347
18254,1.0,1.0,1.0,3112,73016,46680,-26336
18255,0.0,0.0,0.0,3112,73020,46680,-26340
18256,1.0,1.0,1.0,3113,73024,46695,-26329
18257,0.0,0.0,0.0,3113,73028,46695,-26333
18258,1.0,1.0,1.0,3114,73032,46710,-26322
18259,0.0,0.0,0.0,3114,73036,46710,-26326
18260,0.0,0.0,0.0,3114,73040,46710,-26330
18261,0.0,0.0,0.0,3114,73044,46710,-26334
18262,0.0,0.0,0.0,3114,73048,46710,-26338
18263,0.0,0.0,0.2,3114,73052,46710,-26342
18264,1.0,1.0,1.0,3115,73056,46725,-26331
18265,0.0,0.0,0.0,3115,73060,46725,-26335
18266,1.0,1.0,1.0,3116,73064,46740,-26324
18267,0.0,0.0,0.0,3116,73068,46740,-26328
18268,0.0,0.0,0.0,3116,73072,46740,-26332
18269,0.0,0.0,0.0,3116,73076,46740,-26336
18270,0.0,0.0,0.0,3116,73080,46740,-26340
18271,0.0,0.0,0.0,3116,73084,46740,-26344
18272,0.0,0.0,0.0,3116,73088,46740,-26348
18273,1.0,1.0,1.0,3117,73092,46755,-26337
18274,0.0,0.0,0.0,3117,73096,46755,-26341
18275,0.0,0.0,0.0,3117,73100,46755,-26345
18276,0.0,0.0,0.0,3117,73104,46755,-26349
18277,0.0,0.0,0.0,3117,73108,46755,-26353
18278,0.0,0.0,0.0,3117,73112,46755,-26357
18279,1.0,0.0,0.3333333333333333,3118,73116,46770,-26346
18280,0.0,0.0,0.0,3118,73120,46770,-26350
18281,1.0,1.0,1.0,3119,73124,46785,-26339
18282,0.0,0.0,0.0,3119,73128,46785,-26343
18283,1.0,1.0,1.0,3120,73132,46800,-26332
18284,0.0,0.0,0.0,3120,73136,46800,-26336
18285,1.0,1.0,1.0,3121,73140,46815,-26325
18286,0.0,0.0,0.0,3121,73144,46815,-26329
18287,0.0,0.0,0.0,3121,73148,46815,-26333
18288,1.0,1.0,1.0,3122,73152,46830,-26322
18289,0.0,0.0,0.0,3122,73156,46830,-26326
18290,0.0,0.0,0.0,3122,73160,46830,-26330
18291,0.0,0.0,0.0,3122,73164,46830,-26334
18292,0.0,0.0,0.0,3122,73168,46830,-26338
18293,0.0,0.0,0.0,3122,73172,46830,-26342
18294,0.0,0.0,0.0,3122,73176,46830,-26346
18295,0.0,0.0,0.0,3122,73180,46830,-26350
18296,0.0,0.0,0.0,3122,73184,46830,-26354
18297,0.0,0.0,0.0,3122,73188,46830,-26358
18298,0.0,0.0,0.0,3122,73192,46830,-26362
18299,1.0,1.0,1.0,3123,73196,46845,-26351
18300,0.0,0.0,0.0,3123,73200,46845,-26355
18301,0.0,0.0,0.0,3123,73204,46845,-26359
18302,0.0,0.0,0.0,3123,73208,46845,-26363
18303,0.0,0.0,0.0,3123,73212,46845,-26367
18304,0.0,0.0,0.0,3123,73216,46845,-26371
18305,1.0,1.0,1.0,3124,73220,46860,-26360
18306,0.0,0.0,0.0,3124,73224,46860,-26364
18307,0.0,0.0,0.0,3124,73228,46860,-26368
18308,0.0,0.0,0.0,3124,73232,46860,-26372
18309,0.0,0.0,0.0,3124,73236,46860,-26376
18310,0.0,0.0,0.0,3124,73240,46860,-26380
18311,0.0,0.0,0.0,3124,73244,46860,-26384
18312,0.0,0.0,0.0,3124,73248,46860,-26388
18313,0.0,0.0,0.0,3124,73252,46860,-26392
18314,0.0,0.0,0.0,3124,73256,46860,-26396
18315,0.0,0.0,0.0,3124,73260,46860,-26400
18316,1.0,1.0,0.6666666666666666,3125,73264,46875,-26389
18317,1.0,1.0,1.0,3126,73268,46890,-26378
18318,0.0,0.0,0.0,3126,73272,46890,-26382
18319,0.0,0.0,0.0,3126,73276,46890,-26386
18320,0.0,0.0,0.0,3126,73280,46890,-26390
18321,0.0,0.0,0.0,3126,73284,46890,-26394
18322,1.0,1.0,1.0,3127,73288,46905,-26383
18323,0.0,0.0,0.0,3127,73292,46905,-26387
18324,0.0,0.0,0.0,3127,73296,46905,-26391
18325,0.0,0.0,0.0,3127,73300,46905,-26395
18326,0.0,0.0,0.0,3127,73304,46905,-26399
18327,0.0,0.0,0.0,3127,73308,46905,-26403
18328,1.0,1.0,0.75,3128,73312,46920,-26392
18329,0.0,0.0,0.0,3128,73316,46920,-26396
18330,0.0,0.0,0.0,3128,73320,46920,-26400
18331,0.0,0.0,0.0,3128,73324,46920,-26404
18332,0.0,0.0,0.0,3128,73328,46920,-26408
18333,1.0,1.0,1.0,3129,73332,46935,-26397
18334,0.0,0.0,0.0,3129,73336,46935,-26401
18335,0.0,0.0,0.0,3129,73340,46935,-26405
18336,0.0,0.0,0.0,3129,73344,46935,-26409
18337,0.0,0.0,0.0,3129,73348,46935,-26413
18338,0.0,0.0,0.0,3129,73352,46935,-26417
18339,0.0,0.0,0.0,3129,73356,46935,-26421
18340,0.0,0.0,0.0,3129,73360,46935,-26425
18341,1.0,1.0,1.0,3130,73364,46950,-26414
18342,0.0,0.0,0.0,3130,73368,46950,-26418
18343,0.0,0.0,0.0,3130,73372,46950,-26422
18344,0.0,0.0,0.0,3130,73376,46950,-26426
18345,0.0,0.0,0.0,3130,73380,46950,-26430
18346,0.0,0.0,0.0,3130,73384,46950,-26434
18347,1.0,1.0,1.0,3131,73388,46965,-26423
18348,0.0,0.0,0.0,3131,73392,46965,-26427
18349,0.0,0.0,0.3333333333333333,3131,73396,46965,-26431
18350,0.0,0.0,0.0,3131,73400,46965,-26435
18351,0.0,0.0,0.0,3131,73404,46965,-26439
18352,0.0,0.0,0.0,3131,73408,46965,-26443
18353,0.0,0.0,0.0,3131,73412,46965,-26447
18354,0.0,0.0,0.0,3131,73416,46965,-26451
18355,0.0,0.0,0.0,3131,73420,46965,-26455
18356,0.0,0.0,0.0,3131,73424,46965,-26459
18357,0.0,0.0,0.0,3131,73428,46965,-26463
18358,0.0,0.0,0.0,3131,73432,46965,-26467
18359,0.0,0.0,0.0,3131,73436,46965,-26471
18360,0.0,0.0,0.0,3131,73440,46965,-26475
18361,0.0,0.0,0.0,3131,73444,46965,-26479
18362,0.0,0.0,0.0,3131,73448,46965,-26483
18363,0.0,0.0,0.2,3131,73452,46965,-26487
18364,0.0,0.0,0.0,3131,73456,46965,-26491
18365,0.0,0.0,0.0,3131,73460,46965,-26495
18366,1.0,1.0,1.0,3132,73464,46980,-26484
18367,0.0,0.0,0.0,3132,73468,46980,-26488
18368,0.0,0.0,0.0,3132,73472,46980,-26492
18369,0.0,0.0,0.0,3132,73476,46980,-26496
18370,0.0,0.0,0.0,3132,73480,46980,-26500
18371,0.0,0.0,0.0,3132,73484,46980,-26504
18372,0.0,0.0,0.0,3132,73488,46980,-26508
18373,0.0,0.0,0.0,3132,73492,46980,-26512
18374,0.0,0.0,0.0,3132,73496,46980,-26516
18375,0.0,0.0,0.0,3132,73500,46980,-26520
18376,1.0,1.0,0.6666666666666666,3133,73504,46995,-26509
18377,0.0,0.0,0.0,3133,73508,46995,-26513
18378,0.0,0.0,0.0,3133,73512,46995,-26517
18379,0.0,0.0,0.0,3133,73516,46995,-26521
18380,0.0,0.0,0.0,3133,73520,46995,-26525
18381,1.0,1.0,1.0,3134,73524,47010,-26514
18382,0.0,0.0,0.0,3134,73528,47010,-26518
18383,1.0,1.0,1.0,3135,73532,47025,-26507
18384,0.0,0.0,0.0,3135,73536,47025,-26511
18385,0.0,0.0,0.0,3135,73540,47025,-26515
18386,0.0,0.0,0.0,3135,73544,47025,-26519
18387,0.0,0.0,0.0,3135,73548,47025,-26523
18388,0.0,0.0,0.0,3135,73552,47025,-26527
18389,1.0,1.0,1.0,3136,73556,47040,-26516
18390,0.0,0.0,0.0,3136,73560,47040,-26520
18391,0.0,0.0,0.0,3136,73564,47040,-26524
18392,0.0,0.0,0.0,3136,73568,47040,-26528
18393,0.0,0.0,0.0,3136,73572,47040,-26532
18394,1.0,1.0,1.0,3137,73576,47055,-26521
18395,0.0,0.0,0.3333333333333333,3137,73580,47055,-26525
18396,1.0,1.0,0.6666666666666666,3138,73584,47070,-26514
18397,0.0,0.0,0.0,3138,73588,47070,-26518
18398,0.0,0.0,0.0,3138,73592,47070,-26522
18399,0.0,0.0,0.0,3138,73596,47070,-26526
18400,0.0,0.0,0.25,3138,73600,47070,-26530
18401,1.0,1.0,1.0,3139,73604,47085,-26519
18402,0.0,0.0,0.0,3139,73608,47085,-26523
18403,0.0,0.0,0.0,3139,73612,47085,-26527
18404,0.0,0.0,0.0,3139,73616,47085,-26531
18405,0.0,0.0,0.0,3139,73620,47085,-26535
18406,0.0,0.0,0.0,3139,73624,47085,-26539
18407,0.0,0.0,0.0,3139,73628,47085,-26543
18408,0.0,0.0,0.0,3139,73632,47085,-26547
18409,0.0,0.0,0.0,3139,73636,47085,-26551
18410,0.0,0.0,0.0,3139,73640,47085,-26555
18411,1.0,1.0,1.0,3140,73644,47100,-26544
18412,0.0,0.0,0.0,3140,73648,47100,-26548
18413,0.0,0.0,0.0,3140,73652,47100,-26552
18414,0.0,0.0,0.0,3140,73656,47100,-26556
18415,0.0,0.0,0.0,3140,73660,47100,-26560
18416,0.0,0.0,0.0,3140,73664,47100,-26564
18417,0.0,0.0,0.0,3140,73668,47100,-26568
18418,0.0,0.0,0.0,3140,73672,47100,-26572
18419,1.0,0.0,0.3333333333333333,3141,73676,47115,-26561
18420,0.0,0.0,0.0,3141,73680,47115,-26565
18421,0.0,0.0,0.0,3141,73684,47115,-26569
18422,0.0,0.0,0.0,3141,73688,47115,-26573
18423,0.0,0.0,0.0,3141,73692,47115,-26577
18424,0.0,0.0,0.0,3141,73696,47115,-26581
18425,0.0,0.0,0.0,3141,73700,47115,-26585
18426,0.0,0.0,0.0,3141,73704,47115,-26589
18427,0.0,0.0,0.0,3141,73708,47115,-26593
18428,0.0,0.0,0.0,3141,73712,47115,-26597
18429,0.0,0.0,0.0,3141,73716,47115,-26601
18430,0.0,0.0,0.0,3141,73720,47115,-26605
18431,0.0,0.0,0.0,3141,73724,47115,-26609
18432,1.0,1.0,1.0,3142,73728,47130,-26598
18433,0.0,0.0,0.0,3142,73732,47130,-26602
18434,0.0,0.0,0.0,3142,73736,47130,-26606
18435,0.0,0.0,0.0,3142,73740,47130,-26610
18436,0.0,0.0,0.0,3142,73744,47130,-26614
18437,0.0,0.0,0.0,3142,73748,47130,-26618
18438,0.0,0.0,0.0,3142,73752,47130,-26622
18439,0.0,0.0,0.0,3142,73756,47130,-26626
18440,0.0,0.0,0.0,3142,73760,47130,-26630
18441,0.0,0.0,0.0,3142,73764,47130,-26634
18442,0.0,1.0,0.6,3142,73768,47130,-26638
18443,0.0,0.0,0.0,3142,73772,47130,-26642
18444,0.0,0.0,0.0,3142,73776,47130,-26646
18445,0.0,0.0,0.0,3142,73780,47130,-26650
18446,0.0,0.0,0.0,3142,73784,47130,-26654
18447,0.0,0.0,0.0,3142,73788,47130,-26658
18448,0.0,0.0,0.0,3142,73792,47130,-26662
18449,0.0,0.0,0.0,3142,73796,47130,-26666
18450,0.0,0.0,0.0,3142,73800,47130,-26670
18451,1.0,1.0,1.0,3143,73804,47145,-26659
18452,0.0,0.0,0.0,3143,73808,47145,-26663
18453,0.0,0.0,0.0,3143,73812,47145,-26667
18454,0.0,0.0,0.0,3143,73816,47145,-26671
18455,0.0,0.0,0.0,3143,73820,47145,-26675
18456,0.0,0.0,0.0,3143,73824,47145,-26679
18457,0.0,0.0,0.0,3143,73828,47145,-26683
18458,0.0,0.0,0.0,3143,73832,47145,-26687
18459,0.0,0.0,0.0,3143,73836,47145,-26691
18460,0.0,0.0,0.0,3143,73840,47145,-26695
18461,1.0,1.0,1.0,3144,73844,47160,-26684
18462,1.0,1.0,1.0,3145,73848,47175,-26673
18463,0.0,0.0,0.0,3145,73852,47175,-26677
18464,0.0,0.0,0.0,3145,73856,47175,-26681
18465,0.0,0.0,0.0,3145,73860,47175,-26685
18466,0.0,0.0,0.0,3145,73864,47175,-26689
18467,0.0,0.0,0.0,3145,73868,47175,-26693
18468,0.0,0.0,0.0,3145,73872,47175,-26697
18469,0.0,0.0,0.0,3145,73876,47175,-26701
18470,0.0,0.0,0.0,3145,73880,47175,-26705
18471,0.0,0.0,0.0,3145,73884,47175,-26709
18472,0.0,0.0,0.0,3145,73888,47175,-26713
18473,0.0,0.0,0.0,3145,73892,47175,-26717
18474,1.0,1.0,1.0,3146,73896,47190,-26706
18475,1.0,0.0,0.4,3147,73900,47205,-26695
18476,0.0,0.0,0.0,3147,73904,47205,-26699
18477,0.0,0.0,0.0,3147,73908,47205,-26703
18478,0.0,0.0,0.0,3147,73912,47205,-26707
18479,0.0,0.0,0.0,3147,73916,47205,-26711
18480,0.0,0.0,0.0,3147,73920,47205,-26715
18481,1.0,1.0,1.0,3148,73924,47220,-26704
18482,1.0,1.0,0.6666666666666666,3149,73928,47235,-26693
18483,1.0,1.0,1.0,3150,73932,47250,-26682
18484,1.0,1.0,1.0,3151,73936,47265,-26671
18485,0.0,0.0,0.0,3151,73940,47265,-26675
18486,0.0,0.0,0.0,3151,73944,47265,-26679
18487,0.0,0.0,0.0,3151,73948,47265,-26683
18488,0.0,0.0,0.0,3151,73952,47265,-26687
18489,0.0,0.0,0.3333333333333333,3151,73956,47265,-26691
18490,0.0,0.0,0.0,3151,73960,47265,-26695
18491,0.0,0.0,0.0,3151,73964,47265,-26699
18492,0.0,0.0,0.0,3151,73968,47265,-26703
18493,0.0,0.0,0.0,3151,73972,47265,-26707
18494,0.0,0.0,0.0,3151,73976,47265,-26711
18495,0.0,0.0,0.0,3151,73980,47265,-26715
18496,0.0,0.0,0.0,3151,73984,47265,-26719
18497,1.0,1.0,0.6,3152,73988,47280,-26708
18498,0.0,0.0,0.0,3152,73992,47280,-26712
18499,0.0,0.0,0.0,3152,73996,47280,-26716
18500,0.0,0.0,0.0,3152,74000,47280,-26720
18501,0.0,0.0,0.0,3152,74004,47280,-26724
18502,0.0,0.0,0.0,3152,74008,47280,-26728
18503,0.0,0.0,0.0,3152,74012,47280,-26732
18504,0.0,0.0,0.0,3152,74016,47280,-26736
18505,0.0,0.0,0.0,3152,74020,47280,-26740
18506,0.0,0.0,0.0,3152,74024,47280,-26744
18507,0.0,0.0,0.0,3152,74028,47280,-26748
18508,0.0,0.0,0.0,3152,74032,47280,-26752
18509,0.0,0.0,0.0,3152,74036,47280,-26756
18510,0.0,0.0,0.0,3152,74040,47280,-26760
18511,0.0,0.0,0.0,3152,74044,47280,-26764
18512,0.0,0.0,0.0,3152,74048,47280,-26768
18513,0.0,0.0,0.0,3152,74052,47280,-26772
18514,0.0,0.0,0.0,3152,74056,47280,-26776
18515,0.0,0.0,0.0,3152,74060,47280,-26780
18516,0.0,0.0,0.0,3152,74064,47280,-26784
18517,0.0,0.0,0.0,3152,74068,47280,-26788
18518,0.0,0.0,0.0,3152,74072,47280,-26792
18519,0.0,0.0,0.0,3152,74076,47280,-26796
18520,0.0,0.0,0.0,3152,74080,47280,-26800
18521,0.0,0.0,0.0,3152,74084,47280,-26804
18522,0.0,0.0,0.0,3152,74088,47280,-26808
18523,0.0,0.0,0.0,3152,74092,47280,-26812
18524,0.0,0.0,0.0,3152,74096,47280,-26816
18525,0.0,0.0,0.0,3152,74100,47280,-26820
18526,0.0,0.0,0.3333333333333333,3152,74104,47280,-26824
18527,0.0,0.0,0.0,3152,74108,47280,-26828
18528,0.0,0.0,0.0,3152,74112,47280,-26832
18529,0.0,0.0,0.0,3152,74116,47280,-26836
18530,0.0,0.0,0.0,3152,74120,47280,-26840
18531,1.0,1.0,1.0,3153,74124,47295,-26829
18532,0.0,0.0,0.0,3153,74128,47295,-26833
18533,0.0,0.0,0.0,3153,74132,47295,-26837
18534,0.0,0.0,0.0,3153,74136,47295,-26841
18535,0.0,0.0,0.0,3153,74140,47295,-26845
18536,0.0,0.0,0.0,3153,74144,47295,-26849
18537,0.0,0.0,0.0,3153,74148,47295,-26853
18538,1.0,0.0,0.5,3154,74152,47310,-26842
18539,1.0,1.0,1.0,3155,74156,47325,-26831
18540,0.0,0.0,0.0,3155,74160,47325,-26835
18541,0.0,0.0,0.0,3155,74164,47325,-26839
18542,0.0,0.0,0.0,3155,74168,47325,-26843
18543,0.0,0.0,0.0,3155,74172,47325,-26847
18544,0.0,0.0,0.0,3155,74176,47325,-26851
18545,0.0,0.0,0.0,3155,74180,47325,-26855
18546,0.0,0.0,0.0,3155,74184,47325,-26859
18547,0.0,0.0,0.0,3155,74188,47325,-26863
18548,0.0,0.0,0.0,3155,74192,47325,-26867
18549,1.0,1.0,1.0,3156,74196,47340,-26856
18550,0.0,0.0,0.0,3156,74200,47340,-26860
18551,0.0,0.0,0.0,3156,74204,47340,-26864
18552,0.0,0.0,0.0,3156,74208,47340,-26868
18553,0.0,0.0,0.0,3156,74212,47340,-26872
18554,0.0,0.0,0.0,3156,74216,47340,-26876
18555,0.0,0.0,0.0,3156,74220,47340,-26880
18556,0.0,0.0,0.0,3156,74224,47340,-26884
18557,0.0,0.0,0.0,3156,74228,47340,-26888
18558,0.0,0.0,0.0,3156,74232,47340,-26892
18559,0.0,0.0,0.0,3156,74236,47340,-26896
18560,0.0,0.0,0.0,3156,74240,47340,-26900
18561,0.0,0.0,0.0,3156,74244,47340,-26904
18562,0.0,0.0,0.0,3156,74248,47340,-26908
18563,0.0,0.0,0.0,3156,74252,47340,-26912
18564,0.0,0.0,0.0,3156,74256,47340,-26916
18565,0.0,1.0,0.6666666666666666,3156,74260,47340,-26920
18566,0.0,0.0,0.0,3156,74264,47340,-26924
18567,0.0,0.0,0.0,3156,74268,47340,-26928
18568,1.0,1.0,1.0,3157,74272,47355,-26917
18569,0.0,0.0,0.0,3157,74276,47355,-26921
18570,0.0,0.0,0.0,3157,74280,47355,-26925
18571,0.0,0.0,0.0,3157,74284,47355,-26929
18572,0.0,0.0,0.0,3157,74288,47355,-26933
18573,0.0,0.0,0.0,3157,74292,47355,-26937
18574,0.0,0.0,0.0,3157,74296,47355,-26941
18575,0.0,0.0,0.0,3157,74300,47355,-26945
18576,0.0,0.0,0.0,3157,74304,47355,-26949
18577,0.0,0.0,0.0,3157,74308,47355,-26953
18578,0.0,0.0,0.0,3157,74312,47355,-26957
18579,0.0,0.0,0.0,3157,74316,47355,-26961
18580,1.0,1.0,1.0,3158,74320,47370,-26950
18581,0.0,0.0,0.0,3158,74324,47370,-26954
18582,0.0,0.0,0.0,3158,74328,47370,-26958
18583,0.0,0.0,0.0,3158,74332,47370,-26962
18584,0.0,0.0,0.0,3158,74336,47370,-26966
18585,0.0,0.0,0.0,3158,74340,47370,-26970
18586,0.0,0.0,0.0,3158,74344,47370,-26974
18587,0.0,0.0,0.0,3158,74348,47370,-26978
18588,0.0,0.0,0.0,3158,74352,47370,-26982
18589,0.0,0.0,0.0,3158,74356,47370,-26986
18590,0.0,0.0,0.0,3158,74360,47370,-26990
18591,0.0,0.0,0.0,3158,74364,47370,-26994
18592,0.0,0.0,0.0,3158,74368,47370,-26998
18593,0.0,0.0,0.0,3158,74372,47370,-27002
18594,0.0,0.0,0.0,3158,74376,47370,-27006
18595,0.0,0.0,0.0,3158,74380,47370,-27010
18596,0.0,0.0,0.0,3158,74384,47370,-27014
18597,0.0,0.0,0.0,3158,74388,47370,-27018
18598,1.0,1.0,1.0,3159,74392,47385,-27007
18599,1.0,1.0,1.0,3160,74396,47400,-26996
18600,0.0,0.0,0.0,3160,74400,47400,-27000
18601,1.0,1.0,1.0,3161,74404,47415,-26989
18602,0.0,0.0,0.0,3161,74408,47415,-26993
18603,1.0,0.0,0.3333333333333333,3162,74412,47430,-26982
18604,0.0,0.0,0.0,3162,74416,47430,-26986
18605,0.0,0.0,0.0,3162,74420,47430,-26990
18606,0.0,0.0,0.0,3162,74424,47430,-26994
18607,0.0,0.0,0.0,3162,74428,47430,-26998
18608,1.0,1.0,1.0,3163,74432,47445,-26987
18609,1.0,1.0,1.0,3164,74436,47460,-26976
18610,0.0,0.0,0.0,3164,74440,47460,-26980
18611,0.0,0.0,0.0,3164,74444,47460,-26984
18612,0.0,0.0,0.0,3164,74448,47460,-26988
18613,0.0,0.0,0.0,3164,74452,47460,-26992
18614,0.0,0.0,0.0,3164,74456,47460,-26996
18615,1.0,1.0,1.0,3165,74460,47475,-26985
18616,0.0,0.0,0.0,3165,74464,47475,-26989
18617,0.0,0.0,0.0,3165,74468,47475,-26993
18618,0.0,0.0,0.0,3165,74472,47475,-26997
18619,0.0,0.0,0.0,3165,74476,47475,-27001
18620,0.0,0.0,0.0,3165,74480,47475,-27005
18621,0.0,0.0,0.0,3165,74484,47475,-27009
18622,1.0,1.0,0.6666666666666666,3166,74488,47490,-26998
18623,0.0,0.0,0.0,3166,74492,47490,-27002
18624,0.0,1.0,0.6666666666666666,3166,74496,47490,-27006
18625,0.0,0.0,0.0,3166,74500,47490,-27010
18626,1.0,1.0,1.0,3167,74504,47505,-26999
18627,0.0,0.0,0.0,3167,74508,47505,-27003
18628,0.0,0.0,0.0,3167,74512,47505,-27007
18629,0.0,0.0,0.0,3167,74516,47505,-27011
18630,1.0,1.0,1.0,3168,74520,47520,-27000
18631,0.0,0.0,0.0,3168,74524,47520,-27004
18632,0.0,0.0,0.0,3168,74528,47520,-27008
18633,0.0,0.0,0.0,3168,74532,47520,-27012
18634,0.0,0.0,0.0,3168,74536,47520,-27016
18635,1.0,1.0,0.75,3169,74540,47535,-27005
18636,0.0,0.0,0.0,3169,74544,47535,-27009
18637,0.0,0.0,0.0,3169,74548,47535,-27013
18638,0.0,0.0,0.0,3169,74552,47535,-27017
18639,0.0,0.0,0.0,3169,74556,47535,-27021
18640,0.0,0.0,0.0,3169,74560,47535,-27025
18641,0.0,0.0,0.0,3169,74564,47535,-27029
18642,1.0,1.0,1.0,3170,74568,47550,-27018
18643,0.0,0.0,0.0,3170,74572,47550,-27022
18644,0.0,0.0,0.0,3170,74576,47550,-27026
18645,0.0,0.0,0.0,3170,74580,47550,-27030
18646,0.0,0.0,0.0,3170,74584,47550,-27034
18647,0.0,0.0,0.0,3170,74588,47550,-27038
18648,0.0,0.0,0.0,3170,74592,47550,-27042
18649,0.0,0.0,0.0,3170,74596,47550,-27046
18650,0.0,0.0,0.0,3170,74600,47550,-27050
18651,0.0,0.0,0.0,3170,74604,47550,-27054
18652,0.0,0.0,0.0,3170,74608,47550,-27058
18653,0.0,0.0,0.0,3170,74612,47550,-27062
18654,0.0,0.0,0.0,3170,74616,47550,-27066
18655,0.0,0.0,0.0,3170,74620,47550,-27070
18656,0.0,0.0,0.0,3170,74624,47550,-27074
18657,0.0,0.0,0.0,3170,74628,47550,-27078
18658,0.0,0.0,0.0,3170,74632,47550,-27082
18659,0.0,0.0,0.0,3170,74636,47550,-27086
18660,0.0,0.0,0.0,3170,74640,47550,-27090
18661,0.0,1.0,0.8,3170,74644,47550,-27094
18662,0.0,0.0,0.0,3170,74648,47550,-27098
18663,0.0,0.0,0.0,3170,74652,47550,-27102
18664,0.0,0.0,0.0,3170,74656,47550,-27106
18665,0.0,0.0,0.0,3170,74660,47550,-27110
18666,1.0,1.0,0.75,3171,74664,47565,-27099
18667,1.0,1.0,1.0,3172,74668,47580,-27088
18668,0.0,0.0,0.0,3172,74672,47580,-27092
18669,0.0,0.0,0.0,3172,74676,47580,-27096
18670,0.0,0.0,0.0,3172,74680,47580,-27100
18671,0.0,0.0,0.0,3172,74684,47580,-27104
18672,1.0,1.0,1.0,3173,74688,47595,-27093
18673,0.0,0.0,0.0,3173,74692,47595,-27097
18674,0.0,0.0,0.0,3173,74696,47595,-27101
18675,0.0,0.0,0.0,3173,74700,47595,-27105
18676,0.0,0.0,0.0,3173,74704,47595,-27109
18677,0.0,0.0,0.0,3173,74708,47595,-27113
18678,1.0,1.0,1.0,3174,74712,47610,-27102
18679,0.0,0.0,0.0,3174,74716,47610,-27106
18680,0.0,0.0,0.0,3174,74720,47610,-27110
18681,1.0,1.0,0.75,3175,74724,47625,-27099
18682,0.0,0.0,0.0,3175,74728,47625,-27103
18683,0.0,0.0,0.0,3175,74732,47625,-27107
18684,0.0,0.0,0.0,3175,74736,47625,-27111
18685,0.0,0.0,0.0,3175,74740,47625,-27115
18686,0.0,0.0,0.0,3175,74744,47625,-27119
18687,0.0,0.0,0.0,3175,74748,47625,-27123
18688,0.0,0.0,0.0,3175,74752,47625,-27127
18689,0.0,0.0,0.0,3175,74756,47625,-27131
18690,0.0,0.0,0.0,3175,74760,47625,-27135
18691,0.0,0.0,0.0,3175,74764,47625,-27139
18692,0.0,0.0,0.0,3175,74768,47625,-27143
18693,0.0,0.0,0.0,3175,74772,47625,-27147
18694,0.0,0.0,0.0,3175,74776,47625,-27151
18695,0.0,0.0,0.0,3175,74780,47625,-27155
18696,1.0,0.0,0.3333333333333333,3176,74784,47640,-27144
18697,0.0,0.0,0.0,3176,74788,47640,-27148
18698,0.0,0.0,0.0,3176,74792,47640,-27152
18699,1.0,1.0,1.0,3177,74796,47655,-27141
18700,0.0,0.0,0.0,3177,74800,47655,-27145
18701,0.0,0.0,0.0,3177,74804,47655,-27149
18702,0.0,0.0,0.3333333333333333,3177,74808,47655,-27153
18703,0.0,0.0,0.0,3177,74812,47655,-27157
18704,0.0,0.0,0.0,3177,74816,47655,-27161
18705,0.0,0.0,0.0,3177,74820,47655,-27165
18706,0.0,0.0,0.0,3177,74824,47655,-27169
18707,0.0,0.0,0.0,3177,74828,47655,-27173
18708,0.0,0.0,0.2,3177,74832,47655,-27177
18709,0.0,0.0,0.0,3177,74836,47655,-27181
18710,0.0,0.0,0.0,3177,74840,47655,-27185
18711,0.0,0.0,0.0,3177,74844,47655,-27189
18712,0.0,0.0,0.0,3177,74848,47655,-27193
18713,0.0,0.0,0.0,3177,74852,47655,-27197
18714,0.0,0.0,0.0,3177,74856,47655,-27201
18715,0.0,0.0,0.0,3177,74860,47655,-27205
18716,1.0,1.0,1.0,3178,74864,47670,-27194
18717,0.0,0.0,0.0,3178,74868,47670,-27198
18718,0.0,0.0,0.0,3178,74872,47670,-27202
18719,0.0,0.0,0.0,3178,74876,47670,-27206
18720,0.0,0.0,0.0,3178,74880,47670,-27210
18721,1.0,1.0,1.0,3179,74884,47685,-27199
18722,1.0,1.0,0.8,3180,74888,47700,-27188
18723,0.0,0.0,0.0,3180,74892,47700,-27192
18724,0.0,0.0,0.0,3180,74896,47700,-27196
18725,1.0,1.0,1.0,3181,74900,47715,-27185
18726,0.0,0.0,0.0,3181,74904,47715,-27189
18727,0.0,0.0,0.0,3181,74908,47715,-27193
18728,0.0,0.0,0.0,3181,74912,47715,-27197
18729,0.0,0.0,0.0,3181,74916,47715,-27201
18730,0.0,0.0,0.0,3181,74920,47715,-27205
18731,0.0,0.0,0.0,3181,74924,47715,-27209
18732,0.0,0.0,0.0,3181,74928,47715,-27213
18733,0.0,0.0,0.0,3181,74932,47715,-27217
18734,1.0,1.0,0.6,3182,74936,47730,-27206
18735,0.0,0.0,0.0,3182,74940,47730,-27210
18736,0.0,0.0,0.0,3182,74944,47730,-27214
18737,0.0,0.0,0.0,3182,74948,47730,-27218
18738,1.0,0.0,0.5,3183,74952,47745,-27207
18739,1.0,1.0,1.0,3184,74956,47760,-27196
18740,0.0,0.0,0.0,3184,74960,47760,-27200
18741,0.0,0.0,0.0,3184,74964,47760,-27204
18742,0.0,1.0,0.6666666666666666,3184,74968,47760,-27208
18743,0.0,0.0,0.0,3184,74972,47760,-27212
18744,0.0,0.0,0.0,3184,74976,47760,-27216
18745,0.0,0.0,0.0,3184,74980,47760,-27220
18746,1.0,1.0,1.0,3185,74984,47775,-27209
18747,0.0,0.0,0.0,3185,74988,47775,-27213
18748,0.0,0.0,0.0,3185,74992,47775,-27217
18749,1.0,1.0,1.0,3186,74996,47790,-27206
18750,1.0,1.0,1.0,3187,75000,47805,-27195
18751,0.0,0.0,0.0,3187,75004,47805,-27199
18752,0.0,0.0,0.0,3187,75008,47805,-27203
18753,0.0,0.0,0.0,3187,75012,47805,-27207
18754,0.0,1.0,0.6666666666666666,3187,75016,47805,-27211
18755,0.0,0.0,0.0,3187,75020,47805,-27215
18756,0.0,0.0,0.0,3187,75024,47805,-27219
18757,0.0,0.0,0.0,3187,75028,47805,-27223
18758,0.0,0.0,0.0,3187,75032,47805,-27227
18759,0.0,0.0,0.0,3187,75036,47805,-27231
18760,0.0,0.0,0.0,3187,75040,47805,-27235
18761,0.0,0.0,0.2,3187,75044,47805,-27239
18762,0.0,0.0,0.0,3187,75048,47805,-27243
18763,1.0,1.0,0.6666666666666666,3188,75052,47820,-27232
18764,0.0,0.0,0.0,3188,75056,47820,-27236
18765,0.0,0.0,0.0,3188,75060,47820,-27240
18766,0.0,0.0,0.0,3188,75064,47820,-27244
18767,0.0,0.0,0.0,3188,75068,47820,-27248
18768,0.0,0.0,0.0,3188,75072,47820,-27252
18769,0.0,0.0,0.0,3188,75076,47820,-27256
18770,0.0,0.0,0.0,3188,75080,47820,-27260
18771,0.0,0.0,0.0,3188,75084,47820,-27264
18772,1.0,0.0,0.3333333333333333,3189,75088,47835,-27253
18773,0.0,0.0,0.0,3189,75092,47835,-27257
18774,0.0,0.0,0.0,3189,75096,47835,-27261
18775,0.0,0.0,0.0,3189,75100,47835,-27265
18776,0.0,0.0,0.0,3189,75104,47835,-27269
18777,0.0,0.0,0.0,3189,75108,47835,-27273
18778,1.0,0.0,0.2,3190,75112,47850,-27262
18779,0.0,0.0,0.0,3190,75116,47850,-27266
18780,0.0,0.0,0.0,3190,75120,47850,-27270
18781,0.0,0.0,0.3333333333333333,3190,75124,47850,-27274
18782,0.0,0.0,0.0,3190,75128,47850,-27278
18783,0.0,0.0,0.0,3190,75132,47850,-27282
18784,1.0,1.0,1.0,3191,75136,47865,-27271
18785,0.0,0.0,0.0,3191,75140,47865,-27275
18786,0.0,0.0,0.0,3191,75144,47865,-27279
18787,0.0,0.0,0.0,3191,75148,47865,-27283
18788,0.0,0.0,0.0,3191,75152,47865,-27287
18789,0.0,0.0,0.0,3191,75156,47865,-27291
18790,0.0,0.0,0.0,3191,75160,47865,-27295
18791,0.0,0.0,0.0,3191,75164,47865,-27299
18792,0.0,0.0,0.0,3191,75168,47865,-27303
18793,0.0,0.0,0.0,3191,75172,47865,-27307
18794,0.0,0.0,0.0,3191,75176,47865,-27311
18795,0.0,0.0,0.0,3191,75180,47865,-27315
18796,0.0,0.0,0.0,3191,75184,47865,-27319
18797,1.0,0.0,0.3333333333333333,3192,75188,47880,-27308
18798,0.0,0.0,0.0,3192,75192,47880,-27312
18799,0.0,0.0,0.0,3192,75196,47880,-27316
18800,0.0,0.0,0.0,3192,75200,47880,-27320
18801,0.0,0.0,0.0,3192,75204,47880,-27324
18802,1.0,1.0,1.0,3193,75208,47895,-27313
18803,1.0,1.0,1.0,3194,75212,47910,-27302
18804,0.0,0.0,0.0,3194,75216,47910,-27306
18805,0.0,0.0,0.0,3194,75220,47910,-27310
18806,0.0,0.0,0.0,3194,75224,47910,-27314
18807,0.0,0.0,0.0,3194,75228,47910,-27318
18808,0.0,0.0,0.0,3194,75232,47910,-27322
18809,0.0,0.0,0.0,3194,75236,47910,-27326
18810,1.0,1.0,1.0,3195,75240,47925,-27315
18811,0.0,0.0,0.0,3195,75244,47925,-27319
18812,0.0,0.0,0.0,3195,75248,47925,-27323
18813,1.0,1.0,1.0,3196,75252,47940,-27312
18814,0.0,0.0,0.0,3196,75256,47940,-27316
18815,0.0,0.0,0.0,3196,75260,47940,-27320
18816,0.0,0.0,0.0,3196,75264,47940,-27324
18817,0.0,0.0,0.0,3196,75268,47940,-27328
18818,0.0,0.0,0.0,3196,75272,47940,-27332
18819,1.0,1.0,1.0,3197,75276,47955,-27321
18820,0.0,0.0,0.0,3197,75280,47955,-27325
18821,0.0,0.0,0.0,3197,75284,47955,-27329
18822,0.0,0.0,0.0,3197,75288,47955,-27333
18823,0.0,0.0,0.0,3197,75292,47955,-27337
18824,0.0,0.0,0.0,3197,75296,47955,-27341
18825,0.0,0.0,0.0,3197,75300,47955,-27345
18826,0.0,0.0,0.0,3197,75304,47955,-27349
18827,0.0,0.0,0.0,3197,75308,47955,-27353
18828,0.0,0.0,0.0,3197,75312,47955,-27357
18829,0.0,0.0,0.0,3197,75316,47955,-27361
18830,0.0,0.0,0.0,3197,75320,47955,-27365
18831,0.0,0.0,0.0,3197,75324,47955,-27369
18832,0.0,0.0,0.0,3197,75328,47955,-27373
18833,0.0,0.0,0.0,3197,75332,47955,-27377
18834,0.0,0.0,0.0,3197,75336,47955,-27381
18835,0.0,0.0,0.0,3197,75340,47955,-27385
18836,0.0,0.0,0.0,3197,75344,47955,-27389
18837,0.0,0.0,0.0,3197,75348,47955,-27393
18838,0.0,0.0,0.0,3197,75352,47955,-27397
18839,0.0,0.0,0.0,3197,75356,47955,-27401
18840,0.0,0.0,0.0,3197,75360,47955,-27405
18841,0.0,0.0,0.0,3197,75364,47955,-27409
18842,0.0,0.0,0.0,3197,75368,47955,-27413
18843,0.0,0.0,0.0,3197,75372,47955,-27417
18844,1.0,1.0,1.0,3198,75376,47970,-27406
18845,0.0,0.0,0.0,3198,75380,47970,-27410
18846,0.0,0.0,0.0,3198,75384,47970,-27414
18847,0.0,0.0,0.0,3198,75388,47970,-27418
18848,0.0,0.0,0.0,3198,75392,47970,-27422
18849,0.0,0.0,0.0,3198,75396,47970,-27426
18850,1.0,1.0,1.0,3199,75400,47985,-27415
18851,0.0,0.0,0.0,3199,75404,47985,-27419
18852,0.0,0.0,0.0,3199,75408,47985,-27423
18853,0.0,0.0,0.0,3199,75412,47985,-27427
18854,0.0,0.0,0.5,3199,75416,47985,-27431
18855,0.0,0.0,0.0,3199,75420,47985,-27435
18856,0.0,0.0,0.0,3199,75424,47985,-27439
18857,0.0,0.0,0.0,3199,75428,47985,-27443
18858,0.0,0.0,0.0,3199,75432,47985,-27447
18859,0.0,0.0,0.0,3199,75436,47985,-27451
18860,0.0,0.0,0.0,3199,75440,47985,-27455
18861,0.0,0.0,0.0,3199,75444,47985,-27459
18862,0.0,0.0,0.0,3199,75448,47985,-27463
18863,1.0,1.0,1.0,3200,75452,48000,-27452
18864,0.0,0.0,0.0,3200,75456,48000,-27456
18865,0.0,0.0,0.3333333333333333,3200,75460,48000,-27460
18866,1.0,1.0,1.0,3201,75464,48015,-27449
18867,1.0,1.0,1.0,3202,75468,48030,-27438
18868,0.0,0.0,0.0,3202,75472,48030,-27442
18869,0.0,0.0,0.5,3202,75476,48030,-27446
18870,0.0,0.0,0.0,3202,75480,48030,-27450
18871,0.0,0.0,0.0,3202,75484,48030,-27454
18872,0.0,0.0,0.0,3202,75488,48030,-27458
18873,0.0,0.0,0.5,3202,75492,48030,-27462
18874,0.0,0.0,0.0,3202,75496,48030,-27466
18875,0.0,0.0,0.0,3202,75500,48030,-27470
18876,0.0,0.0,0.0,3202,75504,48030,-27474
18877,1.0,1.0,1.0,3203,75508,48045,-27463
18878,0.0,0.0,0.0,3203,75512,48045,-27467
18879,1.0,1.0,1.0,3204,75516,48060,-27456
18880,1.0,1.0,1.0,3205,75520,48075,-27445
18881,0.0,0.0,0.0,3205,75524,48075,-27449
18882,0.0,0.0,0.0,3205,75528,48075,-27453
18883,0.0,0.0,0.0,3205,75532,48075,-27457
18884,0.0,0.0,0.0,3205,75536,48075,-27461
18885,1.0,1.0,0.6666666666666666,3206,75540,48090,-27450
18886,0.0,0.0,0.0,3206,75544,48090,-27454
18887,0.0,0.0,0.0,3206,75548,48090,-27458
18888,0.0,0.0,0.0,3206,75552,48090,-27462
18889,0.0,0.0,0.0,3206,75556,48090,-27466
18890,0.0,0.0,0.0,3206,75560,48090,-27470
18891,0.0,0.0,0.0,3206,75564,48090,-27474
18892,0.0,0.0,0.0,3206,75568,48090,-27478
18893,0.0,0.0,0.0,3206,75572,48090,-27482
18894,0.0,0.0,0.0,3206,75576,48090,-27486
18895,0.0,0.0,0.3333333333333333,3206,75580,48090,-27490
18896,0.0,0.0,0.0,3206,75584,48090,-27494
18897,1.0,1.0,1.0,3207,75588,48105,-27483
18898,0.0,0.0,0.0,3207,75592,48105,-27487
18899,0.0,0.0,0.0,3207,75596,48105,-27491
18900,0.0,0.0,0.0,3207,75600,48105,-27495
18901,0.0,0.0,0.0,3207,75604,48105,-27499
18902,0.0,0.0,0.0,3207,75608,48105,-27503
18903,0.0,0.0,0.0,3207,75612,48105,-27507
18904,0.0,0.0,0.0,3207,75616,48105,-27511
18905,0.0,0.0,0.0,3207,75620,48105,-27515
18906,0.0,0.0,0.0,3207,75624,48105,-27519
18907,0.0,0.0,0.0,3207,75628,48105,-27523
18908,0.0,0.0,0.0,3207,75632,48105,-27527
18909,0.0,0.0,0.0,3207,75636,48105,-27531
18910,0.0,0.0,0.0,3207,75640,48105,-27535
18911,0.0,0.0,0.0,3207,75644,48105,-27539
18912,0.0,0.0,0.0,3207,75648,48105,-27543
18913,0.0,0.0,0.0,3207,75652,48105,-27547
18914,0.0,0.0,0.0,3207,75656,48105,-27551
18915,0.0,0.0,0.0,3207,75660,48105,-27555
18916,0.0,0.0,0.0,3207,75664,48105,-27559
18917,0.0,0.0,0.0,3207,75668,48105,-27563
18918,0.0,0.0,0.0,3207,75672,48105,-27567
18919,0.0,0.0,0.0,3207,75676,48105,-27571
18920,0.0,0.0,0.0,3207,75680,48105,-27575
18921,0.0,0.0,0.0,3207,75684,48105,-27579
18922,1.0,0.0,0.3333333333333333,3208,75688,48120,-27568
18923,0.0,0.0,0.0,3208,75692,48120,-27572
18924,1.0,1.0,1.0,3209,75696,48135,-27561
18925,0.0,0.0,0.0,3209,75700,48135,-27565
18926,0.0,0.0,0.0,3209,75704,48135,-27569
18927,0.0,0.0,0.0,3209,75708,48135,-27573
18928,0.0,0.0,0.0,3209,75712,48135,-27577
18929,0.0,0.0,0.0,3209,75716,48135,-27581
18930,1.0,1.0,1.0,3210,75720,48150,-27570
18931,0.0,0.0,0.0,3210,75724,48150,-27574
18932,0.0,0.0,0.0,3210,75728,48150,-27578
18933,1.0,1.0,0.6,3211,75732,48165,-27567
18934,0.0,0.0,0.0,3211,75736,48165,-27571
18935,0.0,0.0,0.0,3211,75740,48165,-27575
18936,0.0,0.0,0.0,3211,75744,48165,-27579
18937,0.0,0.0,0.0,3211,75748,48165,-27583
18938,0.0,0.0,0.0,3211,75752,48165,-27587
18939,0.0,0.0,0.0,3211,75756,48165,-27591
18940,0.0,0.0,0.0,3211,75760,48165,-27595
18941,0.0,0.0,0.0,3211,75764,48165,-27599
18942,0.0,0.0,0.0,3211,75768,48165,-27603
18943,0.0,0.0,0.0,3211,75772,48165,-27607
18944,0.0,0.0,0.0,3211,75776,48165,-27611
18945,0.0,0.0,0.0,3211,75780,48165,-27615
18946,0.0,0.0,0.0,3211,75784,48165,-27619
18947,0.0,0.0,0.0,3211,75788,48165,-27623
18948,0.0,0.0,0.0,3211,75792,48165,-27627
18949,0.0,0.0,0.0,3211,75796,48165,-27631
18950,1.0,1.0,1.0,3212,75800,48180,-27620
18951,0.0,0.0,0.0,3212,75804,48180,-27624
18952,0.0,0.0,0.0,3212,75808,48180,-27628
18953,0.0,0.0,0.0,3212,75812,48180,-27632
18954,0.0,0.0,0.0,3212,75816,48180,-27636
18955,0.0,0.0,0.0,3212,75820,48180,-27640
18956,1.0,1.0,1.0,3213,75824,48195,-27629
18957,0.0,0.0,0.0,3213,75828,48195,-27633
18958,0.0,0.0,0.0,3213,75832,48195,-27637
18959,1.0,1.0,1.0,3214,75836,48210,-27626
18960,0.0,0.0,0.0,3214,75840,48210,-27630
18961,1.0,1.0,1.0,3215,75844,48225,-27619
18962,1.0,1.0,1.0,3216,75848,48240,-27608
18963,1.0,1.0,1.0,3217,75852,48255,-27597
18964,0.0,0.0,0.0,3217,75856,48255,-27601
18965,0.0,0.0,0.0,3217,75860,48255,-27605
18966,0.0,0.0,0.0,3217,75864,48255,-27609
18967,0.0,0.0,0.0,3217,75868,48255,-27613
18968,0.0,0.0,0.0,3217,75872,48255,-27617
18969,0.0,0.0,0.0,3217,75876,48255,-27621
18970,0.0,0.0,0.0,3217,75880,48255,-27625
18971,1.0,1.0,1.0,3218,75884,48270,-27614
18972,1.0,0.0,0.5,3219,75888,48285,-27603
18973,0.0,0.0,0.0,3219,75892,48285,-27607
18974,1.0,0.0,0.3333333333333333,3220,75896,48300,-27596
18975,0.0,0.0,0.0,3220,75900,48300,-27600
18976,1.0,1.0,1.0,3221,75904,48315,-27589
18977,0.0,0.0,0.0,3221,75908,48315,-27593
18978,0.0,0.0,0.0,3221,75912,48315,-27597
18979,1.0,1.0,1.0,3222,75916,48330,-27586
18980,0.0,1.0,0.6666666666666666,3222,75920,48330,-27590
18981,0.0,0.0,0.0,3222,75924,48330,-27594
18982,1.0,1.0,1.0,3223,75928,48345,-27583
18983,0.0,0.0,0.0,3223,75932,48345,-27587
18984,0.0,0.0,0.0,3223,75936,48345,-27591
18985,0.0,0.0,0.0,3223,75940,48345,-27595
18986,0.0,0.0,0.0,3223,75944,48345,-27599
18987,0.0,0.0,0.0,3223,75948,48345,-27603
18988,0.0,0.0,0.0,3223,75952,48345,-27607
18989,1.0,1.0,1.0,3224,75956,48360,-27596
18990,1.0,1.0,1.0,3225,75960,48375,-27585
18991,0.0,0.0,0.0,3225,75964,48375,-27589
18992,0.0,0.0,0.0,3225,75968,48375,-27593
18993,0.0,0.0,0.0,3225,75972,48375,-27597
18994,0.0,0.0,0.0,3225,75976,48375,-27601
18995,0.0,0.0,0.0,3225,75980,48375,-27605
18996,0.0,0.0,0.0,3225,75984,48375,-27609
18997,1.0,1.0,1.0,3226,75988,48390,-27598
18998,0.0,0.0,0.0,3226,75992,48390,-27602
18999,1.0,1.0,0.6666666666666666,3227,75996,48405,-27591
19000,0.0,0.0,0.0,3227,76000,48405,-27595
19001,0.0,0.0,0.0,3227,76004,48405,-27599
19002,0.0,0.0,0.0,3227,76008,48405,-27603
19003,0.0,0.0,0.0,3227,76012,48405,-27607
19004,0.0,0.0,0.0,3227,76016,48405,-27611
19005,0.0,0.0,0.0,3227,76020,48405,-27615
19006,0.0,0.0,0.0,3227,76024,48405,-27619
19007,0.0,0.0,0.0,3227,76028,48405,-27623
19008,0.0,0.0,0.0,3227,76032,48405,-27627
19009,0.0,0.0,0.0,3227,76036,48405,-27631
19010,1.0,1.0,1.0,3228,76040,48420,-27620
19011,0.0,0.0,0.0,3228,76044,48420,-27624
19012,0.0,0.0,0.0,3228,76048,48420,-27628
19013,0.0,0.0,0.0,3228,76052,48420,-27632
19014,1.0,1.0,0.75,3229,76056,48435,-27621
19015,0.0,0.0,0.0,3229,76060,48435,-27625
19016,0.0,0.0,0.0,3229,76064,48435,-27629
19017,0.0,1.0,0.6666666666666666,3229,76068,48435,-27633
19018,0.0,0.0,0.0,3229,76072,48435,-27637
19019,0.0,0.0,0.0,3229,76076,48435,-27641
19020,1.0,1.0,1.0,3230,76080,48450,-27630
19021,0.0,0.0,0.0,3230,76084,48450,-27634
19022,0.0,0.0,0.0,3230,76088,48450,-27638
19023,0.0,0.0,0.0,3230,76092,48450,-27642
19024,0.0,0.0,0.0,3230,76096,48450,-27646
19025,0.0,0.0,0.0,3230,76100,48450,-27650
19026,0.0,0.0,0.0,3230,76104,48450,-27654
19027,1.0,1.0,1.0,3231,76108,48465,-27643
19028,0.0,0.0,0.3333333333333333,3231,76112,48465,-27647
19029,0.0,0.0,0.0,3231,76116,48465,-27651
19030,0.0,0.0,0.0,3231,76120,48465,-27655
19031,0.0,0.0,0.0,3231,76124,48465,-27659
19032,0.0,0.0,0.0,3231,76128,48465,-27663
19033,0.0,0.0,0.0,3231,76132,48465,-27667
19034,0.0,0.0,0.0,3231,76136,48465,-27671
19035,0.0,0.0,0.0,3231,76140,48465,-27675
19036,0.0,0.0,0.0,3231,76144,48465,-27679
19037,0.0,0.0,0.0,3231,76148,48465,-27683
19038,0.0,0.0,0.0,3231,76152,48465,-27687
19039,0.0,0.0,0.0,3231,76156,48465,-27691
19040,0.0,0.0,0.0,3231,76160,48465,-27695
19041,0.0,0.0,0.0,3231,76164,48465,-27699
19042,0.0,0.0,0.0,3231,76168,48465,-27703
19043,0.0,0.0,0.0,3231,76172,48465,-27707
19044,0.0,0.0,0.0,3231,76176,48465,-27711
19045,0.0,0.0,0.0,3231,76180,48465,-27715
19046,0.0,0.0,0.0,3231,76184,48465,-27719
19047,0.0,0.0,0.0,3231,76188,48465,-27723
19048,0.0,0.0,0.0,3231,76192,48465,-27727
19049,0.0,0.0,0.0,3231,76196,48465,-27731
19050,0.0,0.0,0.0,3231,76200,48465,-27735
19051,0.0,0.0,0.0,3231,76204,48465,-27739
19052,0.0,0.0,0.0,3231,76208,48465,-27743
19053,0.0,0.0,0.0,3231,76212,48465,-27747
19054,0.0,0.0,0.0,3231,76216,48465,-27751
19055,1.0,1.0,1.0,3232,76220,48480,-27740
19056,1.0,1.0,0.6666666666666666,3233,76224,48495,-27729
19057,0.0,0.0,0.0,3233,76228,48495,-27733
19058,0.0,0.0,0.0,3233,76232,48495,-27737
19059,1.0,0.0,0.3333333333333333,3234,76236,48510,-27726
19060,0.0,0.0,0.0,3234,76240,48510,-27730
19061,0.0,0.0,0.0,3234,76244,48510,-27734
19062,0.0,0.0,0.0,3234,76248,48510,-27738
19063,0.0,0.0,0.0,3234,76252,48510,-27742
19064,0.0,0.0,0.0,3234,76256,48510,-27746
19065,0.0,0.0,0.0,3234,76260,48510,-27750
19066,0.0,0.0,0.0,3234,76264,48510,-27754
19067,0.0,0.0,0.0,3234,76268,48510,-27758
19068,0.0,0.0,0.0,3234,76272,48510,-27762
19069,0.0,0.0,0.0,3234,76276,48510,-27766
19070,0.0,0.0,0.0,3234,76280,48510,-27770
19071,0.0,0.0,0.0,3234,76284,48510,-27774
19072,0.0,0.0,0.0,3234,76288,48510,-27778
19073,0.0,0.0,0.0,3234,76292,48510,-27782
19074,1.0,1.0,1.0,3235,76296,48525,-27771
19075,0.0,0.0,0.0,3235,76300,48525,-27775
19076,0.0,0.0,0.0,3235,76304,48525,-27779
19077,0.0,0.0,0.0,3235,76308,48525,-27783
19078,0.0,0.0,0.0,3235,76312,48525,-27787
19079,0.0,0.0,0.0,3235,76316,48525,-27791
19080,0.0,0.0,0.0,3235,76320,48525,-27795
19081,0.0,0.0,0.0,3235,76324,48525,-27799
19082,0.0,0.0,0.0,3235,76328,48525,-27803
19083,1.0,1.0,1.0,3236,76332,48540,-27792
19084,0.0,0.0,0.0,3236,76336,48540,-27796
19085,0.0,0.0,0.0,3236,76340,48540,-27800
19086,0.0,0.0,0.0,3236,76344,48540,-27804
19087,0.0,0.0,0.0,3236,76348,48540,-27808
19088,1.0,1.0,0.6666666666666666,3237,76352,48555,-27797
19089,0.0,0.0,0.0,3237,76356,48555,-27801
19090,0.0,0.0,0.0,3237,76360,48555,-27805
19091,0.0,0.0,0.0,3237,76364,48555,-27809
19092,0.0,0.0,0.0,3237,76368,48555,-27813
19093,1.0,1.0,1.0,3238,76372,48570,-27802
19094,0.0,0.0,0.0,3238,76376,48570,-27806
19095,0.0,0.0,0.0,3238,76380,48570,-27810
19096,0.0,0.0,0.0,3238,76384,48570,-27814
19097,0.0,0.0,0.0,3238,76388,48570,-27818
19098,0.0,0.0,0.0,3238,76392,48570,-27822
19099,0.0,0.0,0.0,3238,76396,48570,-27826
19100,0.0,0.0,0.0,3238,76400,48570,-27830
19101,0.0,0.0,0.0,3238,76404,48570,-27834
19102,0.0,0.0,0.2,3238,76408,48570,-27838
19103,0.0,0.0,0.0,3238,76412,48570,-27842
19104,0.0,0.0,0.0,3238,76416,48570,-27846
19105,0.0,0.0,0.0,3238,76420,48570,-27850
19106,1.0,1.0,1.0,3239,76424,48585,-27839
19107,0.0,0.0,0.0,3239,76428,48585,-27843
19108,0.0,0.0,0.0,3239,76432,48585,-27847
19109,0.0,0.0,0.0,3239,76436,48585,-27851
19110,0.0,0.0,0.0,3239,76440,48585,-27855
19111,0.0,0.0,0.0,3239,76444,48585,-27859
19112,0.0,0.0,0.0,3239,76448,48585,-27863
19113,1.0,1.0,0.6,3240,76452,48600,-27852
19114,0.0,0.0,0.0,3240,76456,48600,-27856
19115,0.0,0.0,0.0,3240,76460,48600,-27860
19116,0.0,0.0,0.0,3240,76464,48600,-27864
19117,0.0,0.0,0.0,3240,76468,48600,-27868
19118,0.0,0.0,0.0,3240,76472,48600,-27872
19119,0.0,0.0,0.0,3240,76476,48600,-27876
19120,0.0,0.0,0.0,3240,76480,48600,-27880
19121,0.0,0.0,0.0,3240,76484,48600,-27884
19122,0.0,0.0,0.0,3240,76488,48600,-27888
19123,0.0,0.0,0.0,3240,76492,48600,-27892
19124,0.0,0.0,0.0,3240,76496,48600,-27896
19125,0.0,0.0,0.0,3240,76500,48600,-27900
19126,0.0,0.0,0.0,3240,76504,48600,-27904
19127,0.0,0.0,0.0,3240,76508,48600,-27908
19128,0.0,0.0,0.0,3240,76512,48600,-27912
19129,0.0,0.0,0.0,3240,76516,48600,-27916
19130,0.0,0.0,0.0,3240,76520,48600,-27920
19131,0.0,0.0,0.0,3240,76524,48600,-27924
19132,0.0,0.0,0.0,3240,76528,48600,-27928
19133,0.0,0.0,0.0,3240,76532,48600,-27932
19134,0.0,0.0,0.0,3240,76536,48600,-27936
19135,0.0,0.0,0.0,3240,76540,48600,-27940
19136,0.0,0.0,0.0,3240,76544,48600,-27944
19137,1.0,1.0,0.8,3241,76548,48615,-27933
19138,0.0,0.0,0.0,3241,76552,48615,-27937
19139,0.0,0.0,0.0,3241,76556,48615,-27941
19140,0.0,0.0,0.0,3241,76560,48615,-27945
19141,0.0,0.0,0.0,3241,76564,48615,-27949
19142,0.0,0.0,0.0,3241,76568,48615,-27953
19143,0.0,0.0,0.0,3241,76572,48615,-27957
19144,0.0,0.0,0.0,3241,76576,48615,-27961
19145,0.0,0.0,0.0,3241,76580,48615,-27965
19146,0.0,0.0,0.0,3241,76584,48615,-27969
19147,0.0,0.0,0.0,3241,76588,48615,-27973
19148,0.0,0.0,0.0,3241,76592,48615,-27977
19149,1.0,1.0,1.0,3242,76596,48630,-27966
19150,0.0,0.0,0.0,3242,76600,48630,-27970
19151,0.0,0.0,0.0,3242,76604,48630,-27974
19152,0.0,0.0,0.0,3242,76608,48630,-27978
19153,0.0,0.0,0.0,3242,76612,48630,-27982
19154,0.0,0.0,0.0,3242,76616,48630,-27986
19155,1.0,1.0,1.0,3243,76620,48645,-27975
19156,0.0,0.0,0.0,3243,76624,48645,-27979
19157,0.0,0.0,0.0,3243,76628,48645,-27983
19158,0.0,0.0,0.0,3243,76632,48645,-27987
19159,0.0,0.0,0.0,3243,76636,48645,-27991
19160,0.0,0.0,0.0,3243,76640,48645,-27995
19161,1.0,1.0,1.0,3244,76644,48660,-27984
19162,0.0,0.0,0.3333333333333333,3244,76648,48660,-27988
19163,1.0,1.0,1.0,3245,76652,48675,-27977
19164,0.0,0.0,0.0,3245,76656,48675,-27981
19165,0.0,0.0,0.0,3245,76660,48675,-27985
19166,0.0,0.0,0.0,3245,76664,48675,-27989
19167,0.0,0.0,0.0,3245,76668,48675,-27993
19168,0.0,0.0,0.0,3245,76672,48675,-27997
19169,0.0,0.0,0.0,3245,76676,48675,-28001
19170,0.0,0.0,0.0,3245,76680,48675,-28005
19171,1.0,0.0,0.5,3246,76684,48690,-27994
19172,0.0,0.0,0.0,3246,76688,48690,-27998
19173,0.0,0.0,0.0,3246,76692,48690,-28002
19174,0.0,0.0,0.0,3246,76696,48690,-28006
19175,0.0,0.0,0.0,3246,76700,48690,-28010
19176,0.0,0.0,0.0,3246,76704,48690,-28014
19177,0.0,0.0,0.0,3246,76708,48690,-28018
19178,0.0,0.0,0.0,3246,76712,48690,-28022
19179,0.0,0.0,0.0,3246,76716,48690,-28026
19180,1.0,1.0,1.0,3247,76720,48705,-28015
19181,1.0,0.0,0.5,3248,76724,48720,-28004
19182,0.0,0.0,0.0,3248,76728,48720,-28008
19183,0.0,0.0,0.0,3248,76732,48720,-28012
19184,0.0,0.0,0.0,3248,76736,48720,-28016
19185,0.0,0.0,0.0,3248,76740,48720,-28020
19186,1.0,1.0,1.0,3249,76744,48735,-28009
19187,1.0,1.0,1.0,3250,76748,48750,-27998
19188,0.0,0.0,0.0,3250,76752,48750,-28002
19189,0.0,0.0,0.0,3250,76756,48750,-28006
19190,0.0,0.0,0.0,3250,76760,48750,-28010
19191,0.0,0.0,0.0,3250,76764,48750,-28014
19192,0.0,0.0,0.0,3250,76768,48750,-28018
19193,0.0,0.0,0.0,3250,76772,48750,-28022
19194,0.0,0.0,0.0,3250,76776,48750,-28026
19195,0.0,0.0,0.0,3250,76780,48750,-28030
19196,0.0,0.0,0.0,3250,76784,48750,-28034
19197,0.0,0.0,0.0,3250,76788,48750,-28038
19198,0.0,0.0,0.0,3250,76792,48750,-28042
19199,0.0,0.0,0.0,3250,76796,48750,-28046
19200,0.0,0.0,0.0,3250,76800,48750,-28050
19201,0.0,0.0,0.0,3250,76804,48750,-28054
19202,0.0,0.0,0.0,3250,76808,48750,-28058
19203,0.0,0.0,0.0,3250,76812,48750,-28062
19204,0.0,0.0,0.0,3250,76816,48750,-28066
19205,0.0,0.0,0.0,3250,76820,48750,-28070
19206,0.0,0.0,0.3333333333333333,3250,76824,48750,-28074
19207,0.0,0.0,0.0,3250,76828,48750,-28078
19208,0.0,0.0,0.0,3250,76832,48750,-28082
19209,0.0,0.0,0.0,3250,76836,48750,-28086
19210,0.0,0.0,0.0,3250,76840,48750,-28090
19211,0.0,0.0,0.0,3250,76844,48750,-28094
19212,0.0,0.0,0.0,3250,76848,48750,-28098
19213,0.0,0.0,0.0,3250,76852,48750,-28102
19214,0.0,0.0,0.0,3250,76856,48750,-28106
19215,0.0,0.0,0.0,3250,76860,48750,-28110
19216,0.0,0.0,0.0,3250,76864,48750,-28114
19217,0.0,1.0,0.75,3250,76868,48750,-28118
19218,0.0,0.0,0.0,3250,76872,48750,-28122
19219,0.0,0.0,0.0,3250,76876,48750,-28126
19220,0.0,0.0,0.0,3250,76880,48750,-28130
19221,0.0,0.0,0.0,3250,76884,48750,-28134
19222,1.0,1.0,1.0,3251,76888,48765,-28123
19223,0.0,0.0,0.0,3251,76892,48765,-28127
19224,0.0,0.0,0.0,3251,76896,48765,-28131
19225,0.0,0.0,0.0,3251,76900,48765,-28135
19226,0.0,0.0,0.0,3251,76904,48765,-28139
19227,0.0,0.0,0.0,3251,76908,48765,-28143
19228,0.0,0.0,0.0,3251,76912,48765,-28147
19229,0.0,0.0,0.0,3251,76916,48765,-28151
19230,0.0,0.0,0.0,3251,76920,48765,-28155
19231,0.0,0.0,0.0,3251,76924,48765,-28159
19232,0.0,0.0,0.0,3251,76928,48765,-28163
19233,1.0,1.0,1.0,3252,76932,48780,-28152
19234,0.0,0.0,0.0,3252,76936,48780,-28156
19235,0.0,0.0,0.0,3252,76940,48780,-28160
19236,1.0,1.0,1.0,3253,76944,48795,-28149
19237,0.0,0.0,0.0,3253,76948,48795,-28153
19238,0.0,0.0,0.0,3253,76952,48795,-28157
19239,0.0,0.0,0.0,3253,76956,48795,-28161
19240,1.0,1.0,1.0,3254,76960,48810,-28150
19241,0.0,0.0,0.0,3254,76964,48810,-28154
19242,1.0,1.0,0.75,3255,76968,48825,-28143
19243,0.0,0.0,0.0,3255,76972,48825,-28147
19244,0.0,0.0,0.0,3255,76976,48825,-28151
19245,0.0,0.0,0.0,3255,76980,48825,-28155
19246,0.0,0.0,0.0,3255,76984,48825,-28159
19247,0.0,0.0,0.0,3255,76988,48825,-28163
19248,0.0,0.0,0.0,3255,76992,48825,-28167
19249,0.0,0.0,0.0,3255,76996,48825,-28171
19250,1.0,0.0,0.4,3256,77000,48840,-28160
19251,1.0,1.0,1.0,3257,77004,48855,-28149
19252,0.0,0.0,0.0,3257,77008,48855,-28153
19253,0.0,0.0,0.25,3257,77012,48855,-28157
19254,0.0,0.0,0.0,3257,77016,48855,-28161
19255,0.0,0.0,0.0,3257,77020,48855,-28165
19256,1.0,1.0,1.0,3258,77024,48870,-28154
19257,0.0,0.0,0.0,3258,77028,48870,-28158
19258,0.0,0.0,0.0,3258,77032,48870,-28162
19259,0.0,0.0,0.0,3258,77036,48870,-28166
19260,0.0,0.0,0.4,3258,77040,48870,-28170
19261,1.0,1.0,1.0,3259,77044,48885,-28159
19262,0.0,0.0,0.0,3259,77048,48885,-28163
19263,0.0,0.0,0.0,3259,77052,48885,-28167
19264,0.0,0.0,0.0,3259,77056,48885,-28171
19265,1.0,1.0,1.0,3260,77060,48900,-28160
19266,0.0,0.0,0.0,3260,77064,48900,-28164
19267,0.0,0.0,0.0,3260,77068,48900,-28168
19268,0.0,0.0,0.5,3260,77072,48900,-28172
19269,0.0,0.0,0.0,3260,77076,48900,-28176
19270,0.0,0.0,0.0,3260,77080,48900,-28180
19271,0.0,0.0,0.0,3260,77084,48900,-28184
19272,1.0,1.0,0.75,3261,77088,48915,-28173
19273,0.0,0.0,0.3333333333333333,3261,77092,48915,-28177
19274,0.0,0.0,0.0,3261,77096,48915,-28181
19275,0.0,0.0,0.0,3261,77100,48915,-28185
19276,0.0,0.0,0.0,3261,77104,48915,-28189
19277,0.0,0.0,0.0,3261,77108,48915,-28193
19278,0.0,0.0,0.0,3261,77112,48915,-28197
19279,0.0,0.0,0.0,3261,77116,48915,-28201
19280,0.0,0.0,0.0,3261,77120,48915,-28205
19281,0.0,0.0,0.0,3261,77124,48915,-28209
19282,0.0,0.0,0.0,3261,77128,48915,-28213
19283,0.0,0.0,0.0,3261,77132,48915,-28217
19284,0.0,0.0,0.0,3261,77136,48915,-28221
19285,0.0,1.0,0.6,3261,77140,48915,-28225
19286,0.0,0.0,0.3333333333333333,3261,77144,48915,-28229
19287,0.0,0.0,0.0,3261,77148,48915,-28233
19288,0.0,0.0,0.0,3261,77152,48915,-28237
19289,0.0,0.0,0.0,3261,77156,48915,-28241
19290,0.0,0.0,0.0,3261,77160,48915,-28245
19291,0.0,0.0,0.0,3261,77164,48915,-28249
19292,1.0,1.0,1.0,3262,77168,48930,-28238
19293,0.0,0.0,0.0,3262,77172,48930,-28242
19294,0.0,0.0,0.0,3262,77176,48930,-28246
19295,0.0,0.0,0.0,3262,77180,48930,-28250
19296,0.0,0.0,0.0,3262,77184,48930,-28254
19297,0.0,0.0,0.0,3262,77188,48930,-28258
19298,0.0,0.0,0.0,3262,77192,48930,-28262
19299,0.0,0.0,0.0,3262,77196,48930,-28266
19300,0.0,0.0,0.0,3262,77200,48930,-28270
19301,0.0,0.0,0.0,3262,77204,48930,-28274
19302,0.0,0.0,0.0,3262,77208,48930,-28278
19303,0.0,0.0,0.0,3262,77212,48930,-28282
19304,0.0,0.0,0.0,3262,77216,48930,-28286
19305,0.0,0.0,0.0,3262,77220,48930,-28290
19306,0.0,0.0,0.0,3262,77224,48930,-28294
19307,0.0,0.0,0.0,3262,77228,48930,-28298
19308,0.0,0.0,0.0,3262,77232,48930,-28302
19309,0.0,0.0,0.0,3262,77236,48930,-28306
19310,0.0,0.0,0.0,3262,77240,48930,-28310
19311,0.0,0.0,0.0,3262,77244,48930,-28314
19312,0.0,0.0,0.2,3262,77248,48930,-28318
19313,0.0,0.0,0.0,3262,77252,48930,-28322
19314,0.0,0.0,0.2,3262,77256,48930,-28326
19315,0.0,0.0,0.0,3262,77260,48930,-28330
19316,0.0,0.0,0.0,3262,77264,48930,-28334
19317,0.0,0.0,0.0,3262,77268,48930,-28338
19318,0.0,0.0,0.0,3262,77272,48930,-28342
19319,1.0,1.0,1.0,3263,77276,48945,-28331
19320,0.0,0.0,0.0,3263,77280,48945,-28335
19321,0.0,0.0,0.0,3263,77284,48945,-28339
19322,0.0,0.0,0.0,3263,77288,48945,-28343
19323,0.0,0.0,0.0,3263,77292,48945,-28347
19324,0.0,0.0,0.0,3263,77296,48945,-28351
19325,1.0,1.0,1.0,3264,77300,48960,-28340
19326,0.0,0.0,0.0,3264,77304,48960,-28344
19327,0.0,0.0,0.0,3264,77308,48960,-28348
19328,0.0,0.0,0.0,3264,77312,48960,-28352
19329,0.0,0.0,0.0,3264,77316,48960,-28356
19330,0.0,0.0,0.0,3264,77320,48960,-28360
19331,0.0,0.0,0.0,3264,77324,48960,-28364
19332,0.0,0.0,0.0,3264,77328,48960,-28368
19333,0.0,0.0,0.3333333333333333,3264,77332,48960,-28372
19334,0.0,0.0,0.0,3264,77336,48960,-28376
19335,0.0,0.0,0.0,3264,77340,48960,-28380
19336,0.0,0.0,0.0,3264,77344,48960,-28384
19337,0.0,0.0,0.0,3264,77348,48960,-28388
19338,0.0,0.0,0.0,3264,77352,48960,-28392
19339,1.0,1.0,1.0,3265,77356,48975,-28381
19340,0.0,0.0,0.0,3265,77360,48975,-28385
19341,0.0,0.0,0.0,3265,77364,48975,-28389
19342,0.0,0.0,0.0,3265,77368,48975,-28393
19343,0.0,0.0,0.0,3265,77372,48975,-28397
19344,0.0,0.0,0.0,3265,77376,48975,-28401
19345,0.0,0.0,0.0,3265,77380,48975,-28405
19346,0.0,0.0,0.0,3265,77384,48975,-28409
19347,1.0,0.0,0.3333333333333333,3266,77388,48990,-28398
19348,0.0,0.0,0.0,3266,77392,48990,-28402
19349,0.0,0.0,0.0,3266,77396,48990,-28406
19350,0.0,0.0,0.0,3266,77400,48990,-28410
19351,0.0,0.0,0.0,3266,77404,48990,-28414
19352,0.0,0.0,0.0,3266,77408,48990,-28418
19353,0.0,0.0,0.0,3266,77412,48990,-28422
19354,0.0,0.0,0.0,3266,77416,48990,-28426
19355,0.0,0.0,0.0,3266,77420,48990,-28430
19356,0.0,0.0,0.0,3266,77424,48990,-28434
19357,0.0,0.0,0.3333333333333333,3266,77428,48990,-28438
19358,0.0,0.0,0.0,3266,77432,48990,-28442
19359,0.0,0.0,0.0,3266,77436,48990,-28446
19360,0.0,0.0,0.0,3266,77440,48990,-28450
19361,0.0,0.0,0.0,3266,77444,48990,-28454
19362,0.0,0.0,0.0,3266,77448,48990,-28458
19363,0.0,0.0,0.0,3266,77452,48990,-28462
19364,0.0,0.0,0.0,3266,77456,48990,-28466
19365,0.0,0.0,0.0,3266,77460,48990,-28470
19366,0.0,0.0,0.0,3266,77464,48990,-28474
19367,0.0,0.0,0.0,3266,77468,48990,-28478
19368,0.0,0.0,0.0,3266,77472,48990,-28482
19369,0.0,0.0,0.0,3266,77476,48990,-28486
19370,0.0,0.0,0.0,3266,77480,48990,-28490
19371,0.0,0.0,0.0,3266,77484,48990,-28494
19372,0.0,0.0,0.0,3266,77488,48990,-28498
19373,1.0,1.0,1.0,3267,77492,49005,-28487
19374,0.0,0.0,0.0,3267,77496,49005,-28491
19375,0.0,0.0,0.0,3267,77500,49005,-28495
19376,0.0,0.0,0.0,3267,77504,49005,-28499
19377,0.0,0.0,0.0,3267,77508,49005,-28503
19378,1.0,0.0,0.25,3268,77512,49020,-28492
19379,0.0,0.0,0.0,3268,77516,49020,-28496
19380,0.0,0.0,0.0,3268,77520,49020,-28500
19381,0.0,0.0,0.0,3268,77524,49020,-28504
19382,0.0,0.0,0.0,3268,77528,49020,-28508
19383,1.0,1.0,0.6666666666666666,3269,77532,49035,-28497
19384,0.0,0.0,0.0,3269,77536,49035,-28501
19385,0.0,0.0,0.0,3269,77540,49035,-28505
19386,0.0,0.0,0.0,3269,77544,49035,-28509
19387,0.0,0.0,0.0,3269,77548,49035,-28513
19388,1.0,1.0,1.0,3270,77552,49050,-28502
19389,0.0,0.0,0.0,3270,77556,49050,-28506
19390,0.0,0.0,0.0,3270,77560,49050,-28510
19391,0.0,0.0,0.0,3270,77564,49050,-28514
19392,1.0,0.0,0.3333333333333333,3271,77568,49065,-28503
19393,0.0,0.0,0.0,3271,77572,49065,-28507
19394,0.0,0.0,0.0,3271,77576,49065,-28511
19395,0.0,0.0,0.0,3271,77580,49065,-28515
19396,0.0,0.0,0.0,3271,77584,49065,-28519
19397,0.0,0.0,0.0,3271,77588,49065,-28523
19398,1.0,1.0,1.0,3272,77592,49080,-28512
19399,0.0,0.0,0.0,3272,77596,49080,-28516
19400,0.0,0.0,0.0,3272,77600,49080,-28520
19401,0.0,0.0,0.0,3272,77604,49080,-28524
19402,0.0,0.0,0.0,3272,77608,49080,-28528
19403,0.0,0.0,0.0,3272,77612,49080,-28532
19404,0.0,0.0,0.0,3272,77616,49080,-28536
19405,0.0,0.0,0.0,3272,77620,49080,-28540
19406,0.0,0.0,0.0,3272,77624,49080,-28544
19407,0.0,0.0,0.0,3272,77628,49080,-28548
19408,0.0,0.0,0.0,3272,77632,49080,-28552
19409,1.0,1.0,1.0,3273,77636,49095,-28541
19410,0.0,0.0,0.0,3273,77640,49095,-28545
19411,0.0,0.0,0.0,3273,77644,49095,-28549
19412,0.0,0.0,0.0,3273,77648,49095,-28553
19413,0.0,0.0,0.0,3273,77652,49095,-28557
19414,0.0,0.0,0.0,3273,77656,49095,-28561
19415,0.0,0.0,0.0,3273,77660,49095,-28565
19416,1.0,1.0,1.0,3274,77664,49110,-28554
19417,0.0,0.0,0.0,3274,77668,49110,-28558
19418,0.0,0.0,0.0,3274,77672,49110,-28562
19419,0.0,0.0,0.0,3274,77676,49110,-28566
19420,0.0,0.0,0.0,3274,77680,49110,-28570
19421,1.0,1.0,1.0,3275,77684,49125,-28559
19422,0.0,0.0,0.0,3275,77688,49125,-28563
19423,1.0,1.0,1.0,3276,77692,49140,-28552
19424,0.0,0.0,0.0,3276,77696,49140,-28556
19425,0.0,0.0,0.5,3276,77700,49140,-28560
19426,0.0,0.0,0.0,3276,77704,49140,-28564
19427,0.0,0.0,0.0,3276,77708,49140,-28568
19428,0.0,0.0,0.0,3276,77712,49140,-28572
19429,0.0,0.0,0.3333333333333333,3276,77716,49140,-28576
19430,0.0,0.0,0.0,3276,77720,49140,-28580
19431,0.0,0.0,0.0,3276,77724,49140,-28584
19432,0.0,0.0,0.0,3276,77728,49140,-28588
19433,1.0,1.0,1.0,3277,77732,49155,-28577
19434,0.0,0.0,0.0,3277,77736,49155,-28581
19435,0.0,0.0,0.0,3277,77740,49155,-28585
19436,0.0,0.0,0.0,3277,77744,49155,-28589
19437,0.0,0.0,0.0,3277,77748,49155,-28593
19438,1.0,1.0,1.0,3278,77752,49170,-28582
19439,0.0,0.0,0.0,3278,77756,49170,-28586
19440,0.0,0.0,0.0,3278,77760,49170,-28590
19441,0.0,0.0,0.0,3278,77764,49170,-28594
19442,0.0,0.0,0.0,3278,77768,49170,-28598
19443,1.0,1.0,0.6666666666666666,3279,77772,49185,-28587
19444,0.0,0.0,0.0,3279,77776,49185,-28591
19445,0.0,0.0,0.0,3279,77780,49185,-28595
19446,0.0,0.0,0.0,3279,77784,49185,-28599
19447,0.0,0.0,0.0,3279,77788,49185,-28603
19448,0.0,0.0,0.0,3279,77792,49185,-28607
19449,0.0,0.0,0.0,3279,77796,49185,-28611
19450,0.0,0.0,0.0,3279,77800,49185,-28615
19451,0.0,0.0,0.0,3279,77804,49185,-28619
19452,0.0,0.0,0.0,3279,77808,49185,-28623
19453,0.0,0.0,0.0,3279,77812,49185,-28627
19454,0.0,0.0,0.0,3279,77816,49185,-28631
19455,0.0,0.0,0.0,3279,77820,49185,-28635
19456,0.0,0.0,0.0,3279,77824,49185,-28639
19457,0.0,0.0,0.0,3279,77828,49185,-28643
19458,0.0,0.0,0.0,3279,77832,49185,-28647
19459,0.0,0.0,0.0,3279,77836,49185,-28651
19460,0.0,0.0,0.0,3279,77840,49185,-28655
19461,0.0,0.0,0.0,3279,77844,49185,-28659
19462,0.0,0.0,0.0,3279,77848,49185,-28663
19463,0.0,0.0,0.0,3279,77852,49185,-28667
19464,0.0,0.0,0.0,3279,77856,49185,-28671
19465,0.0,0.0,0.0,3279,77860,49185,-28675
19466,0.0,0.0,0.0,3279,77864,49185,-28679
19467,0.0,0.0,0.0,3279,77868,49185,-28683
19468,0.0,0.0,0.0,3279,77872,49185,-28687
19469,0.0,0.0,0.0,3279,77876,49185,-28691
19470,0.0,0.0,0.0,3279,77880,49185,-28695
19471,0.0,0.0,0.0,3279,77884,49185,-28699
19472,0.0,0.0,0.0,3279,77888,49185,-28703
19473,0.0,0.0,0.0,3279,77892,49185,-28707
19474,0.0,0.0,0.3333333333333333,3279,77896,49185,-28711
19475,0.0,0.0,0.0,3279,77900,49185,-28715
19476,1.0,1.0,1.0,3280,77904,49200,-28704
19477,0.0,0.0,0.0,3280,77908,49200,-28708
19478,0.0,0.0,0.0,3280,77912,49200,-28712
19479,1.0,1.0,1.0,3281,77916,49215,-28701
19480,0.0,0.0,0.0,3281,77920,49215,-28705
19481,0.0,1.0,0.6666666666666666,3281,77924,49215,-28709
19482,0.0,0.0,0.0,3281,77928,49215,-28713
19483,1.0,1.0,1.0,3282,77932,49230,-28702
19484,0.0,0.0,0.0,3282,77936,49230,-28706
19485,0.0,0.0,0.0,3282,77940,49230,-28710
19486,0.0,0.0,0.0,3282,77944,49230,-28714
19487,0.0,0.0,0.0,3282,77948,49230,-28718
19488,0.0,0.0,0.0,3282,77952,49230,-28722
19489,0.0,0.0,0.0,3282,77956,49230,-28726
19490,0.0,0.0,0.0,3282,77960,49230,-28730
19491,0.0,0.0,0.0,3282,77964,49230,-28734
19492,0.0,0.0,0.0,3282,77968,49230,-28738
19493,0.0,0.0,0.0,3282,77972,49230,-28742
19494,0.0,0.0,0.0,3282,77976,49230,-28746
19495,0.0,0.0,0.0,3282,77980,49230,-28750
19496,1.0,1.0,1.0,3283,77984,49245,-28739
19497,0.0,0.0,0.0,3283,77988,49245,-28743
19498,0.0,0.0,0.0,3283,77992,49245,-28747
19499,0.0,0.0,0.0,3283,77996,49245,-28751
19500,0.0,0.0,0.0,3283,78000,49245,-28755
19501,0.0,0.0,0.0,3283,78004,49245,-28759
19502,0.0,0.0,0.0,3283,78008,49245,-28763
19503,0.0,0.0,0.0,3283,78012,49245,-28767
19504,0.0,0.0,0.0,3283,78016,49245,-28771
19505,0.0,0.0,0.0,3283,78020,49245,-28775
19506,0.0,0.0,0.0,3283,78024,49245,-28779
19507,0.0,1.0,0.6666666666666666,3283,78028,49245,-28783
19508,0.0,0.0,0.0,3283,78032,49245,-28787
19509,0.0,0.0,0.0,3283,78036,49245,-28791
19510,0.0,0.0,0.0,3283,78040,49245,-28795
19511,0.0,0.0,0.0,3283,78044,49245,-28799
19512,0.0,0.0,0.0,3283,78048,49245,-28803
19513,0.0,0.0,0.0,3283,78052,49245,-28807
19514,0.0,0.0,0.0,3283,78056,49245,-28811
19515,0.0,0.0,0.0,3283,78060,49245,-28815
19516,0.0,0.0,0.0,3283,78064,49245,-28819
19517,0.0,0.0,0.0,3283,78068,49245,-28823
19518,0.0,0.0,0.0,3283,78072,49245,-28827
19519,0.0,0.0,0.0,3283,78076,49245,-28831
19520,0.0,0.0,0.0,3283,78080,49245,-28835
19521,0.0,0.0,0.0,3283,78084,49245,-28839
19522,0.0,0.0,0.0,3283,78088,49245,-28843
19523,0.0,0.0,0.0,3283,78092,49245,-28847
19524,0.0,0.0,0.0,3283,78096,49245,-28851
19525,0.0,0.0,0.0,3283,78100,49245,-28855
19526,1.0,1.0,0.6666666666666666,3284,78104,49260,-28844
19527,0.0,0.0,0.0,3284,78108,49260,-28848
19528,0.0,0.0,0.0,3284,78112,49260,-28852
19529,0.0,0.0,0.0,3284,78116,49260,-28856
19530,0.0,0.0,0.0,3284,78120,49260,-28860
19531,0.0,0.0,0.0,3284,78124,49260,-28864
19532,0.0,0.0,0.0,3284,78128,49260,-28868
19533,0.0,0.0,0.0,3284,78132,49260,-28872
19534,0.0,0.0,0.0,3284,78136,49260,-28876
19535,1.0,1.0,0.6,3285,78140,49275,-28865
19536,0.0,0.0,0.0,3285,78144,49275,-28869
19537,0.0,0.0,0.0,3285,78148,49275,-28873
19538,0.0,0.0,0.0,3285,78152,49275,-28877
19539,0.0,0.0,0.0,3285,78156,49275,-28881
19540,0.0,0.0,0.0,3285,78160,49275,-28885
19541,0.0,0.0,0.0,3285,78164,49275,-28889
19542,0.0,0.0,0.0,3285,78168,49275,-28893
19543,0.0,0.0,0.0,3285,78172,49275,-28897
19544,0.0,0.0,0.0,3285,78176,49275,-28901
19545,0.0,0.0,0.0,3285,78180,49275,-28905
19546,0.0,0.0,0.0,3285,78184,49275,-28909
19547,0.0,0.0,0.0,3285,78188,49275,-28913
19548,1.0,1.0,1.0,3286,78192,49290,-28902
19549,0.0,0.0,0.0,3286,78196,49290,-28906
19550,0.0,0.0,0.0,3286,78200,49290,-28910
19551,0.0,0.0,0.0,3286,78204,49290,-28914
19552,0.0,0.0,0.0,3286,78208,49290,-28918
19553,0.0,0.0,0.0,3286,78212,49290,-28922
19554,0.0,0.0,0.0,3286,78216,49290,-28926
19555,0.0,0.0,0.0,3286,78220,49290,-28930
19556,0.0,0.0,0.0,3286,78224,49290,-28934
19557,1.0,1.0,1.0,3287,78228,49305,-28923
19558,0.0,0.0,0.0,3287,78232,49305,-28927
19559,0.0,0.0,0.0,3287,78236,49305,-28931
19560,0.0,0.0,0.0,3287,78240,49305,-28935
19561,1.0,1.0,0.6666666666666666,3288,78244,49320,-28924
19562,0.0,0.0,0.0,3288,78248,49320,-28928
19563,0.0,0.0,0.0,3288,78252,49320,-28932
19564,1.0,0.0,0.3333333333333333,3289,78256,49335,-28921
19565,0.0,0.0,0.0,3289,78260,49335,-28925
19566,0.0,0.0,0.0,3289,78264,49335,-28929
19567,0.0,0.0,0.0,3289,78268,49335,-28933
19568,0.0,0.0,0.0,3289,78272,49335,-28937
19569,0.0,0.0,0.0,3289,78276,49335,-28941
19570,0.0,0.0,0.5,3289,78280,49335,-28945
19571,0.0,0.0,0.0,3289,78284,49335,-28949
19572,0.0,0.0,0.0,3289,78288,49335,-28953
19573,1.0,0.0,0.2,3290,78292,49350,-28942
19574,0.0,0.0,0.0,3290,78296,49350,-28946
19575,0.0,0.0,0.0,3290,78300,49350,-28950
19576,0.0,0.0,0.0,3290,78304,49350,-28954
19577,0.0,0.0,0.0,3290,78308,49350,-28958
19578,0.0,0.0,0.0,3290,78312,49350,-28962
19579,0.0,0.0,0.0,3290,78316,49350,-28966
19580,0.0,0.0,0.0,3290,78320,49350,-28970
19581,0.0,0.0,0.3333333333333333,3290,78324,49350,-28974
19582,0.0,0.0,0.0,3290,78328,49350,-28978
19583,0.0,0.0,0.0,3290,78332,49350,-28982
19584,0.0,0.0,0.0,3290,78336,49350,-28986
19585,0.0,0.0,0.0,3290,78340,49350,-28990
19586,0.0,0.0,0.0,3290,78344,49350,-28994
19587,0.0,0.0,0.0,3290,78348,49350,-28998
19588,1.0,1.0,1.0,3291,78352,49365,-28987
19589,0.0,0.0,0.0,3291,78356,49365,-28991
19590,0.0,0.0,0.0,3291,78360,49365,-28995
19591,0.0,0.0,0.0,3291,78364,49365,-28999
19592,0.0,0.0,0.0,3291,78368,49365,-29003
19593,0.0,0.0,0.0,3291,78372,49365,-29007
19594,0.0,0.0,0.0,3291,78376,49365,-29011
19595,0.0,1.0,0.6666666666666666,3291,78380,49365,-29015
19596,0.0,0.0,0.0,3291,78384,49365,-29019
19597,0.0,0.0,0.0,3291,78388,49365,-29023
19598,0.0,0.0,0.0,3291,78392,49365,-29027
19599,0.0,0.0,0.0,3291,78396,49365,-29031
19600,0.0,0.0,0.0,3291,78400,49365,-29035
19601,0.0,0.0,0.0,3291,78404,49365,-29039
19602,0.0,0.0,0.0,3291,78408,49365,-29043
19603,0.0,0.0,0.0,3291,78412,49365,-29047
19604,0.0,0.0,0.0,3291,78416,49365,-29051
19605,0.0,0.0,0.0,3291,78420,49365,-29055
19606,1.0,1.0,1.0,3292,78424,49380,-29044
19607,1.0,1.0,1.0,3293,78428,49395,-29033
19608,0.0,0.0,0.0,3293,78432,49395,-29037
19609,0.0,0.0,0.0,3293,78436,49395,-29041
19610,0.0,0.0,0.3333333333333333,3293,78440,49395,-29045
19611,0.0,0.0,0.0,3293,78444,49395,-29049
19612,0.0,0.0,0.0,3293,78448,49395,-29053
19613,0.0,0.0,0.0,3293,78452,49395,-29057
19614,0.0,0.0,0.0,3293,78456,49395,-29061
19615,0.0,0.0,0.0,3293,78460,49395,-29065
19616,0.0,0.0,0.0,3293,78464,49395,-29069
19617,1.0,1.0,1.0,3294,78468,49410,-29058
19618,0.0,0.0,0.0,3294,78472,49410,-29062
19619,0.0,0.0,0.0,3294,78476,49410,-29066
19620,0.0,0.0,0.0,3294,78480,49410,-29070
19621,1.0,1.0,1.0,3295,78484,49425,-29059
19622,0.0,0.0,0.0,3295,78488,49425,-29063
19623,0.0,0.0,0.0,3295,78492,49425,-29067
19624,0.0,0.0,0.0,3295,78496,49425,-29071
19625,1.0,0.0,0.5,3296,78500,49440,-29060
19626,0.0,0.0,0.0,3296,78504,49440,-29064
19627,0.0,0.0,0.0,3296,78508,49440,-29068
19628,0.0,0.0,0.0,3296,78512,49440,-29072
19629,0.0,0.0,0.0,3296,78516,49440,-29076
19630,0.0,0.0,0.0,3296,78520,49440,-29080
19631,0.0,0.0,0.0,3296,78524,49440,-29084
19632,0.0,0.0,0.0,3296,78528,49440,-29088
19633,0.0,0.0,0.0,3296,78532,49440,-29092
19634,0.0,0.0,0.0,3296,78536,49440,-29096
19635,0.0,0.0,0.0,3296,78540,49440,-29100
19636,0.0,0.0,0.0,3296,78544,49440,-29104
19637,0.0,0.0,0.0,3296,78548,49440,-29108
19638,1.0,0.0,0.4,3297,78552,49455,-29097
19639,0.0,0.0,0.0,3297,78556,49455,-29101
19640,0.0,0.0,0.0,3297,78560,49455,-29105
19641,0.0,0.0,0.0,3297,78564,49455,-29109
19642,0.0,0.0,0.0,3297,78568,49455,-29113
19643,0.0,0.0,0.0,3297,78572,49455,-29117
19644,0.0,0.0,0.0,3297,78576,49455,-29121
19645,1.0,1.0,1.0,3298,78580,49470,-29110
19646,0.0,0.0,0.0,3298,78584,49470,-29114
19647,0.0,0.0,0.0,3298,78588,49470,-29118
19648,0.0,0.0,0.0,3298,78592,49470,-29122
19649,0.0,0.0,0.0,3298,78596,49470,-29126
19650,0.0,0.0,0.0,3298,78600,49470,-29130
19651,0.0,0.0,0.0,3298,78604,49470,-29134
19652,0.0,0.0,0.0,3298,78608,49470,-29138
19653,0.0,0.0,0.3333333333333333,3298,78612,49470,-29142
19654,0.0,0.0,0.0,3298,78616,49470,-29146
19655,0.0,0.0,0.0,3298,78620,49470,-29150
19656,0.0,0.0,0.0,3298,78624,49470,-29154
19657,0.0,0.0,0.25,3298,78628,49470,-29158
19658,0.0,0.0,0.0,3298,78632,49470,-29162
19659,0.0,0.0,0.0,3298,78636,49470,-29166
19660,0.0,0.0,0.0,3298,78640,49470,-29170
19661,0.0,0.0,0.0,3298,78644,49470,-29174
19662,0.0,0.0,0.0,3298,78648,49470,-29178
19663,0.0,0.0,0.0,3298,78652,49470,-29182
19664,0.0,0.0,0.0,3298,78656,49470,-29186
19665,0.0,0.0,0.0,3298,78660,49470,-29190
19666,0.0,0.0,0.0,3298,78664,49470,-29194
19667,0.0,0.0,0.0,3298,78668,49470,-29198
19668,0.0,0.0,0.0,3298,78672,49470,-29202
19669,0.0,0.0,0.0,3298,78676,49470,-29206
19670,0.0,0.0,0.0,3298,78680,49470,-29210
19671,0.0,0.0,0.0,3298,78684,49470,-29214
19672,0.0,0.0,0.0,3298,78688,49470,-29218
19673,0.0,0.0,0.0,3298,78692,49470,-29222
19674,0.0,0.0,0.0,3298,78696,49470,-29226
19675,0.0,0.0,0.0,3298,78700,49470,-29230
19676,0.0,0.0,0.0,3298,78704,49470,-29234
19677,0.0,0.0,0.0,3298,78708,49470,-29238
19678,0.0,0.0,0.0,3298,78712,49470,-29242
19679,0.0,0.0,0.0,3298,78716,49470,-29246
19680,0.0,0.0,0.0,3298,78720,49470,-29250
19681,0.0,0.0,0.0,3298,78724,49470,-29254
19682,0.0,0.0,0.0,3298,78728,49470,-29258
19683,0.0,0.0,0.0,3298,78732,49470,-29262
19684,0.0,0.0,0.0,3298,78736,49470,-29266
19685,0.0,0.0,0.0,3298,78740,49470,-29270
19686,0.0,0.0,0.0,3298,78744,49470,-29274
19687,0.0,0.0,0.25,3298,78748,49470,-29278
19688,0.0,0.0,0.0,3298,78752,49470,-29282
19689,0.0,0.0,0.0,3298,78756,49470,-29286
19690,0.0,0.0,0.0,3298,78760,49470,-29290
19691,0.0,0.0,0.0,3298,78764,49470,-29294
19692,0.0,0.0,0.5,3298,78768,49470,-29298
19693,0.0,0.0,0.0,3298,78772,49470,-29302
19694,0.0,0.0,0.0,3298,78776,49470,-29306
19695,0.0,0.0,0.0,3298,78780,49470,-29310
19696,1.0,1.0,0.6,3299,78784,49485,-29299
19697,1.0,1.0,1.0,3300,78788,49500,-29288
19698,0.0,0.0,0.0,3300,78792,49500,-29292
19699,0.0,0.0,0.0,3300,78796,49500,-29296
19700,0.0,0.0,0.0,3300,78800,49500,-29300
19701,0.0,0.0,0.0,3300,78804,49500,-29304
19702,0.0,0.0,0.0,3300,78808,49500,-29308
19703,0.0,0.0,0.0,3300,78812,49500,-29312
19704,0.0,0.0,0.0,3300,78816,49500,-29316
19705,0.0,0.0,0.0,3300,78820,49500,-29320
19706,0.0,0.0,0.0,3300,78824,49500,-29324
19707,1.0,1.0,1.0,3301,78828,49515,-29313
19708,0.0,0.0,0.0,3301,78832,49515,-29317
19709,0.0,0.0,0.0,3301,78836,49515,-29321
19710,0.0,0.0,0.0,3301,78840,49515,-29325
19711,0.0,0.0,0.0,3301,78844,49515,-29329
19712,0.0,0.0,0.0,3301,78848,49515,-29333
19713,0.0,0.0,0.0,3301,78852,49515,-29337
19714,0.0,0.0,0.0,3301,78856,49515,-29341
19715,0.0,0.0,0.0,3301,78860,49515,-29345
19716,1.0,1.0,1.0,3302,78864,49530,-29334
19717,0.0,0.0,0.0,3302,78868,49530,-29338
19718,0.0,0.0,0.0,3302,78872,49530,-29342
19719,0.0,0.0,0.0,3302,78876,49530,-29346
19720,1.0,1.0,1.0,3303,78880,49545,-29335
19721,0.0,0.0,0.0,3303,78884,49545,-29339
19722,0.0,0.0,0.0,3303,78888,49545,-29343
19723,0.0,0.0,0.0,3303,78892,49545,-29347
19724,0.0,0.0,0.0,3303,78896,49545,-29351
19725,0.0,0.0,0.0,3303,78900,49545,-29355
19726,0.0,0.0,0.0,3303,78904,49545,-29359
19727,0.0,0.0,0.0,3303,78908,49545,-29363
19728,0.0,0.0,0.0,3303,78912,49545,-29367
19729,0.0,0.0,0.0,3303,78916,49545,-29371
19730,0.0,0.0,0.0,3303,78920,49545,-29375
19731,0.0,0.0,0.0,3303,78924,49545,-29379
19732,0.0,0.0,0.0,3303,78928,49545,-29383
19733,0.0,0.0,0.0,3303,78932,49545,-29387
19734,0.0,0.0,0.0,3303,78936,49545,-29391
19735,0.0,0.0,0.0,3303,78940,49545,-29395
19736,0.0,0.0,0.0,3303,78944,49545,-29399
19737,0.0,0.0,0.0,3303,78948,49545,-29403
19738,0.0,0.0,0.0,3303,78952,49545,-29407
19739,0.0,0.0,0.0,3303,78956,49545,-29411
19740,0.0,0.0,0.0,3303,78960,49545,-29415
19741,0.0,0.0,0.3333333333333333,3303,78964,49545,-29419
19742,0.0,0.0,0.0,3303,78968,49545,-29423
19743,0.0,0.0,0.0,3303,78972,49545,-29427
19744,0.0,0.0,0.0,3303,78976,49545,-29431
19745,0.0,0.0,0.0,3303,78980,49545,-29435
19746,0.0,0.0,0.0,3303,78984,49545,-29439
19747,0.0,0.0,0.0,3303,78988,49545,-29443
19748,0.0,0.0,0.0,3303,78992,49545,-29447
19749,0.0,0.0,0.0,3303,78996,49545,-29451
19750,0.0,0.0,0.0,3303,79000,49545,-29455
19751,0.0,0.0,0.0,3303,79004,49545,-29459
19752,0.0,0.0,0.0,3303,79008,49545,-29463
19753,0.0,0.0,0.0,3303,79012,49545,-29467
19754,1.0,1.0,1.0,3304,79016,49560,-29456
19755,0.0,0.0,0.0,3304,79020,49560,-29460
19756,0.0,0.0,0.0,3304,79024,49560,-29464
19757,0.0,0.0,0.0,3304,79028,49560,-29468
19758,0.0,0.0,0.0,3304,79032,49560,-29472
19759,0.0,0.0,0.3333333333333333,3304,79036,49560,-29476
19760,0.0,0.0,0.0,3304,79040,49560,-29480
19761,0.0,0.0,0.0,3304,79044,49560,-29484
19762,0.0,0.0,0.0,3304,79048,49560,-29488
19763,0.0,0.0,0.0,3304,79052,49560,-29492
19764,0.0,0.0,0.0,3304,79056,49560,-29496
19765,0.0,0.0,0.0,3304,79060,49560,-29500
19766,0.0,0.0,0.0,3304,79064,49560,-29504
19767,0.0,0.0,0.0,3304,79068,49560,-29508
19768,1.0,1.0,1.0,3305,79072,49575,-29497
19769,0.0,0.0,0.0,3305,79076,49575,-29501
19770,0.0,0.0,0.0,3305,79080,49575,-29505
19771,0.0,0.0,0.0,3305,79084,49575,-29509
19772,0.0,0.0,0.0,3305,79088,49575,-29513
19773,0.0,0.0,0.0,3305,79092,49575,-29517
19774,0.0,0.0,0.0,3305,79096,49575,-29521
19775,0.0,0.0,0.0,3305,79100,49575,-29525
19776,0.0,0.0,0.0,3305,79104,49575,-29529
19777,0.0,0.0,0.0,3305,79108,49575,-29533
19778,0.0,0.0,0.0,3305,79112,49575,-29537
19779,0.0,0.0,0.0,3305,79116,49575,-29541
19780,0.0,0.0,0.0,3305,79120,49575,-29545
19781,0.0,0.0,0.0,3305,79124,49575,-29549
19782,0.0,0.0,0.0,3305,79128,49575,-29553
19783,1.0,1.0,1.0,3306,79132,49590,-29542
19784,0.0,0.0,0.0,3306,79136,49590,-29546
19785,0.0,0.0,0.0,3306,79140,49590,-29550
19786,0.0,0.0,0.0,3306,79144,49590,-29554
19787,0.0,0.0,0.0,3306,79148,49590,-29558
19788,0.0,0.0,0.0,3306,79152,49590,-29562
19789,0.0,0.0,0.0,3306,79156,49590,-29566
19790,0.0,0.0,0.0,3306,79160,49590,-29570
19791,0.0,0.0,0.0,3306,79164,49590,-29574
19792,1.0,0.0,0.3333333333333333,3307,79168,49605,-29563
19793,0.0,0.0,0.0,3307,79172,49605,-29567
19794,1.0,1.0,1.0,3308,79176,49620,-29556
19795,0.0,0.0,0.0,3308,79180,49620,-29560
19796,0.0,0.0,0.0,3308,79184,49620,-29564
19797,0.0,0.0,0.0,3308,79188,49620,-29568
19798,0.0,0.0,0.0,3308,79192,49620,-29572
19799,0.0,0.0,0.0,3308,79196,49620,-29576
19800,0.0,0.0,0.0,3308,79200,49620,-29580
19801,0.0,0.0,0.0,3308,79204,49620,-29584
19802,0.0,0.0,0.0,3308,79208,49620,-29588
19803,0.0,0.0,0.0,3308,79212,49620,-29592
19804,0.0,0.0,0.0,3308,79216,49620,-29596
19805,0.0,0.0,0.0,3308,79220,49620,-29600
19806,0.0,1.0,0.6666666666666666,3308,79224,49620,-29604
19807,0.0,0.0,0.0,3308,79228,49620,-29608
19808,0.0,0.0,0.0,3308,79232,49620,-29612
19809,0.0,0.0,0.0,3308,79236,49620,-29616
19810,0.0,0.0,0.0,3308,79240,49620,-29620
19811,0.0,0.0,0.0,3308,79244,49620,-29624
19812,1.0,1.0,1.0,3309,79248,49635,-29613
19813,0.0,0.0,0.0,3309,79252,49635,-29617
19814,0.0,0.0,0.0,3309,79256,49635,-29621
19815,1.0,1.0,1.0,3310,79260,49650,-29610
19816,0.0,0.0,0.0,3310,79264,49650,-29614
19817,0.0,0.0,0.0,3310,79268,49650,-29618
19818,0.0,0.0,0.0,3310,79272,49650,-29622
19819,0.0,0.0,0.0,3310,79276,49650,-29626
19820,0.0,0.0,0.0,3310,79280,49650,-29630
19821,0.0,0.0,0.0,3310,79284,49650,-29634
19822,1.0,1.0,0.8,3311,79288,49665,-29623
19823,0.0,0.0,0.0,3311,79292,49665,-29627
19824,0.0,0.0,0.0,3311,79296,49665,-29631
19825,1.0,1.0,1.0,3312,79300,49680,-29620
19826,1.0,1.0,1.0,3313,79304,49695,-29609
19827,0.0,0.0,0.0,3313,79308,49695,-29613
19828,0.0,0.0,0.0,3313,79312,49695,-29617
19829,0.0,0.0,0.0,3313,79316,49695,-29621
19830,0.0,0.0,0.0,3313,79320,49695,-29625
19831,0.0,0.0,0.0,3313,79324,49695,-29629
19832,0.0,0.0,0.0,3313,79328,49695,-29633
19833,1.0,1.0,1.0,3314,79332,49710,-29622
19834,0.0,0.0,0.0,3314,79336,49710,-29626
19835,0.0,0.0,0.0,3314,79340,49710,-29630
19836,0.0,0.0,0.0,3314,79344,49710,-29634
19837,0.0,0.0,0.0,3314,79348,49710,-29638
19838,0.0,0.0,0.0,3314,79352,49710,-29642
19839,0.0,0.0,0.0,3314,79356,49710,-29646
19840,1.0,1.0,1.0,3315,79360,49725,-29635
19841,0.0,0.0,0.0,3315,79364,49725,-29639
19842,0.0,0.0,0.0,3315,79368,49725,-29643
19843,0.0,0.0,0.0,3315,79372,49725,-29647
19844,0.0,0.0,0.0,3315,79376,49725,-29651
19845,0.0,0.0,0.25,3315,79380,49725,-29655
19846,0.0,0.0,0.0,3315,79384,49725,-29659
19847,0.0,0.0,0.0,3315,79388,49725,-29663
19848,0.0,0.0,0.0,3315,79392,49725,-29667
19849,0.0,0.0,0.0,3315,79396,49725,-29671
19850,0.0,0.0,0.0,3315,79400,49725,-29675
19851,0.0,0.0,0.0,3315,79404,49725,-29679
19852,0.0,0.0,0.0,3315,79408,49725,-29683
19853,0.0,0.0,0.0,3315,79412,49725,-29687
19854,0.0,0.0,0.0,3315,79416,49725,-29691
19855,0.0,0.0,0.0,3315,79420,49725,-29695
19856,0.0,0.0,0.0,3315,79424,49725,-29699
19857,1.0,1.0,1.0,3316,79428,49740,-29688
19858,0.0,0.0,0.0,3316,79432,49740,-29692
19859,0.0,0.0,0.0,3316,79436,49740,-29696
19860,0.0,0.0,0.0,3316,79440,49740,-29700
19861,0.0,0.0,0.0,3316,79444,49740,-29704
19862,0.0,0.0,0.0,3316,79448,49740,-29708
19863,0.0,0.0,0.0,3316,79452,49740,-29712
19864,0.0,0.0,0.0,3316,79456,49740,-29716
19865,1.0,1.0,1.0,3317,79460,49755,-29705
19866,0.0,0.0,0.0,3317,79464,49755,-29709
19867,0.0,0.0,0.0,3317,79468,49755,-29713
19868,0.0,0.0,0.0,3317,79472,49755,-29717
19869,0.0,0.0,0.0,3317,79476,49755,-29721
19870,1.0,1.0,1.0,3318,79480,49770,-29710
19871,0.0,0.0,0.0,3318,79484,49770,-29714
19872,0.0,0.0,0.0,3318,79488,49770,-29718
19873,0.0,0.0,0.0,3318,79492,49770,-29722
19874,0.0,0.0,0.0,3318,79496,49770,-29726
19875,0.0,0.0,0.0,3318,79500,49770,-29730
19876,0.0,0.0,0.0,3318,79504,49770,-29734
19877,0.0,0.0,0.0,3318,79508,49770,-29738
19878,0.0,0.0,0.0,3318,79512,49770,-29742
19879,0.0,0.0,0.0,3318,79516,49770,-29746
19880,0.0,0.0,0.0,3318,79520,49770,-29750
19881,1.0,1.0,1.0,3319,79524,49785,-29739
19882,0.0,0.0,0.0,3319,79528,49785,-29743
19883,0.0,0.0,0.0,3319,79532,49785,-29747
19884,0.0,0.0,0.3333333333333333,3319,79536,49785,-29751
19885,0.0,0.0,0.0,3319,79540,49785,-29755
19886,0.0,0.0,0.3333333333333333,3319,79544,49785,-29759
19887,0.0,0.0,0.0,3319,79548,49785,-29763
19888,0.0,0.0,0.0,3319,79552,49785,-29767
19889,0.0,0.0,0.0,3319,79556,49785,-29771
19890,0.0,0.0,0.0,3319,79560,49785,-29775
19891,0.0,0.0,0.0,3319,79564,49785,-29779
19892,0.0,0.0,0.0,3319,79568,49785,-29783
19893,0.0,0.0,0.0,3319,79572,49785,-29787
19894,0.0,0.0,0.0,3319,79576,49785,-29791
19895,0.0,0.0,0.0,3319,79580,49785,-29795
19896,0.0,0.0,0.0,3319,79584,49785,-29799
19897,0.0,0.0,0.0,3319,79588,49785,-29803
19898,0.0,0.0,0.0,3319,79592,49785,-29807
19899,0.0,0.0,0.0,3319,79596,49785,-29811
19900,0.0,0.0,0.0,3319,79600,49785,-29815
19901,0.0,0.0,0.0,3319,79604,49785,-29819
19902,1.0,1.0,1.0,3320,79608,49800,-29808
19903,0.0,0.0,0.0,3320,79612,49800,-29812
19904,1.0,0.0,0.5,3321,79616,49815,-29801
19905,0.0,1.0,0.6,3321,79620,49815,-29805
19906,1.0,1.0,1.0,3322,79624,49830,-29794
19907,0.0,0.0,0.0,3322,79628,49830,-29798
19908,0.0,0.0,0.0,3322,79632,49830,-29802
19909,0.0,0.0,0.0,3322,79636,49830,-29806
19910,0.0,0.0,0.0,3322,79640,49830,-29810
19911,0.0,0.0,0.0,3322,79644,49830,-29814
19912,0.0,0.0,0.0,3322,79648,49830,-29818
19913,0.0,0.0,0.0,3322,79652,49830,-29822
19914,0.0,0.0,0.0,3322,79656,49830,-29826
19915,0.0,0.0,0.0,3322,79660,49830,-29830
19916,0.0,0.0,0.0,3322,79664,49830,-29834
19917,0.0,0.0,0.0,3322,79668,49830,-29838
19918,0.0,0.0,0.0,3322,79672,49830,-29842
19919,0.0,0.0,0.0,3322,79676,49830,-29846
19920,0.0,0.0,0.0,3322,79680,49830,-29850
19921,1.0,1.0,1.0,3323,79684,49845,-29839
19922,1.0,1.0,1.0,3324,79688,49860,-29828
19923,1.0,1.0,1.0,3325,79692,49875,-29817
19924,0.0,0.0,0.0,3325,79696,49875,-29821
19925,0.0,0.0,0.0,3325,79700,49875,-29825
19926,1.0,1.0,1.0,3326,79704,49890,-29814
19927,1.0,1.0,1.0,3327,79708,49905,-29803
19928,0.0,0.0,0.0,3327,79712,49905,-29807
19929,1.0,1.0,0.75,3328,79716,49920,-29796
19930,0.0,0.0,0.0,3328,79720,49920,-29800
19931,0.0,0.0,0.0,3328,79724,49920,-29804
19932,0.0,0.0,0.0,3328,79728,49920,-29808
19933,0.0,0.0,0.0,3328,79732,49920,-29812
19934,0.0,0.0,0.0,3328,79736,49920,-29816
19935,0.0,0.0,0.0,3328,79740,49920,-29820
19936,0.0,0.0,0.0,3328,79744,49920,-29824
19937,0.0,0.0,0.0,3328,79748,49920,-29828
19938,0.0,0.0,0.3333333333333333,3328,79752,49920,-29832
19939,0.0,0.0,0.0,3328,79756,49920,-29836
19940,0.0,0.0,0.0,3328,79760,49920,-29840
19941,0.0,0.0,0.0,3328,79764,49920,-29844
19942,0.0,1.0,0.6666666666666666,3328,79768,49920,-29848
19943,0.0,0.0,0.0,3328,79772,49920,-29852
19944,0.0,0.0,0.0,3328,79776,49920,-29856
19945,0.0,0.0,0.0,3328,79780,49920,-29860
19946,1.0,1.0,1.0,3329,79784,49935,-29849
19947,0.0,0.0,0.0,3329,79788,49935,-29853
19948,0.0,0.0,0.0,3329,79792,49935,-29857
19949,0.0,0.0,0.0,3329,79796,49935,-29861
19950,0.0,0.0,0.0,3329,79800,49935,-29865
19951,0.0,0.0,0.0,3329,79804,49935,-29869
19952,1.0,1.0,1.0,3330,79808,49950,-29858
19953,1.0,1.0,1.0,3331,79812,49965,-29847
19954,0.0,0.0,0.0,3331,79816,49965,-29851
19955,0.0,0.0,0.0,3331,79820,49965,-29855
19956,0.0,0.0,0.0,3331,79824,49965,-29859
19957,1.0,1.0,1.0,3332,79828,49980,-29848
19958,0.0,0.0,0.0,3332,79832,49980,-29852
19959,1.0,1.0,1.0,3333,79836,49995,-29841
19960,0.0,0.0,0.0,3333,79840,49995,-29845
19961,1.0,1.0,1.0,3334,79844,50010,-29834
19962,0.0,0.0,0.0,3334,79848,50010,-29838
19963,0.0,0.0,0.0,3334,79852,50010,-29842
19964,0.0,0.0,0.0,3334,79856,50010,-29846
19965,0.0,0.0,0.0,3334,79860,50010,-29850
19966,0.0,0.0,0.0,3334,79864,50010,-29854
19967,1.0,1.0,1.0,3335,79868,50025,-29843
19968,1.0,1.0,1.0,3336,79872,50040,-29832
19969,1.0,1.0,1.0,3337,79876,50055,-29821
19970,0.0,0.0,0.0,3337,79880,50055,-29825
19971,0.0,0.0,0.0,3337,79884,50055,-29829
19972,0.0,0.0,0.0,3337,79888,50055,-29833
19973,1.0,1.0,1.0,3338,79892,50070,-29822
19974,0.0,0.0,0.0,3338,79896,50070,-29826
19975,0.0,0.0,0.0,3338,79900,50070,-29830
19976,0.0,0.0,0.0,3338,79904,50070,-29834
19977,0.0,0.0,0.0,3338,79908,50070,-29838
19978,0.0,0.0,0.0,3338,79912,50070,-29842
19979,0.0,0.0,0.0,3338,79916,50070,-29846
19980,0.0,0.0,0.0,3338,79920,50070,-29850
19981,0.0,0.0,0.0,3338,79924,50070,-29854
19982,0.0,0.0,0.0,3338,79928,50070,-29858
19983,0.0,0.0,0.0,3338,79932,50070,-29862
19984,0.0,0.0,0.0,3338,79936,50070,-29866
19985,0.0,0.0,0.0,3338,79940,50070,-29870
19986,0.0,0.0,0.0,3338,79944,50070,-29874
19987,0.0,0.0,0.0,3338,79948,50070,-29878
19988,0.0,0.0,0.0,3338,79952,50070,-29882
19989,0.0,0.0,0.0,3338,79956,50070,-29886
19990,1.0,1.0,1.0,3339,79960,50085,-29875
19991,0.0,0.0,0.0,3339,79964,50085,-29879
19992,0.0,0.0,0.3333333333333333,3339,79968,50085,-29883
19993,0.0,0.0,0.0,3339,79972,50085,-29887
19994,0.0,0.0,0.0,3339,79976,50085,-29891
19995,0.0,0.0,0.0,3339,79980,50085,-29895
19996,0.0,0.0,0.0,3339,79984,50085,-29899
19997,0.0,0.0,0.0,3339,79988,50085,-29903
19998,0.0,0.0,0.0,3339,79992,50085,-29907
19999,0.0,0.0,0.0,3339,79996,50085,-29911
20000,1.0,1.0,1.0,3340,80000,50100,-29900
20001,0.0,0.0,0.0,3340,80004,50100,-29904
20002,0.0,0.0,0.0,3340,80008,50100,-29908
20003,0.0,0.0,0.0,3340,80012,50100,-29912
20004,0.0,0.0,0.0,3340,80016,50100,-29916
20005,0.0,0.0,0.0,3340,80020,50100,-29920
20006,0.0,0.0,0.0,3340,80024,50100,-29924
20007,0.0,0.0,0.0,3340,80028,50100,-29928
20008,0.0,0.0,0.0,3340,80032,50100,-29932
20009,0.0,0.0,0.0,3340,80036,50100,-29936
20010,0.0,0.0,0.0,3340,80040,50100,-29940
20011,0.0,0.0,0.0,3340,80044,50100,-29944
20012,0.0,0.0,0.3333333333333333,3340,80048,50100,-29948
20013,0.0,0.0,0.0,3340,80052,50100,-29952
20014,0.0,0.0,0.0,3340,80056,50100,-29956
20015,0.0,0.0,0.0,3340,80060,50100,-29960
20016,0.0,0.0,0.0,3340,80064,50100,-29964
20017,0.0,0.0,0.0,3340,80068,50100,-29968
20018,0.0,0.0,0.0,3340,80072,50100,-29972
20019,0.0,0.0,0.0,3340,80076,50100,-29976
20020,0.0,0.0,0.5,3340,80080,50100,-29980
20021,0.0,0.0,0.0,3340,80084,50100,-29984
20022,0.0,0.0,0.0,3340,80088,50100,-29988
20023,0.0,0.0,0.0,3340,80092,50100,-29992
20024,0.0,0.0,0.0,3340,80096,50100,-29996
20025,0.0,0.0,0.0,3340,80100,50100,-30000
20026,1.0,1.0,0.75,3341,80104,50115,-29989
20027,0.0,0.0,0.0,3341,80108,50115,-29993
20028,0.0,0.0,0.0,3341,80112,50115,-29997
20029,0.0,0.0,0.0,3341,80116,50115,-30001
20030,0.0,0.0,0.0,3341,80120,50115,-30005
20031,1.0,1.0,1.0,3342,80124,50130,-29994
20032,1.0,1.0,1.0,3343,80128,50145,-29983
20033,0.0,0.0,0.0,3343,80132,50145,-29987
20034,0.0,0.0,0.0,3343,80136,50145,-29991
20035,1.0,1.0,0.75,3344,80140,50160,-29980
20036,0.0,0.0,0.3333333333333333,3344,80144,50160,-29984
20037,0.0,0.0,0.0,3344,80148,50160,-29988
20038,0.0,0.0,0.0,3344,80152,50160,-29992
20039,0.0,0.0,0.0,3344,80156,50160,-29996
20040,0.0,0.0,0.0,3344,80160,50160,-30000
20041,0.0,0.0,0.0,3344,80164,50160,-30004
20042,0.0,0.0,0.0,3344,80168,50160,-30008
20043,0.0,0.0,0.0,3344,80172,50160,-30012
20044,1.0,1.0,0.6,3345,80176,50175,-30001
20045,0.0,0.0,0.0,3345,80180,50175,-30005
20046,1.0,1.0,1.0,3346,80184,50190,-29994
20047,0.0,0.0,0.0,3346,80188,50190,-29998
20048,0.0,0.0,0.0,3346,80192,50190,-30002
20049,0.0,0.0,0.0,3346,80196,50190,-30006
20050,0.0,0.0,0.0,3346,80200,50190,-30010
20051,0.0,0.0,0.0,3346,80204,50190,-30014
20052,0.0,1.0,0.6666666666666666,3346,80208,50190,-30018
20053,0.0,0.0,0.0,3346,80212,50190,-30022
20054,0.0,0.0,0.0,3346,80216,50190,-30026
20055,0.0,0.0,0.0,3346,80220,50190,-30030
20056,0.0,0.0,0.0,3346,80224,50190,-30034
20057,1.0,1.0,0.6,3347,80228,50205,-30023
20058,0.0,0.0,0.0,3347,80232,50205,-30027
20059,0.0,0.0,0.0,3347,80236,50205,-30031
20060,0.0,0.0,0.0,3347,80240,50205,-30035
20061,0.0,0.0,0.0,3347,80244,50205,-30039
20062,1.0,1.0,0.6666666666666666,3348,80248,50220,-30028
20063,1.0,1.0,1.0,3349,80252,50235,-30017
20064,0.0,0.0,0.0,3349,80256,50235,-30021
20065,0.0,0.0,0.0,3349,80260,50235,-30025
20066,0.0,0.0,0.0,3349,80264,50235,-30029
20067,0.0,0.0,0.0,3349,80268,50235,-30033
20068,1.0,1.0,1.0,3350,80272,50250,-30022
20069,0.0,0.0,0.0,3350,80276,50250,-30026
20070,0.0,0.0,0.0,3350,80280,50250,-30030
20071,0.0,0.0,0.0,3350,80284,50250,-30034
20072,0.0,0.0,0.0,3350,80288,50250,-30038
20073,0.0,0.0,0.0,3350,80292,50250,-30042
20074,0.0,0.0,0.0,3350,80296,50250,-30046
20075,0.0,0.0,0.0,3350,80300,50250,-30050
20076,0.0,0.0,0.0,3350,80304,50250,-30054
20077,0.0,0.0,0.0,3350,80308,50250,-30058
20078,0.0,0.0,0.0,3350,80312,50250,-30062
20079,0.0,0.0,0.0,3350,80316,50250,-30066
20080,0.0,0.0,0.0,3350,80320,50250,-30070
20081,0.0,0.0,0.0,3350,80324,50250,-30074
20082,0.0,0.0,0.0,3350,80328,50250,-30078
20083,0.0,0.0,0.0,3350,80332,50250,-30082
20084,0.0,0.0,0.3333333333333333,3350,80336,50250,-30086
20085,0.0,0.0,0.0,3350,80340,50250,-30090
20086,1.0,1.0,1.0,3351,80344,50265,-30079
20087,0.0,0.0,0.0,3351,80348,50265,-30083
20088,0.0,0.0,0.0,3351,80352,50265,-30087
20089,1.0,1.0,1.0,3352,80356,50280,-30076
20090,1.0,1.0,1.0,3353,80360,50295,-30065
20091,0.0,0.0,0.0,3353,80364,50295,-30069
20092,0.0,0.0,0.0,3353,80368,50295,-30073
20093,0.0,0.0,0.0,3353,80372,50295,-30077
20094,0.0,0.0,0.0,3353,80376,50295,-30081
20095,0.0,0.0,0.0,3353,80380,50295,-30085
20096,0.0,0.0,0.0,3353,80384,50295,-30089
20097,0.0,0.0,0.0,3353,80388,50295,-30093
20098,0.0,0.0,0.0,3353,80392,50295,-30097
20099,0.0,0.0,0.0,3353,80396,50295,-30101
20100,0.0,0.0,0.0,3353,80400,50295,-30105
20101,0.0,0.0,0.0,3353,80404,50295,-30109
20102,0.0,0.0,0.0,3353,80408,50295,-30113
20103,0.0,0.0,0.0,3353,80412,50295,-30117
20104,0.0,0.0,0.0,3353,80416,50295,-30121
20105,0.0,0.0,0.0,3353,80420,50295,-30125
20106,0.0,0.0,0.0,3353,80424,50295,-30129
20107,0.0,0.0,0.0,3353,80428,50295,-30133
20108,0.0,0.0,0.0,3353,80432,50295,-30137
20109,0.0,0.0,0.0,3353,80436,50295,-30141
20110,0.0,0.0,0.0,3353,80440,50295,-30145
20111,1.0,1.0,1.0,3354,80444,50310,-30134
20112,0.0,0.0,0.0,3354,80448,50310,-30138
20113,0.0,0.0,0.0,3354,80452,50310,-30142
20114,1.0,0.0,0.3333333333333333,3355,80456,50325,-30131
20115,0.0,0.0,0.0,3355,80460,50325,-30135
20116,0.0,0.0,0.0,3355,80464,50325,-30139
20117,1.0,1.0,1.0,3356,80468,50340,-30128
20118,0.0,0.0,0.0,3356,80472,50340,-30132
20119,0.0,0.0,0.0,3356,80476,50340,-30136
20120,1.0,1.0,1.0,3357,80480,50355,-30125
20121,0.0,0.0,0.0,3357,80484,50355,-30129
20122,0.0,0.0,0.0,3357,80488,50355,-30133
20123,0.0,0.0,0.0,3357,80492,50355,-30137
20124,0.0,0.0,0.0,3357,80496,50355,-30141
20125,0.0,0.0,0.0,3357,80500,50355,-30145
20126,0.0,0.0,0.0,3357,80504,50355,-30149
20127,1.0,1.0,1.0,3358,80508,50370,-30138
20128,0.0,0.0,0.0,3358,80512,50370,-30142
20129,0.0,0.0,0.0,3358,80516,50370,-30146
20130,0.0,0.0,0.0,3358,80520,50370,-30150
20131,0.0,0.0,0.0,3358,80524,50370,-30154
20132,0.0,0.0,0.0,3358,80528,50370,-30158
20133,0.0,0.0,0.0,3358,80532,50370,-30162
20134,0.0,0.0,0.0,3358,80536,50370,-30166
20135,0.0,0.0,0.0,3358,80540,50370,-30170
20136,0.0,0.0,0.0,3358,80544,50370,-30174
20137,0.0,0.0,0.0,3358,80548,50370,-30178
20138,1.0,1.0,0.6666666666666666,3359,80552,50385,-30167
20139,0.0,0.0,0.0,3359,80556,50385,-30171
20140,0.0,0.0,0.0,3359,80560,50385,-30175
20141,0.0,0.0,0.0,3359,80564,50385,-30179
20142,0.0,0.0,0.0,3359,80568,50385,-30183
20143,0.0,0.0,0.0,3359,80572,50385,-30187
20144,0.0,0.0,0.0,3359,80576,50385,-30191
20145,0.0,0.0,0.0,3359,80580,50385,-30195
20146,0.0,0.0,0.0,3359,80584,50385,-30199
20147,1.0,1.0,1.0,3360,80588,50400,-30188
20148,0.0,0.0,0.0,3360,80592,50400,-30192
20149,0.0,0.0,0.0,3360,80596,50400,-30196
20150,0.0,0.0,0.0,3360,80600,50400,-30200
20151,1.0,0.0,0.3333333333333333,3361,80604,50415,-30189
20152,0.0,0.0,0.0,3361,80608,50415,-30193
20153,0.0,0.0,0.0,3361,80612,50415,-30197
20154,1.0,1.0,1.0,3362,80616,50430,-30186
20155,0.0,0.0,0.0,3362,80620,50430,-30190
20156,0.0,0.0,0.0,3362,80624,50430,-30194
20157,0.0,0.0,0.0,3362,80628,50430,-30198
20158,0.0,0.0,0.0,3362,80632,50430,-30202
20159,0.0,0.0,0.0,3362,80636,50430,-30206
20160,0.0,0.0,0.0,3362,80640,50430,-30210
20161,0.0,0.0,0.0,3362,80644,50430,-30214
20162,0.0,0.0,0.0,3362,80648,50430,-30218
20163,0.0,0.0,0.0,3362,80652,50430,-30222
20164,0.0,0.0,0.0,3362,80656,50430,-30226
20165,0.0,0.0,0.0,3362,80660,50430,-30230
20166,0.0,0.0,0.0,3362,80664,50430,-30234
20167,0.0,1.0,0.6666666666666666,3362,80668,50430,-30238
20168,0.0,0.0,0.0,3362,80672,50430,-30242
20169,0.0,0.0,0.0,3362,80676,50430,-30246
20170,0.0,0.0,0.25,3362,80680,50430,-30250
20171,0.0,0.0,0.0,3362,80684,50430,-30254
20172,1.0,1.0,1.0,3363,80688,50445,-30243
20173,0.0,0.0,0.0,3363,80692,50445,-30247
20174,0.0,0.0,0.0,3363,80696,50445,-30251
20175,0.0,0.0,0.0,3363,80700,50445,-30255
20176,0.0,0.0,0.0,3363,80704,50445,-30259
20177,1.0,1.0,1.0,3364,80708,50460,-30248
20178,0.0,0.0,0.0,3364,80712,50460,-30252
20179,1.0,1.0,1.0,3365,80716,50475,-30241
20180,0.0,0.0,0.0,3365,80720,50475,-30245
20181,0.0,0.0,0.0,3365,80724,50475,-30249
20182,1.0,1.0,1.0,3366,80728,50490,-30238
20183,0.0,0.0,0.0,3366,80732,50490,-30242
20184,0.0,0.0,0.0,3366,80736,50490,-30246
20185,0.0,0.0,0.0,3366,80740,50490,-30250
20186,0.0,0.0,0.0,3366,80744,50490,-30254
20187,0.0,0.0,0.0,3366,80748,50490,-30258
20188,0.0,0.0,0.0,3366,80752,50490,-30262
20189,0.0,0.0,0.0,3366,80756,50490,-30266
20190,0.0,0.0,0.0,3366,80760,50490,-30270
20191,0.0,0.0,0.0,3366,80764,50490,-30274
20192,0.0,0.0,0.0,3366,80768,50490,-30278
20193,0.0,0.0,0.0,3366,80772,50490,-30282
20194,1.0,1.0,1.0,3367,80776,50505,-30271
20195,0.0,0.0,0.0,3367,80780,50505,-30275
20196,0.0,0.0,0.5,3367,80784,50505,-30279
20197,0.0,0.0,0.0,3367,80788,50505,-30283
20198,0.0,0.0,0.0,3367,80792,50505,-30287
20199,0.0,0.0,0.0,3367,80796,50505,-30291
20200,0.0,0.0,0.0,3367,80800,50505,-30295
20201,1.0,1.0,1.0,3368,80804,50520,-30284
20202,0.0,0.0,0.0,3368,80808,50520,-30288
20203,0.0,0.0,0.0,3368,80812,50520,-30292
20204,0.0,0.0,0.0,3368,80816,50520,-30296
20205,1.0,1.0,1.0,3369,80820,50535,-30285
20206,0.0,0.0,0.0,3369,80824,50535,-30289
20207,1.0,1.0,1.0,3370,80828,50550,-30278
20208,0.0,0.0,0.0,3370,80832,50550,-30282
20209,0.0,0.0,0.0,3370,80836,50550,-30286
20210,0.0,0.0,0.0,3370,80840,50550,-30290
20211,0.0,0.0,0.0,3370,80844,50550,-30294
20212,0.0,0.0,0.0,3370,80848,50550,-30298
20213,0.0,0.0,0.0,3370,80852,50550,-30302
20214,0.0,0.0,0.0,3370,80856,50550,-30306
20215,0.0,0.0,0.0,3370,80860,50550,-30310
20216,0.0,0.0,0.0,3370,80864,50550,-30314
20217,0.0,0.0,0.0,3370,80868,50550,-30318
20218,1.0,1.0,1.0,3371,80872,50565,-30307
20219,0.0,0.0,0.0,3371,80876,50565,-30311
20220,0.0,0.0,0.0,3371,80880,50565,-30315
20221,1.0,1.0,1.0,3372,80884,50580,-30304
20222,0.0,0.0,0.0,3372,80888,50580,-30308
20223,0.0,0.0,0.0,3372,80892,50580,-30312
20224,0.0,0.0,0.0,3372,80896,50580,-30316
20225,0.0,0.0,0.0,3372,80900,50580,-30320
20226,0.0,0.0,0.0,3372,80904,50580,-30324
20227,0.0,0.0,0.0,3372,80908,50580,-30328
20228,0.0,0.0,0.0,3372,80912,50580,-30332
20229,0.0,0.0,0.0,3372,80916,50580,-30336
20230,1.0,1.0,1.0,3373,80920,50595,-30325
20231,1.0,1.0,1.0,3374,80924,50610,-30314
20232,0.0,0.0,0.0,3374,80928,50610,-30318
20233,0.0,0.0,0.0,3374,80932,50610,-30322
20234,0.0,0.0,0.0,3374,80936,50610,-30326
20235,0.0,0.0,0.0,3374,80940,50610,-30330
20236,0.0,0.0,0.0,3374,80944,50610,-30334
20237,1.0,1.0,1.0,3375,80948,50625,-30323
20238,0.0,0.0,0.0,3375,80952,50625,-30327
20239,0.0,0.0,0.0,3375,80956,50625,-30331
20240,0.0,0.0,0.0,3375,80960,50625,-30335
20241,1.0,1.0,1.0,3376,80964,50640,-30324
20242,0.0,0.0,0.0,3376,80968,50640,-30328
20243,0.0,0.0,0.0,3376,80972,50640,-30332
20244,0.0,0.0,0.0,3376,80976,50640,-30336
20245,0.0,0.0,0.0,3376,80980,50640,-30340
20246,0.0,0.0,0.0,3376,80984,50640,-30344
20247,0.0,0.0,0.0,3376,80988,50640,-30348
20248,0.0,0.0,0.0,3376,80992,50640,-30352
20249,0.0,0.0,0.0,3376,80996,50640,-30356
20250,0.0,0.0,0.0,3376,81000,50640,-30360
20251,1.0,1.0,1.0,3377,81004,50655,-30349
20252,0.0,0.0,0.0,3377,81008,50655,-30353
20253,0.0,0.0,0.0,3377,81012,50655,-30357
20254,0.0,0.0,0.0,3377,81016,50655,-30361
20255,0.0,0.0,0.0,3377,81020,50655,-30365
20256,1.0,0.0,0.5,3378,81024,50670,-30354
20257,0.0,0.0,0.0,3378,81028,50670,-30358
20258,0.0,0.0,0.0,3378,81032,50670,-30362
20259,1.0,1.0,1.0,3379,81036,50685,-30351
20260,0.0,0.0,0.0,3379,81040,50685,-30355
20261,0.0,0.0,0.0,3379,81044,50685,-30359
20262,0.0,0.0,0.0,3379,81048,50685,-30363
20263,0.0,0.0,0.0,3379,81052,50685,-30367
20264,0.0,0.0,0.0,3379,81056,50685,-30371
20265,0.0,0.0,0.0,3379,81060,50685,-30375
20266,1.0,1.0,0.6,3380,81064,50700,-30364
20267,1.0,1.0,1.0,3381,81068,50715,-30353
20268,0.0,0.0,0.3333333333333333,3381,81072,50715,-30357
20269,0.0,0.0,0.0,3381,81076,50715,-30361
20270,1.0,1.0,1.0,3382,81080,50730,-30350
20271,1.0,1.0,1.0,3383,81084,50745,-30339
20272,0.0,0.0,0.0,3383,81088,50745,-30343
20273,0.0,0.0,0.0,3383,81092,50745,-30347
20274,1.0,1.0,0.6666666666666666,3384,81096,50760,-30336
20275,0.0,0.0,0.0,3384,81100,50760,-30340
20276,0.0,0.0,0.0,3384,81104,50760,-30344
20277,0.0,0.0,0.0,3384,81108,50760,-30348
20278,0.0,0.0,0.0,3384,81112,50760,-30352
20279,1.0,0.0,0.3333333333333333,3385,81116,50775,-30341
20280,0.0,0.0,0.0,3385,81120,50775,-30345
20281,0.0,0.0,0.0,3385,81124,50775,-30349
20282,0.0,0.0,0.0,3385,81128,50775,-30353
20283,0.0,0.0,0.0,3385,81132,50775,-30357
20284,0.0,0.0,0.0,3385,81136,50775,-30361
20285,1.0,1.0,1.0,3386,81140,50790,-30350
20286,0.0,0.0,0.0,3386,81144,50790,-30354
20287,0.0,0.0,0.0,3386,81148,50790,-30358
20288,0.0,0.0,0.0,3386,81152,50790,-30362
20289,0.0,0.0,0.0,3386,81156,50790,-30366
20290,0.0,0.0,0.0,3386,81160,50790,-30370
20291,0.0,0.0,0.0,3386,81164,50790,-30374
20292,0.0,0.0,0.0,3386,81168,50790,-30378
20293,0.0,0.0,0.0,3386,81172,50790,-30382
20294,1.0,1.0,0.8,3387,81176,50805,-30371
20295,0.0,0.0,0.0,3387,81180,50805,-30375
20296,0.0,0.0,0.0,3387,81184,50805,-30379
20297,0.0,0.0,0.0,3387,81188,50805,-30383
20298,0.0,0.0,0.0,3387,81192,50805,-30387
20299,1.0,1.0,1.0,3388,81196,50820,-30376
20300,0.0,0.0,0.0,3388,81200,50820,-30380
20301,0.0,0.0,0.0,3388,81204,50820,-30384
20302,0.0,0.0,0.0,3388,81208,50820,-30388
20303,0.0,0.0,0.0,3388,81212,50820,-30392
20304,1.0,1.0,1.0,3389,81216,50835,-30381
20305,0.0,0.0,0.0,3389,81220,50835,-30385
20306,0.0,0.0,0.0,3389,81224,50835,-30389
20307,0.0,0.0,0.0,3389,81228,50835,-30393
20308,0.0,0.0,0.0,3389,81232,50835,-30397
20309,0.0,0.0,0.0,3389,81236,50835,-30401
20310,0.0,0.0,0.0,3389,81240,50835,-30405
20311,0.0,0.0,0.0,3389,81244,50835,-30409
20312,0.0,0.0,0.0,3389,81248,50835,-30413
20313,0.0,0.0,0.0,3389,81252,50835,-30417
20314,0.0,0.0,0.0,3389,81256,50835,-30421
20315,0.0,0.0,0.0,3389,81260,50835,-30425
20316,0.0,0.0,0.0,3389,81264,50835,-30429
20317,0.0,0.0,0.0,3389,81268,50835,-30433
20318,0.0,0.0,0.0,3389,81272,50835,-30437
20319,0.0,0.0,0.0,3389,81276,50835,-30441
20320,0.0,0.0,0.0,3389,81280,50835,-30445
20321,0.0,0.0,0.0,3389,81284,50835,-30449
20322,0.0,0.0,0.0,3389,81288,50835,-30453
20323,0.0,0.0,0.0,3389,81292,50835,-30457
20324,0.0,0.0,0.0,3389,81296,50835,-30461
20325,0.0,0.0,0.0,3389,81300,50835,-30465
20326,0.0,0.0,0.0,3389,81304,50835,-30469
20327,0.0,0.0,0.0,3389,81308,50835,-30473
20328,0.0,0.0,0.0,3389,81312,50835,-30477
20329,1.0,1.0,1.0,3390,81316,50850,-30466
20330,0.0,0.0,0.0,3390,81320,50850,-30470
20331,0.0,0.0,0.5,3390,81324,50850,-30474
20332,0.0,0.0,0.0,3390,81328,50850,-30478
20333,1.0,1.0,0.75,3391,81332,50865,-30467
20334,0.0,0.0,0.0,3391,81336,50865,-30471
20335,0.0,0.0,0.0,3391,81340,50865,-30475
20336,0.0,0.0,0.0,3391,81344,50865,-30479
20337,0.0,0.0,0.0,3391,81348,50865,-30483
20338,0.0,0.0,0.0,3391,81352,50865,-30487
20339,0.0,0.0,0.3333333333333333,3391,81356,50865,-30491
20340,0.0,0.0,0.0,3391,81360,50865,-30495
20341,1.0,1.0,1.0,3392,81364,50880,-30484
20342,0.0,0.0,0.0,3392,81368,50880,-30488
20343,0.0,0.0,0.0,3392,81372,50880,-30492
20344,0.0,0.0,0.0,3392,81376,50880,-30496
20345,0.0,0.0,0.0,3392,81380,50880,-30500
20346,0.0,0.0,0.0,3392,81384,50880,-30504
20347,1.0,1.0,1.0,3393,81388,50895,-30493
20348,0.0,0.0,0.0,3393,81392,50895,-30497
20349,0.0,0.0,0.0,3393,81396,50895,-30501
20350,1.0,1.0,1.0,3394,81400,50910,-30490
20351,0.0,0.0,0.0,3394,81404,50910,-30494
20352,0.0,0.0,0.0,3394,81408,50910,-30498
20353,0.0,0.0,0.0,3394,81412,50910,-30502
20354,0.0,0.0,0.0,3394,81416,50910,-30506
20355,0.0,0.0,0.5,3394,81420,50910,-30510
20356,0.0,0.0,0.0,3394,81424,50910,-30514
20357,0.0,0.0,0.0,3394,81428,50910,-30518
20358,0.0,0.0,0.0,3394,81432,50910,-30522
20359,0.0,0.0,0.0,3394,81436,50910,-30526
20360,0.0,0.0,0.0,3394,81440,50910,-30530
20361,0.0,0.0,0.0,3394,81444,50910,-30534
20362,0.0,0.0,0.0,3394,81448,50910,-30538
20363,0.0,0.0,0.0,3394,81452,50910,-30542
20364,0.0,0.0,0.25,3394,81456,50910,-30546
20365,0.0,0.0,0.0,3394,81460,50910,-30550
20366,1.0,1.0,1.0,3395,81464,50925,-30539
20367,0.0,0.0,0.0,3395,81468,50925,-30543
20368,0.0,0.0,0.0,3395,81472,50925,-30547
20369,0.0,0.0,0.0,3395,81476,50925,-30551
20370,1.0,0.0,0.5,3396,81480,50940,-30540
20371,0.0,0.0,0.0,3396,81484,50940,-30544
20372,1.0,1.0,1.0,3397,81488,50955,-30533
20373,0.0,0.0,0.0,3397,81492,50955,-30537
20374,0.0,0.0,0.0,3397,81496,50955,-30541
20375,0.0,0.0,0.0,3397,81500,50955,-30545
20376,0.0,0.0,0.0,3397,81504,50955,-30549
20377,0.0,0.0,0.0,3397,81508,50955,-30553
20378,1.0,1.0,1.0,3398,81512,50970,-30542
20379,0.0,0.0,0.3333333333333333,3398,81516,50970,-30546
20380,0.0,0.0,0.0,3398,81520,50970,-30550
20381,0.0,0.0,0.0,3398,81524,50970,-30554
20382,0.0,0.0,0.0,3398,81528,50970,-30558
20383,1.0,1.0,1.0,3399,81532,50985,-30547
20384,0.0,0.0,0.0,3399,81536,50985,-30551
20385,0.0,0.0,0.0,3399,81540,50985,-30555
20386,0.0,0.0,0.0,3399,81544,50985,-30559
20387,0.0,0.0,0.0,3399,81548,50985,-30563
20388,0.0,0.0,0.0,3399,81552,50985,-30567
20389,0.0,0.0,0.0,3399,81556,50985,-30571
20390,0.0,0.0,0.0,3399,81560,50985,-30575
20391,0.0,0.0,0.0,3399,81564,50985,-30579
20392,0.0,0.0,0.3333333333333333,3399,81568,50985,-30583
20393,0.0,0.0,0.0,3399,81572,50985,-30587
20394,0.0,0.0,0.0,3399,81576,50985,-30591
20395,0.0,0.0,0.0,3399,81580,50985,-30595
20396,0.0,0.0,0.0,3399,81584,50985,-30599
20397,1.0,1.0,1.0,3400,81588,51000,-30588
20398,1.0,1.0,0.6,3401,81592,51015,-30577
20399,0.0,0.0,0.0,3401,81596,51015,-30581
20400,0.0,0.0,0.0,3401,81600,51015,-30585
20401,1.0,0.0,0.5,3402,81604,51030,-30574
20402,0.0,0.0,0.0,3402,81608,51030,-30578
20403,0.0,0.0,0.0,3402,81612,51030,-30582
20404,0.0,0.0,0.0,3402,81616,51030,-30586
20405,0.0,0.0,0.0,3402,81620,51030,-30590
20406,0.0,0.0,0.0,3402,81624,51030,-30594
20407,0.0,0.0,0.0,3402,81628,51030,-30598
20408,0.0,0.0,0.0,3402,81632,51030,-30602
20409,0.0,0.0,0.0,3402,81636,51030,-30606
20410,1.0,1.0,1.0,3403,81640,51045,-30595
20411,0.0,0.0,0.0,3403,81644,51045,-30599
20412,0.0,0.0,0.0,3403,81648,51045,-30603
20413,0.0,0.0,0.0,3403,81652,51045,-30607
20414,1.0,1.0,1.0,3404,81656,51060,-30596
20415,1.0,1.0,1.0,3405,81660,51075,-30585
20416,0.0,0.0,0.0,3405,81664,51075,-30589
20417,0.0,0.0,0.0,3405,81668,51075,-30593
20418,0.0,0.0,0.0,3405,81672,51075,-30597
20419,1.0,1.0,1.0,3406,81676,51090,-30586
20420,0.0,0.0,0.0,3406,81680,51090,-30590
20421,1.0,1.0,1.0,3407,81684,51105,-30579
20422,0.0,0.0,0.0,3407,81688,51105,-30583
20423,0.0,0.0,0.0,3407,81692,51105,-30587
20424,0.0,0.0,0.0,3407,81696,51105,-30591
20425,1.0,1.0,1.0,3408,81700,51120,-30580
20426,0.0,0.0,0.0,3408,81704,51120,-30584
20427,0.0,0.0,0.0,3408,81708,51120,-30588
20428,0.0,0.0,0.0,3408,81712,51120,-30592
20429,0.0,0.0,0.0,3408,81716,51120,-30596
20430,1.0,0.0,0.5,3409,81720,51135,-30585
20431,1.0,1.0,0.6666666666666666,3410,81724,51150,-30574
20432,0.0,0.0,0.0,3410,81728,51150,-30578
20433,0.0,0.0,0.2,3410,81732,51150,-30582
20434,0.0,0.0,0.0,3410,81736,51150,-30586
20435,0.0,0.0,0.0,3410,81740,51150,-30590
20436,0.0,0.0,0.0,3410,81744,51150,-30594
20437,0.0,0.0,0.0,3410,81748,51150,-30598
20438,1.0,0.0,0.25,3411,81752,51165,-30587
20439,0.0,0.0,0.0,3411,81756,51165,-30591
20440,0.0,0.0,0.0,3411,81760,51165,-30595
20441,0.0,0.0,0.25,3411,81764,51165,-30599
20442,0.0,0.0,0.0,3411,81768,51165,-30603
20443,0.0,0.0,0.0,3411,81772,51165,-30607
20444,0.0,0.0,0.0,3411,81776,51165,-30611
20445,0.0,0.0,0.0,3411,81780,51165,-30615
20446,0.0,0.0,0.0,3411,81784,51165,-30619
20447,0.0,0.0,0.0,3411,81788,51165,-30623
20448,0.0,0.0,0.0,3411,81792,51165,-30627
20449,0.0,0.0,0.0,3411,81796,51165,-30631
20450,0.0,0.0,0.0,3411,81800,51165,-30635
20451,1.0,1.0,1.0,3412,81804,51180,-30624
20452,1.0,1.0,1.0,3413,81808,51195,-30613
20453,0.0,0.0,0.0,3413,81812,51195,-30617
20454,0.0,0.0,0.0,3413,81816,51195,-30621
20455,0.0,0.0,0.0,3413,81820,51195,-30625
20456,0.0,0.0,0.0,3413,81824,51195,-30629
20457,1.0,1.0,1.0,3414,81828,51210,-30618
20458,0.0,0.0,0.0,3414,81832,51210,-30622
20459,0.0,0.0,0.0,3414,81836,51210,-30626
20460,0.0,0.0,0.0,3414,81840,51210,-30630
20461,1.0,1.0,1.0,3415,81844,51225,-30619
20462,1.0,0.0,0.5,3416,81848,51240,-30608
20463,1.0,1.0,0.75,3417,81852,51255,-30597
20464,0.0,0.0,0.0,3417,81856,51255,-30601
20465,0.0,0.0,0.0,3417,81860,51255,-30605
20466,0.0,0.0,0.0,3417,81864,51255,-30609
20467,0.0,0.0,0.3333333333333333,3417,81868,51255,-30613
20468,1.0,1.0,1.0,3418,81872,51270,-30602
20469,0.0,0.0,0.0,3418,81876,51270,-30606
20470,0.0,0.0,0.0,3418,81880,51270,-30610
20471,0.0,0.0,0.0,3418,81884,51270,-30614
20472,0.0,0.0,0.0,3418,81888,51270,-30618
20473,0.0,0.0,0.0,3418,81892,51270,-30622
20474,0.0,0.0,0.0,3418,81896,51270,-30626
20475,1.0,1.0,1.0,3419,81900,51285,-30615
20476,0.0,0.0,0.0,3419,81904,51285,-30619
20477,0.0,0.0,0.0,3419,81908,51285,-30623
20478,1.0,1.0,1.0,3420,81912,51300,-30612
20479,0.0,0.0,0.0,3420,81916,51300,-30616
20480,1.0,0.0,0.4,3421,81920,51315,-30605
20481,0.0,0.0,0.0,3421,81924,51315,-30609
20482,1.0,0.0,0.25,3422,81928,51330,-30598
20483,0.0,0.0,0.0,3422,81932,51330,-30602
20484,0.0,0.0,0.0,3422,81936,51330,-30606
20485,1.0,1.0,1.0,3423,81940,51345,-30595
20486,0.0,0.0,0.0,3423,81944,51345,-30599
20487,0.0,0.0,0.0,3423,81948,51345,-30603
20488,0.0,0.0,0.0,3423,81952,51345,-30607
20489,0.0,0.0,0.0,3423,81956,51345,-30611
20490,0.0,0.0,0.0,3423,81960,51345,-30615
20491,1.0,1.0,1.0,3424,81964,51360,-30604
20492,0.0,0.0,0.0,3424,81968,51360,-30608
20493,1.0,1.0,0.8,3425,81972,51375,-30597
20494,0.0,0.0,0.0,3425,81976,51375,-30601
20495,0.0,0.0,0.0,3425,81980,51375,-30605
20496,0.0,0.0,0.0,3425,81984,51375,-30609
20497,1.0,1.0,1.0,3426,81988,51390,-30598
20498,0.0,0.0,0.0,3426,81992,51390,-30602
20499,0.0,0.0,0.0,3426,81996,51390,-30606
20500,1.0,1.0,1.0,3427,82000,51405,-30595
20501,0.0,0.0,0.0,3427,82004,51405,-30599
20502,1.0,1.0,1.0,3428,82008,51420,-30588
20503,0.0,0.0,0.0,3428,82012,51420,-30592
20504,0.0,0.0,0.0,3428,82016,51420,-30596
20505,0.0,0.0,0.0,3428,82020,51420,-30600
20506,0.0,0.0,0.0,3428,82024,51420,-30604
20507,0.0,0.0,0.0,3428,82028,51420,-30608
20508,0.0,0.0,0.0,3428,82032,51420,-30612
20509,0.0,0.0,0.0,3428,82036,51420,-30616
20510,0.0,1.0,0.6,3428,82040,51420,-30620
20511,0.0,0.0,0.0,3428,82044,51420,-30624
20512,0.0,0.0,0.0,3428,82048,51420,-30628
20513,1.0,1.0,1.0,3429,82052,51435,-30617
20514,1.0,1.0,1.0,3430,82056,51450,-30606
20515,0.0,0.0,0.0,3430,82060,51450,-30610
20516,0.0,0.0,0.0,3430,82064,51450,-30614
20517,1.0,1.0,1.0,3431,82068,51465,-30603
20518,0.0,0.0,0.0,3431,82072,51465,-30607
20519,0.0,0.0,0.0,3431,82076,51465,-30611
20520,1.0,1.0,1.0,3432,82080,51480,-30600
20521,0.0,0.0,0.0,3432,82084,51480,-30604
20522,0.0,0.0,0.0,3432,82088,51480,-30608
20523,0.0,0.0,0.0,3432,82092,51480,-30612
20524,0.0,0.0,0.0,3432,82096,51480,-30616
20525,0.0,0.0,0.0,3432,82100,51480,-30620
20526,0.0,0.0,0.0,3432,82104,51480,-30624
20527,0.0,0.0,0.0,3432,82108,51480,-30628
20528,0.0,0.0,0.0,3432,82112,51480,-30632
20529,0.0,0.0,0.0,3432,82116,51480,-30636
20530,0.0,0.0,0.0,3432,82120,51480,-30640
20531,0.0,0.0,0.0,3432,82124,51480,-30644
20532,0.0,0.0,0.0,3432,82128,51480,-30648
20533,0.0,0.0,0.0,3432,82132,51480,-30652
20534,0.0,0.0,0.0,3432,82136,51480,-30656
20535,0.0,0.0,0.0,3432,82140,51480,-30660
20536,0.0,0.0,0.0,3432,82144,51480,-30664
20537,0.0,0.0,0.0,3432,82148,51480,-30668
20538,0.0,0.0,0.0,3432,82152,51480,-30672
20539,0.0,0.0,0.0,3432,82156,51480,-30676
20540,0.0,0.0,0.0,3432,82160,51480,-30680
20541,1.0,0.0,0.5,3433,82164,51495,-30669
20542,0.0,0.0,0.0,3433,82168,51495,-30673
20543,0.0,0.0,0.0,3433,82172,51495,-30677
20544,0.0,0.0,0.0,3433,82176,51495,-30681
20545,0.0,0.0,0.3333333333333333,3433,82180,51495,-30685
20546,0.0,0.0,0.3333333333333333,3433,82184,51495,-30689
20547,0.0,0.0,0.0,3433,82188,51495,-30693
20548,0.0,1.0,0.6666666666666666,3433,82192,51495,-30697
20549,0.0,0.0,0.0,3433,82196,51495,-30701
20550,0.0,0.0,0.0,3433,82200,51495,-30705
20551,0.0,0.0,0.0,3433,82204,51495,-30709
20552,0.0,0.0,0.0,3433,82208,51495,-30713
20553,0.0,0.0,0.0,3433,82212,51495,-30717
20554,0.0,0.0,0.0,3433,82216,51495,-30721
20555,0.0,0.0,0.0,3433,82220,51495,-30725
20556,0.0,0.0,0.0,3433,82224,51495,-30729
20557,0.0,0.0,0.0,3433,82228,51495,-30733
20558,1.0,1.0,1.0,3434,82232,51510,-30722
20559,0.0,0.0,0.0,3434,82236,51510,-30726
20560,0.0,0.0,0.0,3434,82240,51510,-30730
20561,0.0,0.0,0.0,3434,82244,51510,-30734
20562,0.0,0.0,0.0,3434,82248,51510,-30738
20563,0.0,0.0,0.0,3434,82252,51510,-30742
20564,0.0,0.0,0.0,3434,82256,51510,-30746
20565,0.0,0.0,0.5,3434,82260,51510,-30750
20566,0.0,0.0,0.0,3434,82264,51510,-30754
20567,0.0,0.0,0.0,3434,82268,51510,-30758
20568,0.0,0.0,0.0,3434,82272,51510,-30762
20569,0.0,0.0,0.0,3434,82276,51510,-30766
20570,0.0,0.0,0.0,3434,82280,51510,-30770
20571,0.0,0.0,0.0,3434,82284,51510,-30774
20572,1.0,1.0,0.6,3435,82288,51525,-30763
20573,1.0,1.0,0.6666666666666666,3436,82292,51540,-30752
20574,0.0,0.0,0.0,3436,82296,51540,-30756
20575,0.0,0.0,0.0,3436,82300,51540,-30760
20576,0.0,0.0,0.0,3436,82304,51540,-30764
20577,0.0,0.0,0.0,3436,82308,51540,-30768
20578,1.0,1.0,0.75,3437,82312,51555,-30757
20579,0.0,0.0,0.0,3437,82316,51555,-30761
20580,1.0,1.0,1.0,3438,82320,51570,-30750
20581,0.0,0.0,0.0,3438,82324,51570,-30754
20582,0.0,0.0,0.0,3438,82328,51570,-30758
20583,0.0,0.0,0.0,3438,82332,51570,-30762
20584,0.0,0.0,0.0,3438,82336,51570,-30766
20585,0.0,0.0,0.0,3438,82340,51570,-30770
20586,0.0,0.0,0.0,3438,82344,51570,-30774
20587,1.0,0.0,0.25,3439,82348,51585,-30763
20588,0.0,0.0,0.0,3439,82352,51585,-30767
20589,0.0,0.0,0.0,3439,82356,51585,-30771
20590,0.0,0.0,0.0,3439,82360,51585,-30775
20591,0.0,1.0,0.6,3439,82364,51585,-30779
20592,0.0,0.0,0.0,3439,82368,51585,-30783
20593,0.0,0.0,0.0,3439,82372,51585,-30787
20594,0.0,0.0,0.0,3439,82376,51585,-30791
20595,0.0,0.0,0.0,3439,82380,51585,-30795
20596,1.0,1.0,1.0,3440,82384,51600,-30784
20597,0.0,0.0,0.0,3440,82388,51600,-30788
20598,0.0,1.0,0.8,3440,82392,51600,-30792
20599,0.0,0.0,0.0,3440,82396,51600,-30796
20600,0.0,1.0,0.6666666666666666,3440,82400,51600,-30800
20601,0.0,0.0,0.0,3440,82404,51600,-30804
20602,0.0,0.0,0.0,3440,82408,51600,-30808
20603,1.0,1.0,1.0,3441,82412,51615,-30797
20604,0.0,0.0,0.0,3441,82416,51615,-30801
20605,1.0,1.0,1.0,3442,82420,51630,-30790
20606,0.0,0.0,0.0,3442,82424,51630,-30794
20607,0.0,0.0,0.0,3442,82428,51630,-30798
20608,0.0,0.0,0.0,3442,82432,51630,-30802
20609,0.0,0.0,0.0,3442,82436,51630,-30806
20610,0.0,0.0,0.0,3442,82440,51630,-30810
20611,1.0,0.0,0.3333333333333333,3443,82444,51645,-30799
20612,0.0,0.0,0.0,3443,82448,51645,-30803
20613,0.0,0.0,0.0,3443,82452,51645,-30807
20614,0.0,0.0,0.0,3443,82456,51645,-30811
20615,1.0,1.0,1.0,3444,82460,51660,-30800
20616,0.0,0.0,0.0,3444,82464,51660,-30804
20617,1.0,1.0,1.0,3445,82468,51675,-30793
20618,0.0,0.0,0.0,3445,82472,51675,-30797
20619,0.0,0.0,0.0,3445,82476,51675,-30801
20620,0.0,0.0,0.0,3445,82480,51675,-30805
20621,1.0,1.0,1.0,3446,82484,51690,-30794
20622,0.0,0.0,0.0,3446,82488,51690,-30798
20623,0.0,0.0,0.0,3446,82492,51690,-30802
20624,0.0,0.0,0.0,3446,82496,51690,-30806
20625,0.0,0.0,0.0,3446,82500,51690,-30810
20626,0.0,0.0,0.0,3446,82504,51690,-30814
20627,0.0,0.0,0.0,3446,82508,51690,-30818
20628,0.0,0.0,0.0,3446,82512,51690,-30822
20629,0.0,0.0,0.0,3446,82516,51690,-30826
20630,1.0,1.0,1.0,3447,82520,51705,-30815
20631,0.0,0.0,0.0,3447,82524,51705,-30819
20632,0.0,0.0,0.0,3447,82528,51705,-30823
20633,0.0,0.0,0.0,3447,82532,51705,-30827
20634,0.0,0.0,0.0,3447,82536,51705,-30831
20635,0.0,0.0,0.0,3447,82540,51705,-30835
20636,1.0,1.0,1.0,3448,82544,51720,-30824
20637,0.0,0.0,0.0,3448,82548,51720,-30828
20638,0.0,1.0,0.6666666666666666,3448,82552,51720,-30832
20639,0.0,0.0,0.0,3448,82556,51720,-30836
20640,0.0,0.0,0.0,3448,82560,51720,-30840
20641,0.0,1.0,0.8,3448,82564,51720,-30844
20642,0.0,0.0,0.0,3448,82568,51720,-30848
20643,1.0,1.0,1.0,3449,82572,51735,-30837
20644,0.0,0.0,0.0,3449,82576,51735,-30841
20645,1.0,1.0,1.0,3450,82580,51750,-30830
20646,0.0,0.0,0.0,3450,82584,51750,-30834
20647,0.0,0.0,0.0,3450,82588,51750,-30838
20648,0.0,0.0,0.0,3450,82592,51750,-30842
20649,0.0,0.0,0.0,3450,82596,51750,-30846
20650,1.0,1.0,1.0,3451,82600,51765,-30835
20651,1.0,1.0,1.0,3452,82604,51780,-30824
20652,0.0,0.0,0.0,3452,82608,51780,-30828
20653,0.0,0.0,0.0,3452,82612,51780,-30832
20654,0.0,0.0,0.0,3452,82616,51780,-30836
20655,0.0,0.0,0.0,3452,82620,51780,-30840
20656,1.0,1.0,1.0,3453,82624,51795,-30829
20657,0.0,0.0,0.0,3453,82628,51795,-30833
20658,0.0,0.0,0.0,3453,82632,51795,-30837
20659,0.0,0.0,0.0,3453,82636,51795,-30841
20660,0.0,0.0,0.0,3453,82640,51795,-30845
20661,0.0,0.0,0.0,3453,82644,51795,-30849
20662,0.0,0.0,0.0,3453,82648,51795,-30853
20663,0.0,0.0,0.0,3453,82652,51795,-30857
20664,0.0,0.0,0.0,3453,82656,51795,-30861
20665,0.0,0.0,0.0,3453,82660,51795,-30865
20666,0.0,0.0,0.0,3453,82664,51795,-30869
20667,0.0,0.0,0.0,3453,82668,51795,-30873
20668,0.0,0.0,0.0,3453,82672,51795,-30877
20669,0.0,0.0,0.0,3453,82676,51795,-30881
20670,0.0,0.0,0.0,3453,82680,51795,-30885
20671,0.0,0.0,0.3333333333333333,3453,82684,51795,-30889
20672,0.0,0.0,0.0,3453,82688,51795,-30893
20673,1.0,1.0,1.0,3454,82692,51810,-30882
20674,0.0,0.0,0.0,3454,82696,51810,-30886
20675,0.0,0.0,0.0,3454,82700,51810,-30890
20676,0.0,0.0,0.0,3454,82704,51810,-30894
20677,0.0,0.0,0.0,3454,82708,51810,-30898
20678,0.0,0.0,0.0,3454,82712,51810,-30902
20679,0.0,0.0,0.0,3454,82716,51810,-30906
20680,0.0,0.0,0.0,3454,82720,51810,-30910
20681,0.0,0.0,0.0,3454,82724,51810,-30914
20682,0.0,0.0,0.0,3454,82728,51810,-30918
20683,0.0,0.0,0.0,3454,82732,51810,-30922
20684,0.0,0.0,0.0,3454,82736,51810,-30926
20685,0.0,0.0,0.0,3454,82740,51810,-30930
20686,0.0,0.0,0.0,3454,82744,51810,-30934
20687,0.0,0.0,0.0,3454,82748,51810,-30938
20688,1.0,1.0,1.0,3455,82752,51825,-30927
20689,0.0,0.0,0.0,3455,82756,51825,-30931
20690,0.0,0.0,0.0,3455,82760,51825,-30935
20691,0.0,0.0,0.0,3455,82764,51825,-30939
20692,1.0,1.0,1.0,3456,82768,51840,-30928
20693,0.0,0.0,0.0,3456,82772,51840,-30932
20694,1.0,1.0,1.0,3457,82776,51855,-30921
20695,0.0,0.0,0.0,3457,82780,51855,-30925
20696,0.0,0.0,0.0,3457,82784,51855,-30929
20697,0.0,0.0,0.0,3457,82788,51855,-30933
20698,0.0,0.0,0.0,3457,82792,51855,-30937
20699,1.0,1.0,1.0,3458,82796,51870,-30926
20700,0.0,0.0,0.0,3458,82800,51870,-30930
20701,1.0,1.0,1.0,3459,82804,51885,-30919
20702,0.0,0.0,0.0,3459,82808,51885,-30923
20703,1.0,1.0,1.0,3460,82812,51900,-30912
20704,0.0,1.0,0.75,3460,82816,51900,-30916
20705,0.0,0.0,0.0,3460,82820,51900,-30920
20706,0.0,0.0,0.0,3460,82824,51900,-30924
20707,0.0,0.0,0.4,3460,82828,51900,-30928
20708,0.0,0.0,0.0,3460,82832,51900,-30932
20709,0.0,0.0,0.0,3460,82836,51900,-30936
20710,0.0,0.0,0.0,3460,82840,51900,-30940
20711,0.0,1.0,0.6,3460,82844,51900,-30944
20712,0.0,0.0,0.3333333333333333,3460,82848,51900,-30948
20713,0.0,0.0,0.0,3460,82852,51900,-30952
20714,1.0,1.0,1.0,3461,82856,51915,-30941
20715,1.0,1.0,1.0,3462,82860,51930,-30930
20716,1.0,1.0,1.0,3463,82864,51945,-30919
20717,0.0,0.0,0.0,3463,82868,51945,-30923
20718,0.0,0.0,0.0,3463,82872,51945,-30927
20719,0.0,0.0,0.0,3463,82876,51945,-30931
20720,0.0,0.0,0.0,3463,82880,51945,-30935
20721,1.0,1.0,1.0,3464,82884,51960,-30924
20722,0.0,0.0,0.0,3464,82888,51960,-30928
20723,0.0,0.0,0.0,3464,82892,51960,-30932
20724,1.0,1.0,1.0,3465,82896,51975,-30921
20725,0.0,0.0,0.3333333333333333,3465,82900,51975,-30925
20726,0.0,0.0,0.0,3465,82904,51975,-30929
20727,0.0,0.0,0.0,3465,82908,51975,-30933
20728,0.0,0.0,0.0,3465,82912,51975,-30937
20729,0.0,0.0,0.4,3465,82916,51975,-30941
20730,0.0,0.0,0.0,3465,82920,51975,-30945
20731,0.0,0.0,0.0,3465,82924,51975,-30949
20732,0.0,0.0,0.0,3465,82928,51975,-30953
20733,0.0,0.0,0.0,3465,82932,51975,-30957
20734,0.0,0.0,0.0,3465,82936,51975,-30961
20735,0.0,0.0,0.0,3465,82940,51975,-30965
20736,0.0,0.0,0.0,3465,82944,51975,-30969
20737,0.0,0.0,0.0,3465,82948,51975,-30973
20738,1.0,1.0,1.0,3466,82952,51990,-30962
20739,1.0,1.0,1.0,3467,82956,52005,-30951
20740,0.0,0.0,0.0,3467,82960,52005,-30955
20741,0.0,0.0,0.0,3467,82964,52005,-30959
20742,0.0,0.0,0.0,3467,82968,52005,-30963
20743,0.0,0.0,0.0,3467,82972,52005,-30967
20744,0.0,0.0,0.0,3467,82976,52005,-30971
20745,0.0,0.0,0.0,3467,82980,52005,-30975
20746,0.0,0.0,0.0,3467,82984,52005,-30979
20747,0.0,0.0,0.0,3467,82988,52005,-30983
20748,0.0,0.0,0.0,3467,82992,52005,-30987
20749,0.0,0.0,0.0,3467,82996,52005,-30991
20750,0.0,0.0,0.0,3467,83000,52005,-30995
20751,0.0,0.0,0.0,3467,83004,52005,-30999
20752,0.0,0.0,0.0,3467,83008,52005,-31003
20753,0.0,0.0,0.0,3467,83012,52005,-31007
20754,0.0,0.0,0.0,3467,83016,52005,-31011
20755,0.0,0.0,0.0,3467,83020,52005,-31015
20756,1.0,1.0,1.0,3468,83024,52020,-31004
20757,0.0,0.0,0.0,3468,83028,52020,-31008
20758,0.0,0.0,0.0,3468,83032,52020,-31012
20759,0.0,0.0,0.0,3468,83036,52020,-31016
20760,0.0,0.0,0.0,3468,83040,52020,-31020
20761,0.0,0.0,0.0,3468,83044,52020,-31024
20762,0.0,0.0,0.0,3468,83048,52020,-31028
20763,0.0,0.0,0.0,3468,83052,52020,-31032
20764,0.0,0.0,0.0,3468,83056,52020,-31036
20765,1.0,0.0,0.4,3469,83060,52035,-31025
20766,0.0,0.0,0.0,3469,83064,52035,-31029
20767,0.0,0.0,0.0,3469,83068,52035,-31033
20768,0.0,0.0,0.25,3469,83072,52035,-31037
20769,1.0,1.0,0.75,3470,83076,52050,-31026
20770,1.0,1.0,1.0,3471,83080,52065,-31015
20771,0.0,0.0,0.0,3471,83084,52065,-31019
20772,1.0,1.0,1.0,3472,83088,52080,-31008
20773,0.0,0.0,0.0,3472,83092,52080,-31012
20774,0.0,0.0,0.0,3472,83096,52080,-31016
20775,1.0,1.0,1.0,3473,83100,52095,-31005
20776,0.0,0.0,0.0,3473,83104,52095,-31009
20777,0.0,0.0,0.0,3473,83108,52095,-31013
20778,0.0,0.0,0.0,3473,83112,52095,-31017
20779,0.0,0.0,0.0,3473,83116,52095,-31021
20780,0.0,0.0,0.0,3473,83120,52095,-31025
20781,1.0,1.0,1.0,3474,83124,52110,-31014
20782,1.0,1.0,1.0,3475,83128,52125,-31003
20783,0.0,0.0,0.0,3475,83132,52125,-31007
20784,0.0,0.0,0.0,3475,83136,52125,-31011
20785,1.0,0.0,0.3333333333333333,3476,83140,52140,-31000
20786,0.0,0.0,0.0,3476,83144,52140,-31004
20787,0.0,0.0,0.0,3476,83148,52140,-31008
20788,0.0,0.0,0.0,3476,83152,52140,-31012
20789,0.0,0.0,0.0,3476,83156,52140,-31016
20790,0.0,0.0,0.0,3476,83160,52140,-31020
20791,0.0,0.0,0.3333333333333333,3476,83164,52140,-31024
20792,0.0,0.0,0.0,3476,83168,52140,-31028
20793,0.0,0.0,0.0,3476,83172,52140,-31032
20794,0.0,0.0,0.0,3476,83176,52140,-31036
20795,0.0,0.0,0.0,3476,83180,52140,-31040
20796,0.0,0.0,0.0,3476,83184,52140,-31044
20797,0.0,0.0,0.0,3476,83188,52140,-31048
20798,1.0,1.0,1.0,3477,83192,52155,-31037
20799,0.0,0.0,0.0,3477,83196,52155,-31041
20800,0.0,0.0,0.0,3477,83200,52155,-31045
20801,0.0,0.0,0.0,3477,83204,52155,-31049
20802,0.0,0.0,0.0,3477,83208,52155,-31053
20803,0.0,0.0,0.0,3477,83212,52155,-31057
20804,1.0,0.0,0.3333333333333333,3478,83216,52170,-31046
20805,0.0,0.0,0.0,3478,83220,52170,-31050
20806,0.0,0.0,0.0,3478,83224,52170,-31054
20807,0.0,0.0,0.0,3478,83228,52170,-31058
20808,0.0,0.0,0.0,3478,83232,52170,-31062
20809,0.0,0.0,0.0,3478,83236,52170,-31066
20810,1.0,1.0,1.0,3479,83240,52185,-31055
20811,0.0,0.0,0.0,3479,83244,52185,-31059
20812,0.0,0.0,0.0,3479,83248,52185,-31063
20813,0.0,0.0,0.0,3479,83252,52185,-31067
20814,0.0,0.0,0.0,3479,83256,52185,-31071
20815,0.0,0.0,0.0,3479,83260,52185,-31075
20816,1.0,1.0,1.0,3480,83264,52200,-31064
20817,0.0,0.0,0.0,3480,83268,52200,-31068
20818,1.0,1.0,1.0,3481,83272,52215,-31057
20819,0.0,0.0,0.0,3481,83276,52215,-31061
20820,0.0,0.0,0.0,3481,83280,52215,-31065
20821,0.0,0.0,0.0,3481,83284,52215,-31069
20822,0.0,0.0,0.0,3481,83288,52215,-31073
20823,1.0,1.0,1.0,3482,83292,52230,-31062
20824,0.0,0.0,0.0,3482,83296,52230,-31066
20825,1.0,1.0,1.0,3483,83300,52245,-31055
20826,0.0,0.0,0.0,3483,83304,52245,-31059
20827,0.0,0.0,0.0,3483,83308,52245,-31063
20828,0.0,0.0,0.0,3483,83312,52245,-31067
20829,0.0,0.0,0.0,3483,83316,52245,-31071
20830,0.0,0.0,0.0,3483,83320,52245,-31075
20831,0.0,0.0,0.0,3483,83324,52245,-31079
20832,0.0,0.0,0.0,3483,83328,52245,-31083
20833,0.0,0.0,0.0,3483,83332,52245,-31087
20834,0.0,0.0,0.0,3483,83336,52245,-31091
20835,0.0,0.0,0.0,3483,83340,52245,-31095
20836,0.0,0.0,0.0,3483,83344,52245,-31099
20837,0.0,0.0,0.0,3483,83348,52245,-31103
20838,0.0,0.0,0.0,3483,83352,52245,-31107
20839,0.0,0.0,0.0,3483,83356,52245,-31111
20840,0.0,0.0,0.0,3483,83360,52245,-31115
20841,1.0,1.0,1.0,3484,83364,52260,-31104
20842,0.0,0.0,0.0,3484,83368,52260,-31108
20843,0.0,0.0,0.0,3484,83372,52260,-31112
20844,0.0,0.0,0.0,3484,83376,52260,-31116
20845,1.0,1.0,1.0,3485,83380,52275,-31105
20846,0.0,0.0,0.0,3485,83384,52275,-31109
20847,0.0,0.0,0.0,3485,83388,52275,-31113
20848,0.0,0.0,0.0,3485,83392,52275,-31117
20849,0.0,0.0,0.0,3485,83396,52275,-31121
20850,0.0,0.0,0.0,3485,83400,52275,-31125
20851,0.0,0.0,0.0,3485,83404,52275,-31129
20852,0.0,0.0,0.0,3485,83408,52275,-31133
20853,0.0,0.0,0.0,3485,83412,52275,-31137
20854,0.0,0.0,0.0,3485,83416,52275,-31141
20855,0.0,0.0,0.0,3485,83420,52275,-31145
20856,0.0,0.0,0.0,3485,83424,52275,-31149
20857,0.0,0.0,0.0,3485,83428,52275,-31153
20858,0.0,0.0,0.0,3485,83432,52275,-31157
20859,0.0,0.0,0.0,3485,83436,52275,-31161
20860,0.0,0.0,0.0,3485,83440,52275,-31165
20861,0.0,0.0,0.0,3485,83444,52275,-31169
20862,1.0,1.0,0.8,3486,83448,52290,-31158
20863,0.0,0.0,0.0,3486,83452,52290,-31162
20864,0.0,0.0,0.0,3486,83456,52290,-31166
20865,0.0,0.0,0.0,3486,83460,52290,-31170
20866,0.0,0.0,0.0,3486,83464,52290,-31174
20867,0.0,0.0,0.0,3486,83468,52290,-31178
20868,0.0,0.0,0.5,3486,83472,52290,-31182
20869,1.0,1.0,1.0,3487,83476,52305,-31171
20870,0.0,0.0,0.0,3487,83480,52305,-31175
20871,0.0,0.0,0.0,3487,83484,52305,-31179
20872,0.0,0.0,0.0,3487,83488,52305,-31183
20873,1.0,1.0,1.0,3488,83492,52320,-31172
20874,0.0,0.0,0.0,3488,83496,52320,-31176
20875,0.0,0.0,0.0,3488,83500,52320,-31180
20876,0.0,0.0,0.0,3488,83504,52320,-31184
20877,0.0,0.0,0.0,3488,83508,52320,-31188
20878,0.0,0.0,0.0,3488,83512,52320,-31192
20879,0.0,0.0,0.3333333333333333,3488,83516,52320,-31196
20880,0.0,0.0,0.0,3488,83520,52320,-31200
20881,0.0,0.0,0.0,3488,83524,52320,-31204
20882,1.0,1.0,1.0,3489,83528,52335,-31193
20883,0.0,0.0,0.0,3489,83532,52335,-31197
20884,0.0,0.0,0.0,3489,83536,52335,-31201
20885,0.0,0.0,0.0,3489,83540,52335,-31205
20886,0.0,0.0,0.0,3489,83544,52335,-31209
20887,0.0,0.0,0.0,3489,83548,52335,-31213
20888,0.0,0.0,0.0,3489,83552,52335,-31217
20889,0.0,0.0,0.0,3489,83556,52335,-31221
20890,0.0,0.0,0.0,3489,83560,52335,-31225
20891,0.0,0.0,0.0,3489,83564,52335,-31229
20892,0.0,0.0,0.0,3489,83568,52335,-31233
20893,0.0,0.0,0.0,3489,83572,52335,-31237
20894,0.0,0.0,0.0,3489,83576,52335,-31241
20895,1.0,1.0,0.6666666666666666,3490,83580,52350,-31230
20896,0.0,0.0,0.0,3490,83584,52350,-31234
20897,0.0,0.0,0.0,3490,83588,52350,-31238
20898,0.0,0.0,0.0,3490,83592,52350,-31242
20899,0.0,0.0,0.0,3490,83596,52350,-31246
20900,0.0,0.0,0.0,3490,83600,52350,-31250
20901,0.0,0.0,0.0,3490,83604,52350,-31254
20902,0.0,0.0,0.0,3490,83608,52350,-31258
20903,0.0,0.0,0.0,3490,83612,52350,-31262
20904,0.0,0.0,0.0,3490,83616,52350,-31266
20905,0.0,0.0,0.0,3490,83620,52350,-31270
20906,0.0,0.0,0.0,3490,83624,52350,-31274
20907,0.0,0.0,0.0,3490,83628,52350,-31278
20908,0.0,0.0,0.0,3490,83632,52350,-31282
20909,0.0,0.0,0.0,3490,83636,52350,-31286
20910,0.0,0.0,0.0,3490,83640,52350,-31290
20911,0.0,0.0,0.0,3490,83644,52350,-31294
20912,0.0,0.0,0.0,3490,83648,52350,-31298
20913,0.0,0.0,0.0,3490,83652,52350,-31302
20914,0.0,0.0,0.0,3490,83656,52350,-31306
20915,0.0,0.0,0.0,3490,83660,52350,-31310
20916,0.0,0.0,0.0,3490,83664,52350,-31314
20917,0.0,0.0,0.0,3490,83668,52350,-31318
20918,0.0,0.0,0.0,3490,83672,52350,-31322
20919,1.0,0.0,0.3333333333333333,3491,83676,52365,-31311
20920,0.0,0.0,0.0,3491,83680,52365,-31315
20921,1.0,1.0,1.0,3492,83684,52380,-31304
20922,0.0,0.0,0.0,3492,83688,52380,-31308
20923,0.0,0.0,0.0,3492,83692,52380,-31312
20924,1.0,1.0,1.0,3493,83696,52395,-31301
20925,0.0,0.0,0.0,3493,83700,52395,-31305
20926,1.0,1.0,1.0,3494,83704,52410,-31294
20927,0.0,0.0,0.0,3494,83708,52410,-31298
20928,0.0,0.0,0.3333333333333333,3494,83712,52410,-31302
20929,0.0,0.0,0.0,3494,83716,52410,-31306
20930,0.0,0.0,0.0,3494,83720,52410,-31310
20931,0.0,0.0,0.0,3494,83724,52410,-31314
20932,0.0,0.0,0.0,3494,83728,52410,-31318
20933,0.0,0.0,0.0,3494,83732,52410,-31322
20934,0.0,0.0,0.0,3494,83736,52410,-31326
20935,0.0,0.0,0.0,3494,83740,52410,-31330
20936,0.0,0.0,0.0,3494,83744,52410,-31334
20937,0.0,0.0,0.0,3494,83748,52410,-31338
20938,0.0,0.0,0.0,3494,83752,52410,-31342
20939,0.0,0.0,0.0,3494,83756,52410,-31346
20940,0.0,0.0,0.0,3494,83760,52410,-31350
20941,0.0,0.0,0.0,3494,83764,52410,-31354
20942,0.0,0.0,0.0,3494,83768,52410,-31358
20943,0.0,0.0,0.0,3494,83772,52410,-31362
20944,0.0,0.0,0.0,3494,83776,52410,-31366
20945,1.0,1.0,1.0,3495,83780,52425,-31355
20946,0.0,0.0,0.0,3495,83784,52425,-31359
20947,1.0,1.0,1.0,3496,83788,52440,-31348
20948,0.0,0.0,0.0,3496,83792,52440,-31352
20949,0.0,0.0,0.0,3496,83796,52440,-31356
20950,0.0,0.0,0.0,3496,83800,52440,-31360
20951,0.0,0.0,0.0,3496,83804,52440,-31364
20952,0.0,0.0,0.0,3496,83808,52440,-31368
20953,0.0,0.0,0.0,3496,83812,52440,-31372
20954,0.0,0.0,0.0,3496,83816,52440,-31376
20955,0.0,0.0,0.0,3496,83820,52440,-31380
20956,0.0,0.0,0.0,3496,83824,52440,-31384
20957,0.0,0.0,0.0,3496,83828,52440,-31388
20958,0.0,0.0,0.0,3496,83832,52440,-31392
20959,0.0,0.0,0.0,3496,83836,52440,-31396
20960,0.0,0.0,0.0,3496,83840,52440,-31400
20961,0.0,0.0,0.0,3496,83844,52440,-31404
20962,0.0,0.0,0.0,3496,83848,52440,-31408
20963,0.0,0.0,0.0,3496,83852,52440,-31412
20964,0.0,0.0,0.0,3496,83856,52440,-31416
20965,0.0,0.0,0.0,3496,83860,52440,-31420
20966,0.0,0.0,0.0,3496,83864,52440,-31424
20967,1.0,1.0,1.0,3497,83868,52455,-31413
20968,0.0,0.0,0.3333333333333333,3497,83872,52455,-31417
20969,0.0,0.0,0.0,3497,83876,52455,-31421
20970,0.0,0.0,0.0,3497,83880,52455,-31425
20971,0.0,0.0,0.0,3497,83884,52455,-31429
20972,0.0,0.0,0.0,3497,83888,52455,-31433
20973,0.0,0.0,0.0,3497,83892,52455,-31437
20974,0.0,0.0,0.0,3497,83896,52455,-31441
20975,0.0,0.0,0.0,3497,83900,52455,-31445
20976,0.0,0.0,0.0,3497,83904,52455,-31449
20977,0.0,0.0,0.0,3497,83908,52455,-31453
20978,0.0,0.0,0.0,3497,83912,52455,-31457
20979,1.0,1.0,1.0,3498,83916,52470,-31446
20980,0.0,0.0,0.5,3498,83920,52470,-31450
20981,0.0,0.0,0.0,3498,83924,52470,-31454
20982,1.0,1.0,1.0,3499,83928,52485,-31443
20983,0.0,0.0,0.3333333333333333,3499,83932,52485,-31447
20984,0.0,0.0,0.0,3499,83936,52485,-31451
20985,0.0,0.0,0.0,3499,83940,52485,-31455
20986,0.0,0.0,0.0,3499,83944,52485,-31459
20987,0.0,0.0,0.0,3499,83948,52485,-31463
20988,0.0,0.0,0.0,3499,83952,52485,-31467
20989,0.0,0.0,0.0,3499,83956,52485,-31471
20990,0.0,0.0,0.0,3499,83960,52485,-31475
20991,0.0,0.0,0.0,3499,83964,52485,-31479
20992,0.0,0.0,0.0,3499,83968,52485,-31483
20993,0.0,0.0,0.0,3499,83972,52485,-31487
20994,0.0,0.0,0.0,3499,83976,52485,-31491
20995,0.0,0.0,0.0,3499,83980,52485,-31495
20996,0.0,0.0,0.0,3499,83984,52485,-31499
20997,0.0,0.0,0.0,3499,83988,52485,-31503
20998,0.0,0.0,0.0,3499,83992,52485,-31507
20999,0.0,0.0,0.0,3499,83996,52485,-31511
21000,0.0,0.0,0.0,3499,84000,52485,-31515
21001,0.0,0.0,0.0,3499,84004,52485,-31519
21002,0.0,0.0,0.0,3499,84008,52485,-31523
21003,0.0,0.0,0.0,3499,84012,52485,-31527
21004,0.0,0.0,0.0,3499,84016,52485,-31531
21005,0.0,0.0,0.0,3499,84020,52485,-31535
21006,0.0,0.0,0.0,3499,84024,52485,-31539
21007,0.0,0.0,0.0,3499,84028,52485,-31543
21008,0.0,0.0,0.0,3499,84032,52485,-31547
21009,0.0,0.0,0.0,3499,84036,52485,-31551
21010,0.0,0.0,0.0,3499,84040,52485,-31555
21011,0.0,0.0,0.0,3499,84044,52485,-31559
21012,0.0,0.0,0.0,3499,84048,52485,-31563
21013,0.0,0.0,0.0,3499,84052,52485,-31567
21014,1.0,1.0,1.0,3500,84056,52500,-31556
21015,0.0,0.0,0.0,3500,84060,52500,-31560
21016,0.0,0.0,0.0,3500,84064,52500,-31564
21017,0.0,0.0,0.0,3500,84068,52500,-31568
21018,0.0,0.0,0.0,3500,84072,52500,-31572
21019,1.0,1.0,1.0,3501,84076,52515,-31561
21020,0.0,0.0,0.0,3501,84080,52515,-31565
21021,0.0,0.0,0.0,3501,84084,52515,-31569
21022,0.0,0.0,0.0,3501,84088,52515,-31573
21023,0.0,0.0,0.0,3501,84092,52515,-31577
21024,0.0,0.0,0.0,3501,84096,52515,-31581
21025,0.0,0.0,0.0,3501,84100,52515,-31585
21026,1.0,0.0,0.3333333333333333,3502,84104,52530,-31574
21027,0.0,0.0,0.0,3502,84108,52530,-31578
21028,0.0,0.0,0.0,3502,84112,52530,-31582
21029,0.0,0.0,0.0,3502,84116,52530,-31586
21030,0.0,0.0,0.0,3502,84120,52530,-31590
21031,0.0,0.0,0.0,3502,84124,52530,-31594
21032,0.0,0.0,0.3333333333333333,3502,84128,52530,-31598
21033,1.0,1.0,0.6,3503,84132,52545,-31587
21034,0.0,0.0,0.0,3503,84136,52545,-31591
21035,0.0,0.0,0.0,3503,84140,52545,-31595
21036,0.0,0.0,0.0,3503,84144,52545,-31599
21037,0.0,0.0,0.0,3503,84148,52545,-31603
21038,0.0,0.0,0.0,3503,84152,52545,-31607
21039,0.0,0.0,0.0,3503,84156,52545,-31611
21040,0.0,0.0,0.25,3503,84160,52545,-31615
21041,1.0,1.0,1.0,3504,84164,52560,-31604
21042,0.0,0.0,0.0,3504,84168,52560,-31608
21043,0.0,0.0,0.3333333333333333,3504,84172,52560,-31612
21044,1.0,0.0,0.3333333333333333,3505,84176,52575,-31601
21045,0.0,0.0,0.0,3505,84180,52575,-31605
21046,0.0,0.0,0.0,3505,84184,52575,-31609
21047,1.0,1.0,1.0,3506,84188,52590,-31598
21048,0.0,0.0,0.0,3506,84192,52590,-31602
21049,0.0,0.0,0.0,3506,84196,52590,-31606
21050,0.0,0.0,0.0,3506,84200,52590,-31610
21051,0.0,0.0,0.0,3506,84204,52590,-31614
21052,0.0,0.0,0.0,3506,84208,52590,-31618
21053,0.0,0.0,0.0,3506,84212,52590,-31622
21054,0.0,0.0,0.0,3506,84216,52590,-31626
21055,0.0,0.0,0.0,3506,84220,52590,-31630
21056,0.0,0.0,0.0,3506,84224,52590,-31634
21057,0.0,0.0,0.0,3506,84228,52590,-31638
21058,0.0,0.0,0.0,3506,84232,52590,-31642
21059,0.0,0.0,0.0,3506,84236,52590,-31646
21060,0.0,0.0,0.0,3506,84240,52590,-31650
21061,0.0,0.0,0.0,3506,84244,52590,-31654
21062,0.0,0.0,0.0,3506,84248,52590,-31658
21063,0.0,0.0,0.0,3506,84252,52590,-31662
21064,0.0,0.0,0.0,3506,84256,52590,-31666
21065,1.0,1.0,1.0,3507,84260,52605,-31655
21066,0.0,0.0,0.0,3507,84264,52605,-31659
21067,0.0,0.0,0.0,3507,84268,52605,-31663
21068,0.0,0.0,0.0,3507,84272,52605,-31667
21069,0.0,0.0,0.0,3507,84276,52605,-31671
21070,0.0,0.0,0.0,3507,84280,52605,-31675
21071,0.0,0.0,0.3333333333333333,3507,84284,52605,-31679
21072,0.0,0.0,0.0,3507,84288,52605,-31683
21073,0.0,0.0,0.0,3507,84292,52605,-31687
21074,0.0,0.0,0.0,3507,84296,52605,-31691
21075,1.0,1.0,1.0,3508,84300,52620,-31680
21076,0.0,0.0,0.0,3508,84304,52620,-31684
21077,0.0,0.0,0.0,3508,84308,52620,-31688
21078,0.0,0.0,0.0,3508,84312,52620,-31692
21079,0.0,0.0,0.0,3508,84316,52620,-31696
21080,0.0,0.0,0.0,3508,84320,52620,-31700
21081,0.0,0.0,0.0,3508,84324,52620,-31704
21082,0.0,0.0,0.0,3508,84328,52620,-31708
21083,1.0,1.0,1.0,3509,84332,52635,-31697
21084,0.0,0.0,0.0,3509,84336,52635,-31701
21085,1.0,1.0,0.6666666666666666,3510,84340,52650,-31690
21086,0.0,0.0,0.0,3510,84344,52650,-31694
21087,1.0,1.0,0.6666666666666666,3511,84348,52665,-31683
21088,1.0,1.0,1.0,3512,84352,52680,-31672
21089,0.0,0.0,0.0,3512,84356,52680,-31676
21090,1.0,1.0,1.0,3513,84360,52695,-31665
21091,0.0,0.0,0.0,3513,84364,52695,-31669
21092,1.0,1.0,1.0,3514,84368,52710,-31658
21093,0.0,0.0,0.0,3514,84372,52710,-31662
21094,0.0,0.0,0.0,3514,84376,52710,-31666
21095,0.0,0.0,0.0,3514,84380,52710,-31670
21096,1.0,1.0,1.0,3515,84384,52725,-31659
21097,0.0,0.0,0.0,3515,84388,52725,-31663
21098,0.0,0.0,0.0,3515,84392,52725,-31667
21099,0.0,0.0,0.0,3515,84396,52725,-31671
21100,0.0,0.0,0.0,3515,84400,52725,-31675
21101,0.0,0.0,0.0,3515,84404,52725,-31679
21102,0.0,0.0,0.0,3515,84408,52725,-31683
21103,0.0,0.0,0.0,3515,84412,52725,-31687
21104,0.0,0.0,0.0,3515,84416,52725,-31691
21105,0.0,0.0,0.0,3515,84420,52725,-31695
21106,0.0,0.0,0.0,3515,84424,52725,-31699
21107,1.0,1.0,1.0,3516,84428,52740,-31688
21108,0.0,0.0,0.0,3516,84432,52740,-31692
21109,0.0,0.0,0.0,3516,84436,52740,-31696
21110,1.0,1.0,0.6666666666666666,3517,84440,52755,-31685
21111,0.0,0.0,0.0,3517,84444,52755,-31689
21112,0.0,0.0,0.0,3517,84448,52755,-31693
21113,0.0,0.0,0.0,3517,84452,52755,-31697
21114,0.0,0.0,0.0,3517,84456,52755,-31701
21115,0.0,0.0,0.0,3517,84460,52755,-31705
21116,0.0,0.0,0.0,3517,84464,52755,-31709
21117,0.0,0.0,0.0,3517,84468,52755,-31713
21118,1.0,1.0,1.0,3518,84472,52770,-31702
21119,0.0,0.0,0.0,3518,84476,52770,-31706
21120,0.0,0.0,0.0,3518,84480,52770,-31710
21121,0.0,0.0,0.0,3518,84484,52770,-31714
21122,0.0,0.0,0.0,3518,84488,52770,-31718
21123,1.0,1.0,1.0,3519,84492,52785,-31707
21124,0.0,0.0,0.0,3519,84496,52785,-31711
21125,0.0,0.0,0.0,3519,84500,52785,-31715
21126,0.0,0.0,0.0,3519,84504,52785,-31719
21127,0.0,0.0,0.0,3519,84508,52785,-31723
21128,0.0,0.0,0.0,3519,84512,52785,-31727
21129,0.0,0.0,0.0,3519,84516,52785,-31731
21130,0.0,0.0,0.0,3519,84520,52785,-31735
21131,0.0,0.0,0.0,3519,84524,52785,-31739
21132,0.0,0.0,0.0,3519,84528,52785,-31743
21133,0.0,0.0,0.0,3519,84532,52785,-31747
21134,0.0,0.0,0.0,3519,84536,52785,-31751
21135,0.0,0.0,0.0,3519,84540,52785,-31755
21136,0.0,0.0,0.0,3519,84544,52785,-31759
21137,0.0,0.0,0.0,3519,84548,52785,-31763
21138,0.0,0.0,0.0,3519,84552,52785,-31767
21139,0.0,0.0,0.0,3519,84556,52785,-31771
21140,1.0,1.0,0.6666666666666666,3520,84560,52800,-31760
21141,0.0,0.0,0.25,3520,84564,52800,-31764
21142,0.0,0.0,0.0,3520,84568,52800,-31768
21143,1.0,1.0,1.0,3521,84572,52815,-31757
21144,0.0,0.0,0.0,3521,84576,52815,-31761
21145,0.0,0.0,0.0,3521,84580,52815,-31765
21146,0.0,0.0,0.0,3521,84584,52815,-31769
21147,0.0,0.0,0.0,3521,84588,52815,-31773
21148,0.0,0.0,0.0,3521,84592,52815,-31777
21149,0.0,0.0,0.0,3521,84596,52815,-31781
21150,0.0,0.0,0.0,3521,84600,52815,-31785
21151,0.0,0.0,0.0,3521,84604,52815,-31789
21152,0.0,1.0,0.8,3521,84608,52815,-31793
21153,0.0,0.0,0.0,3521,84612,52815,-31797
21154,0.0,0.0,0.0,3521,84616,52815,-31801
21155,1.0,1.0,0.6666666666666666,3522,84620,52830,-31790
21156,1.0,1.0,1.0,3523,84624,52845,-31779
21157,0.0,0.0,0.0,3523,84628,52845,-31783
21158,0.0,0.0,0.0,3523,84632,52845,-31787
21159,1.0,1.0,1.0,3524,84636,52860,-31776
21160,0.0,0.0,0.0,3524,84640,52860,-31780
21161,0.0,0.0,0.0,3524,84644,52860,-31784
21162,0.0,0.0,0.0,3524,84648,52860,-31788
21163,0.0,0.0,0.0,3524,84652,52860,-31792
21164,0.0,0.0,0.0,3524,84656,52860,-31796
21165,0.0,0.0,0.0,3524,84660,52860,-31800
21166,0.0,0.0,0.0,3524,84664,52860,-31804
21167,1.0,0.0,0.25,3525,84668,52875,-31793
21168,0.0,0.0,0.0,3525,84672,52875,-31797
21169,0.0,0.0,0.0,3525,84676,52875,-31801
21170,0.0,0.0,0.0,3525,84680,52875,-31805
21171,0.0,0.0,0.0,3525,84684,52875,-31809
21172,0.0,0.0,0.0,3525,84688,52875,-31813
21173,0.0,0.0,0.0,3525,84692,52875,-31817
21174,1.0,1.0,0.8,3526,84696,52890,-31806
21175,0.0,0.0,0.0,3526,84700,52890,-31810
21176,0.0,0.0,0.0,3526,84704,52890,-31814
21177,0.0,0.0,0.0,3526,84708,52890,-31818
21178,0.0,0.0,0.0,3526,84712,52890,-31822
21179,0.0,0.0,0.0,3526,84716,52890,-31826
21180,0.0,0.0,0.0,3526,84720,52890,-31830
21181,1.0,0.0,0.25,3527,84724,52905,-31819
21182,0.0,0.0,0.0,3527,84728,52905,-31823
21183,0.0,0.0,0.0,3527,84732,52905,-31827
21184,0.0,0.0,0.0,3527,84736,52905,-31831
21185,0.0,0.0,0.0,3527,84740,52905,-31835
21186,0.0,0.0,0.0,3527,84744,52905,-31839
21187,0.0,0.0,0.0,3527,84748,52905,-31843
21188,1.0,1.0,1.0,3528,84752,52920,-31832
21189,0.0,0.0,0.0,3528,84756,52920,-31836
21190,0.0,0.0,0.0,3528,84760,52920,-31840
21191,0.0,0.0,0.0,3528,84764,52920,-31844
21192,0.0,0.0,0.0,3528,84768,52920,-31848
21193,0.0,0.0,0.0,3528,84772,52920,-31852
21194,0.0,0.0,0.0,3528,84776,52920,-31856
21195,0.0,0.0,0.0,3528,84780,52920,-31860
21196,0.0,0.0,0.5,3528,84784,52920,-31864
21197,0.0,0.0,0.0,3528,84788,52920,-31868
21198,0.0,0.0,0.0,3528,84792,52920,-31872
21199,0.0,0.0,0.0,3528,84796,52920,-31876
21200,0.0,0.0,0.0,3528,84800,52920,-31880
21201,0.0,0.0,0.0,3528,84804,52920,-31884
21202,0.0,0.0,0.0,3528,84808,52920,-31888
21203,1.0,1.0,0.75,3529,84812,52935,-31877
21204,0.0,0.0,0.0,3529,84816,52935,-31881
21205,1.0,0.0,0.25,3530,84820,52950,-31870
21206,0.0,0.0,0.0,3530,84824,52950,-31874
21207,0.0,0.0,0.0,3530,84828,52950,-31878
21208,0.0,0.0,0.0,3530,84832,52950,-31882
21209,0.0,0.0,0.0,3530,84836,52950,-31886
21210,0.0,0.0,0.0,3530,84840,52950,-31890
21211,0.0,0.0,0.0,3530,84844,52950,-31894
21212,0.0,0.0,0.0,3530,84848,52950,-31898
21213,0.0,0.0,0.0,3530,84852,52950,-31902
21214,0.0,0.0,0.25,3530,84856,52950,-31906
21215,0.0,0.0,0.0,3530,84860,52950,-31910
21216,0.0,0.0,0.0,3530,84864,52950,-31914
21217,0.0,0.0,0.0,3530,84868,52950,-31918
21218,0.0,0.0,0.0,3530,84872,52950,-31922
21219,0.0,0.0,0.0,3530,84876,52950,-31926
21220,0.0,0.0,0.0,3530,84880,52950,-31930
21221,0.0,0.0,0.0,3530,84884,52950,-31934
21222,0.0,0.0,0.0,3530,84888,52950,-31938
21223,0.0,0.0,0.0,3530,84892,52950,-31942
21224,1.0,1.0,0.75,3531,84896,52965,-31931
21225,1.0,1.0,1.0,3532,84900,52980,-31920
21226,0.0,0.0,0.0,3532,84904,52980,-31924
21227,0.0,0.0,0.0,3532,84908,52980,-31928
21228,0.0,0.0,0.0,3532,84912,52980,-31932
21229,1.0,1.0,1.0,3533,84916,52995,-31921
21230,0.0,0.0,0.0,3533,84920,52995,-31925
21231,1.0,1.0,1.0,3534,84924,53010,-31914
21232,0.0,0.0,0.0,3534,84928,53010,-31918
21233,0.0,0.0,0.0,3534,84932,53010,-31922
21234,0.0,0.0,0.0,3534,84936,53010,-31926
21235,0.0,0.0,0.0,3534,84940,53010,-31930
21236,0.0,0.0,0.0,3534,84944,53010,-31934
21237,0.0,0.0,0.0,3534,84948,53010,-31938
21238,0.0,0.0,0.0,3534,84952,53010,-31942
21239,0.0,0.0,0.0,3534,84956,53010,-31946
21240,1.0,1.0,1.0,3535,84960,53025,-31935
21241,0.0,0.0,0.2,3535,84964,53025,-31939
21242,1.0,1.0,1.0,3536,84968,53040,-31928
21243,0.0,0.0,0.0,3536,84972,53040,-31932
21244,0.0,0.0,0.0,3536,84976,53040,-31936
21245,0.0,0.0,0.0,3536,84980,53040,-31940
21246,0.0,0.0,0.0,3536,84984,53040,-31944
21247,0.0,0.0,0.0,3536,84988,53040,-31948
21248,0.0,0.0,0.0,3536,84992,53040,-31952
21249,0.0,0.0,0.0,3536,84996,53040,-31956
21250,1.0,1.0,0.75,3537,85000,53055,-31945
21251,0.0,1.0,0.75,3537,85004,53055,-31949
21252,0.0,0.0,0.0,3537,85008,53055,-31953
21253,0.0,0.0,0.0,3537,85012,53055,-31957
21254,0.0,0.0,0.0,3537,85016,53055,-31961
21255,0.0,0.0,0.0,3537,85020,53055,-31965
21256,0.0,0.0,0.3333333333333333,3537,85024,53055,-31969
21257,1.0,1.0,1.0,3538,85028,53070,-31958
21258,0.0,0.0,0.0,3538,85032,53070,-31962
21259,0.0,0.0,0.0,3538,85036,53070,-31966
21260,0.0,0.0,0.0,3538,85040,53070,-31970
21261,0.0,0.0,0.0,3538,85044,53070,-31974
21262,0.0,0.0,0.0,3538,85048,53070,-31978
21263,0.0,0.0,0.0,3538,85052,53070,-31982
21264,1.0,1.0,1.0,3539,85056,53085,-31971
21265,0.0,0.0,0.0,3539,85060,53085,-31975
21266,0.0,0.0,0.0,3539,85064,53085,-31979
21267,0.0,0.0,0.0,3539,85068,53085,-31983
21268,0.0,0.0,0.0,3539,85072,53085,-31987
21269,0.0,0.0,0.0,3539,85076,53085,-31991
21270,0.0,0.0,0.0,3539,85080,53085,-31995
21271,0.0,0.0,0.0,3539,85084,53085,-31999
21272,0.0,0.0,0.0,3539,85088,53085,-32003
21273,0.0,0.0,0.0,3539,85092,53085,-32007
21274,0.0,0.0,0.0,3539,85096,53085,-32011
21275,0.0,0.0,0.0,3539,85100,53085,-32015
21276,0.0,0.0,0.0,3539,85104,53085,-32019
21277,0.0,0.0,0.0,3539,85108,53085,-32023
21278,0.0,0.0,0.0,3539,85112,53085,-32027
21279,0.0,0.0,0.0,3539,85116,53085,-32031
21280,0.0,0.0,0.0,3539,85120,53085,-32035
21281,0.0,0.0,0.0,3539,85124,53085,-32039
21282,0.0,0.0,0.0,3539,85128,53085,-32043
21283,0.0,0.0,0.0,3539,85132,53085,-32047
21284,0.0,0.0,0.0,3539,85136,53085,-32051
21285,0.0,0.0,0.0,3539,85140,53085,-32055
21286,0.0,0.0,0.0,3539,85144,53085,-32059
21287,0.0,0.0,0.0,3539,85148,53085,-32063
21288,0.0,0.0,0.3333333333333333,3539,85152,53085,-32067
21289,0.0,0.0,0.0,3539,85156,53085,-32071
21290,0.0,0.0,0.0,3539,85160,53085,-32075
21291,0.0,0.0,0.0,3539,85164,53085,-32079
21292,0.0,0.0,0.0,3539,85168,53085,-32083
21293,0.0,0.0,0.0,3539,85172,53085,-32087
21294,0.0,0.0,0.0,3539,85176,53085,-32091
21295,0.0,0.0,0.0,3539,85180,53085,-32095
21296,0.0,0.0,0.0,3539,85184,53085,-32099
21297,1.0,0.0,0.5,3540,85188,53100,-32088
21298,0.0,0.0,0.0,3540,85192,53100,-32092
21299,0.0,0.0,0.0,3540,85196,53100,-32096
21300,0.0,0.0,0.0,3540,85200,53100,-32100
21301,1.0,1.0,1.0,3541,85204,53115,-32089
21302,0.0,0.0,0.0,3541,85208,53115,-32093
21303,0.0,0.0,0.0,3541,85212,53115,-32097
21304,0.0,0.0,0.0,3541,85216,53115,-32101
21305,0.0,0.0,0.0,3541,85220,53115,-32105
21306,0.0,0.0,0.0,3541,85224,53115,-32109
21307,0.0,0.0,0.0,3541,85228,53115,-32113
21308,0.0,0.0,0.5,3541,85232,53115,-32117
21309,0.0,0.0,0.0,3541,85236,53115,-32121
21310,0.0,0.0,0.0,3541,85240,53115,-32125
21311,0.0,0.0,0.0,3541,85244,53115,-32129
21312,0.0,1.0,0.6,3541,85248,53115,-32133
21313,0.0,0.0,0.0,3541,85252,53115,-32137
21314,0.0,0.0,0.0,3541,85256,53115,-32141
21315,0.0,0.0,0.0,3541,85260,53115,-32145
21316,0.0,0.0,0.0,3541,85264,53115,-32149
21317,0.0,0.0,0.0,3541,85268,53115,-32153
21318,1.0,1.0,1.0,3542,85272,53130,-32142
21319,0.0,0.0,0.0,3542,85276,53130,-32146
21320,0.0,0.0,0.0,3542,85280,53130,-32150
21321,0.0,0.0,0.0,3542,85284,53130,-32154
21322,0.0,0.0,0.0,3542,85288,53130,-32158
21323,1.0,1.0,1.0,3543,85292,53145,-32147
21324,0.0,0.0,0.0,3543,85296,53145,-32151
21325,0.0,0.0,0.0,3543,85300,53145,-32155
21326,1.0,0.0,0.5,3544,85304,53160,-32144
21327,0.0,1.0,0.6,3544,85308,53160,-32148
21328,0.0,0.0,0.0,3544,85312,53160,-32152
21329,0.0,0.0,0.0,3544,85316,53160,-32156
21330,0.0,0.0,0.0,3544,85320,53160,-32160
21331,0.0,0.0,0.0,3544,85324,53160,-32164
21332,1.0,1.0,1.0,3545,85328,53175,-32153
21333,0.0,0.0,0.0,3545,85332,53175,-32157
21334,0.0,0.0,0.0,3545,85336,53175,-32161
21335,1.0,0.0,0.4,3546,85340,53190,-32150
21336,1.0,1.0,1.0,3547,85344,53205,-32139
21337,1.0,1.0,1.0,3548,85348,53220,-32128
21338,0.0,0.0,0.0,3548,85352,53220,-32132
21339,1.0,1.0,1.0,3549,85356,53235,-32121
21340,0.0,0.0,0.0,3549,85360,53235,-32125
21341,0.0,0.0,0.0,3549,85364,53235,-32129
21342,0.0,0.0,0.0,3549,85368,53235,-32133
21343,0.0,0.0,0.0,3549,85372,53235,-32137
21344,0.0,0.0,0.0,3549,85376,53235,-32141
21345,0.0,0.0,0.0,3549,85380,53235,-32145
21346,0.0,0.0,0.0,3549,85384,53235,-32149
21347,0.0,0.0,0.0,3549,85388,53235,-32153
21348,0.0,0.0,0.0,3549,85392,53235,-32157
21349,0.0,0.0,0.0,3549,85396,53235,-32161
21350,0.0,0.0,0.0,3549,85400,53235,-32165
21351,0.0,0.0,0.0,3549,85404,53235,-32169
21352,0.0,0.0,0.0,3549,85408,53235,-32173
21353,0.0,0.0,0.0,3549,85412,53235,-32177
21354,1.0,1.0,0.8,3550,85416,53250,-32166
21355,0.0,0.0,0.0,3550,85420,53250,-32170
21356,0.0,0.0,0.0,3550,85424,53250,-32174
21357,0.0,0.0,0.0,3550,85428,53250,-32178
21358,0.0,0.0,0.0,3550,85432,53250,-32182
21359,0.0,0.0,0.0,3550,85436,53250,-32186
21360,0.0,0.0,0.0,3550,85440,53250,-32190
21361,0.0,0.0,0.0,3550,85444,53250,-32194
21362,0.0,0.0,0.0,3550,85448,53250,-32198
21363,0.0,0.0,0.0,3550,85452,53250,-32202
21364,0.0,0.0,0.0,3550,85456,53250,-32206
21365,0.0,0.0,0.3333333333333333,3550,85460,53250,-32210
21366,0.0,0.0,0.0,3550,85464,53250,-32214
21367,0.0,0.0,0.0,3550,85468,53250,-32218
21368,0.0,0.0,0.0,3550,85472,53250,-32222
21369,0.0,0.0,0.0,3550,85476,53250,-32226
21370,0.0,0.0,0.0,3550,85480,53250,-32230
21371,0.0,0.0,0.0,3550,85484,53250,-32234
21372,0.0,0.0,0.0,3550,85488,53250,-32238
21373,0.0,0.0,0.0,3550,85492,53250,-32242
21374,0.0,0.0,0.0,3550,85496,53250,-32246
21375,0.0,0.0,0.3333333333333333,3550,85500,53250,-32250
21376,0.0,0.0,0.0,3550,85504,53250,-32254
21377,0.0,0.0,0.0,3550,85508,53250,-32258
21378,0.0,0.0,0.0,3550,85512,53250,-32262
21379,0.0,0.0,0.0,3550,85516,53250,-32266
21380,0.0,0.0,0.0,3550,85520,53250,-32270
21381,0.0,0.0,0.0,3550,85524,53250,-32274
21382,0.0,0.0,0.0,3550,85528,53250,-32278
21383,0.0,0.0,0.0,3550,85532,53250,-32282
21384,0.0,0.0,0.0,3550,85536,53250,-32286
21385,0.0,0.0,0.0,3550,85540,53250,-32290
21386,0.0,0.0,0.0,3550,85544,53250,-32294
21387,0.0,0.0,0.0,3550,85548,53250,-32298
21388,0.0,0.0,0.0,3550,85552,53250,-32302
21389,0.0,0.0,0.0,3550,85556,53250,-32306
21390,0.0,0.0,0.0,3550,85560,53250,-32310
21391,0.0,0.0,0.0,3550,85564,53250,-32314
21392,0.0,0.0,0.0,3550,85568,53250,-32318
21393,1.0,1.0,1.0,3551,85572,53265,-32307
21394,0.0,0.0,0.0,3551,85576,53265,-32311
21395,0.0,0.0,0.0,3551,85580,53265,-32315
21396,0.0,0.0,0.0,3551,85584,53265,-32319
21397,1.0,1.0,1.0,3552,85588,53280,-32308
21398,0.0,0.0,0.0,3552,85592,53280,-32312
21399,1.0,1.0,1.0,3553,85596,53295,-32301
21400,0.0,0.0,0.0,3553,85600,53295,-32305
21401,0.0,0.0,0.0,3553,85604,53295,-32309
21402,0.0,0.0,0.0,3553,85608,53295,-32313
21403,0.0,0.0,0.0,3553,85612,53295,-32317
21404,0.0,0.0,0.0,3553,85616,53295,-32321
21405,0.0,0.0,0.0,3553,85620,53295,-32325
21406,0.0,0.0,0.0,3553,85624,53295,-32329
21407,0.0,0.0,0.0,3553,85628,53295,-32333
21408,0.0,0.0,0.0,3553,85632,53295,-32337
21409,0.0,0.0,0.0,3553,85636,53295,-32341
21410,0.0,0.0,0.0,3553,85640,53295,-32345
21411,0.0,0.0,0.0,3553,85644,53295,-32349
21412,0.0,0.0,0.0,3553,85648,53295,-32353
21413,0.0,0.0,0.0,3553,85652,53295,-32357
21414,0.0,0.0,0.0,3553,85656,53295,-32361
21415,0.0,0.0,0.0,3553,85660,53295,-32365
21416,0.0,0.0,0.0,3553,85664,53295,-32369
21417,0.0,0.0,0.0,3553,85668,53295,-32373
21418,0.0,0.0,0.0,3553,85672,53295,-32377
21419,0.0,0.0,0.0,3553,85676,53295,-32381
21420,1.0,1.0,0.8,3554,85680,53310,-32370
21421,0.0,0.0,0.0,3554,85684,53310,-32374
21422,0.0,0.0,0.0,3554,85688,53310,-32378
21423,0.0,0.0,0.0,3554,85692,53310,-32382
21424,0.0,0.0,0.0,3554,85696,53310,-32386
21425,0.0,0.0,0.0,3554,85700,53310,-32390
21426,1.0,1.0,1.0,3555,85704,53325,-32379
21427,0.0,0.0,0.0,3555,85708,53325,-32383
21428,0.0,0.0,0.0,3555,85712,53325,-32387
21429,0.0,0.0,0.0,3555,85716,53325,-32391
21430,0.0,0.0,0.0,3555,85720,53325,-32395
21431,0.0,0.0,0.0,3555,85724,53325,-32399
21432,0.0,0.0,0.0,3555,85728,53325,-32403
21433,0.0,0.0,0.0,3555,85732,53325,-32407
21434,0.0,0.0,0.0,3555,85736,53325,-32411
21435,0.0,0.0,0.0,3555,85740,53325,-32415
21436,0.0,0.0,0.0,3555,85744,53325,-32419
21437,1.0,1.0,1.0,3556,85748,53340,-32408
21438,0.0,0.0,0.0,3556,85752,53340,-32412
21439,0.0,0.0,0.0,3556,85756,53340,-32416
21440,0.0,0.0,0.0,3556,85760,53340,-32420
21441,0.0,0.0,0.0,3556,85764,53340,-32424
21442,0.0,0.0,0.0,3556,85768,53340,-32428
21443,0.0,0.0,0.0,3556,85772,53340,-32432
21444,1.0,0.0,0.3333333333333333,3557,85776,53355,-32421
21445,0.0,0.0,0.0,3557,85780,53355,-32425
21446,0.0,0.0,0.0,3557,85784,53355,-32429
21447,0.0,0.0,0.0,3557,85788,53355,-32433
21448,0.0,0.0,0.0,3557,85792,53355,-32437
21449,1.0,1.0,1.0,3558,85796,53370,-32426
21450,0.0,0.0,0.0,3558,85800,53370,-32430
21451,0.0,0.0,0.0,3558,85804,53370,-32434
21452,0.0,0.0,0.0,3558,85808,53370,-32438
21453,0.0,0.0,0.0,3558,85812,53370,-32442
21454,0.0,0.0,0.0,3558,85816,53370,-32446
21455,0.0,0.0,0.0,3558,85820,53370,-32450
21456,0.0,0.0,0.0,3558,85824,53370,-32454
21457,0.0,0.0,0.0,3558,85828,53370,-32458
21458,0.0,0.0,0.0,3558,85832,53370,-32462
21459,0.0,0.0,0.0,3558,85836,53370,-32466
21460,1.0,1.0,1.0,3559,85840,53385,-32455
21461,0.0,0.0,0.0,3559,85844,53385,-32459
21462,0.0,0.0,0.0,3559,85848,53385,-32463
21463,0.0,0.0,0.0,3559,85852,53385,-32467
21464,0.0,0.0,0.0,3559,85856,53385,-32471
21465,0.0,0.0,0.0,3559,85860,53385,-32475
21466,0.0,0.0,0.0,3559,85864,53385,-32479
21467,1.0,1.0,1.0,3560,85868,53400,-32468
21468,0.0,0.0,0.0,3560,85872,53400,-32472
21469,0.0,0.0,0.0,3560,85876,53400,-32476
21470,0.0,0.0,0.0,3560,85880,53400,-32480
21471,0.0,0.0,0.0,3560,85884,53400,-32484
21472,0.0,0.0,0.0,3560,85888,53400,-32488
21473,0.0,0.0,0.0,3560,85892,53400,-32492
21474,0.0,0.0,0.0,3560,85896,53400,-32496
21475,0.0,0.0,0.0,3560,85900,53400,-32500
21476,0.0,0.0,0.0,3560,85904,53400,-32504
21477,0.0,0.0,0.0,3560,85908,53400,-32508
21478,0.0,0.0,0.0,3560,85912,53400,-32512
21479,0.0,0.0,0.0,3560,85916,53400,-32516
21480,0.0,0.0,0.0,3560,85920,53400,-32520
21481,1.0,1.0,1.0,3561,85924,53415,-32509
21482,0.0,0.0,0.0,3561,85928,53415,-32513
21483,0.0,0.0,0.0,3561,85932,53415,-32517
21484,0.0,0.0,0.0,3561,85936,53415,-32521
21485,0.0,0.0,0.0,3561,85940,53415,-32525
21486,0.0,0.0,0.0,3561,85944,53415,-32529
21487,0.0,0.0,0.0,3561,85948,53415,-32533
21488,0.0,0.0,0.0,3561,85952,53415,-32537
21489,0.0,0.0,0.0,3561,85956,53415,-32541
21490,0.0,0.0,0.0,3561,85960,53415,-32545
21491,0.0,0.0,0.0,3561,85964,53415,-32549
21492,0.0,0.0,0.0,3561,85968,53415,-32553
21493,1.0,1.0,1.0,3562,85972,53430,-32542
21494,0.0,0.0,0.0,3562,85976,53430,-32546
21495,0.0,0.0,0.0,3562,85980,53430,-32550
21496,1.0,1.0,1.0,3563,85984,53445,-32539
21497,0.0,0.0,0.0,3563,85988,53445,-32543
21498,0.0,0.0,0.0,3563,85992,53445,-32547
21499,0.0,0.0,0.0,3563,85996,53445,-32551
21500,0.0,0.0,0.0,3563,86000,53445,-32555
21501,0.0,0.0,0.0,3563,86004,53445,-32559
21502,0.0,0.0,0.0,3563,86008,53445,-32563
21503,0.0,0.0,0.0,3563,86012,53445,-32567
21504,0.0,0.0,0.0,3563,86016,53445,-32571
21505,0.0,0.0,0.0,3563,86020,53445,-32575
21506,0.0,0.0,0.0,3563,86024,53445,-32579
21507,0.0,0.0,0.0,3563,86028,53445,-32583
21508,0.0,0.0,0.3333333333333333,3563,86032,53445,-32587
21509,0.0,0.0,0.0,3563,86036,53445,-32591
21510,0.0,0.0,0.0,3563,86040,53445,-32595
21511,0.0,0.0,0.0,3563,86044,53445,-32599
21512,0.0,0.0,0.0,3563,86048,53445,-32603
21513,0.0,0.0,0.0,3563,86052,53445,-32607
21514,1.0,0.0,0.3333333333333333,3564,86056,53460,-32596
21515,0.0,0.0,0.0,3564,86060,53460,-32600
21516,0.0,0.0,0.3333333333333333,3564,86064,53460,-32604
21517,0.0,0.0,0.0,3564,86068,53460,-32608
21518,1.0,1.0,1.0,3565,86072,53475,-32597
21519,0.0,0.0,0.0,3565,86076,53475,-32601
21520,0.0,0.0,0.0,3565,86080,53475,-32605
21521,0.0,0.0,0.0,3565,86084,53475,-32609
21522,0.0,0.0,0.0,3565,86088,53475,-32613
21523,0.0,0.0,0.0,3565,86092,53475,-32617
21524,0.0,0.0,0.0,3565,86096,53475,-32621
21525,0.0,1.0,0.6666666666666666,3565,86100,53475,-32625
21526,0.0,0.0,0.0,3565,86104,53475,-32629
21527,0.0,0.0,0.0,3565,86108,53475,-32633
21528,0.0,0.0,0.0,3565,86112,53475,-32637
21529,0.0,0.0,0.0,3565,86116,53475,-32641
21530,0.0,0.0,0.0,3565,86120,53475,-32645
21531,0.0,0.0,0.0,3565,86124,53475,-32649
21532,0.0,0.0,0.0,3565,86128,53475,-32653
21533,0.0,0.0,0.0,3565,86132,53475,-32657
21534,0.0,0.0,0.0,3565,86136,53475,-32661
21535,0.0,0.0,0.0,3565,86140,53475,-32665
21536,0.0,0.0,0.25,3565,86144,53475,-32669
21537,1.0,1.0,1.0,3566,86148,53490,-32658
21538,1.0,1.0,1.0,3567,86152,53505,-32647
21539,0.0,0.0,0.0,3567,86156,53505,-32651
21540,0.0,0.0,0.0,3567,86160,53505,-32655
21541,0.0,0.0,0.0,3567,86164,53505,-32659
21542,0.0,0.0,0.0,3567,86168,53505,-32663
21543,0.0,0.0,0.0,3567,86172,53505,-32667
21544,0.0,0.0,0.0,3567,86176,53505,-32671
21545,0.0,0.0,0.0,3567,86180,53505,-32675
21546,0.0,0.0,0.0,3567,86184,53505,-32679
21547,1.0,0.0,0.25,3568,86188,53520,-32668
21548,0.0,0.0,0.0,3568,86192,53520,-32672
21549,0.0,0.0,0.0,3568,86196,53520,-32676
21550,1.0,1.0,1.0,3569,86200,53535,-32665
21551,0.0,0.0,0.0,3569,86204,53535,-32669
21552,0.0,0.0,0.0,3569,86208,53535,-32673
21553,0.0,0.0,0.0,3569,86212,53535,-32677
21554,0.0,0.0,0.0,3569,86216,53535,-32681
21555,0.0,0.0,0.0,3569,86220,53535,-32685
21556,0.0,0.0,0.0,3569,86224,53535,-32689
21557,0.0,0.0,0.0,3569,86228,53535,-32693
21558,0.0,0.0,0.0,3569,86232,53535,-32697
21559,0.0,0.0,0.0,3569,86236,53535,-32701
21560,0.0,0.0,0.0,3569,86240,53535,-32705
21561,1.0,1.0,1.0,3570,86244,53550,-32694
21562,0.0,0.0,0.0,3570,86248,53550,-32698
21563,1.0,1.0,1.0,3571,86252,53565,-32687
21564,0.0,0.0,0.0,3571,86256,53565,-32691
21565,1.0,1.0,1.0,3572,86260,53580,-32680
21566,0.0,0.0,0.0,3572,86264,53580,-32684
21567,0.0,0.0,0.0,3572,86268,53580,-32688
21568,0.0,0.0,0.0,3572,86272,53580,-32692
21569,0.0,0.0,0.0,3572,86276,53580,-32696
21570,1.0,1.0,1.0,3573,86280,53595,-32685
21571,1.0,1.0,1.0,3574,86284,53610,-32674
21572,0.0,0.0,0.0,3574,86288,53610,-32678
21573,0.0,0.0,0.0,3574,86292,53610,-32682
21574,1.0,1.0,1.0,3575,86296,53625,-32671
21575,1.0,1.0,1.0,3576,86300,53640,-32660
21576,0.0,0.0,0.0,3576,86304,53640,-32664
21577,0.0,0.0,0.0,3576,86308,53640,-32668
21578,0.0,0.0,0.0,3576,86312,53640,-32672
21579,1.0,1.0,1.0,3577,86316,53655,-32661
21580,0.0,0.0,0.0,3577,86320,53655,-32665
21581,0.0,0.0,0.0,3577,86324,53655,-32669
21582,0.0,0.0,0.0,3577,86328,53655,-32673
21583,0.0,0.0,0.0,3577,86332,53655,-32677
21584,0.0,0.0,0.0,3577,86336,53655,-32681
21585,0.0,0.0,0.0,3577,86340,53655,-32685
21586,0.0,0.0,0.0,3577,86344,53655,-32689
21587,0.0,0.0,0.0,3577,86348,53655,-32693
21588,0.0,0.0,0.0,3577,86352,53655,-32697
21589,0.0,0.0,0.0,3577,86356,53655,-32701
21590,0.0,0.0,0.0,3577,86360,53655,-32705
21591,0.0,0.0,0.0,3577,86364,53655,-32709
21592,1.0,1.0,0.8,3578,86368,53670,-32698
21593,1.0,1.0,1.0,3579,86372,53685,-32687
21594,0.0,0.0,0.0,3579,86376,53685,-32691
21595,0.0,0.0,0.0,3579,86380,53685,-32695
21596,1.0,1.0,1.0,3580,86384,53700,-32684
21597,0.0,0.0,0.0,3580,86388,53700,-32688
21598,0.0,0.0,0.0,3580,86392,53700,-32692
21599,0.0,0.0,0.0,3580,86396,53700,-32696
21600,0.0,0.0,0.0,3580,86400,53700,-32700
21601,0.0,0.0,0.0,3580,86404,53700,-32704
21602,0.0,0.0,0.0,3580,86408,53700,-32708
21603,0.0,0.0,0.0,3580,86412,53700,-32712
21604,0.0,0.0,0.0,3580,86416,53700,-32716
21605,0.0,0.0,0.0,3580,86420,53700,-32720
21606,0.0,0.0,0.4,3580,86424,53700,-32724
21607,0.0,0.0,0.0,3580,86428,53700,-32728
21608,0.0,0.0,0.0,3580,86432,53700,-32732
21609,0.0,0.0,0.0,3580,86436,53700,-32736
21610,0.0,0.0,0.0,3580,86440,53700,-32740
21611,0.0,0.0,0.0,3580,86444,53700,-32744
21612,0.0,0.0,0.0,3580,86448,53700,-32748
21613,0.0,0.0,0.25,3580,86452,53700,-32752
21614,1.0,1.0,0.6666666666666666,3581,86456,53715,-32741
21615,1.0,1.0,0.75,3582,86460,53730,-32730
21616,0.0,0.0,0.0,3582,86464,53730,-32734
21617,0.0,0.0,0.0,3582,86468,53730,-32738
21618,0.0,0.0,0.0,3582,86472,53730,-32742
21619,0.0,0.0,0.0,3582,86476,53730,-32746
21620,0.0,0.0,0.0,3582,86480,53730,-32750
21621,0.0,0.0,0.0,3582,86484,53730,-32754
21622,0.0,0.0,0.0,3582,86488,53730,-32758
21623,1.0,1.0,1.0,3583,86492,53745,-32747
21624,0.0,0.0,0.3333333333333333,3583,86496,53745,-32751
21625,0.0,0.0,0.0,3583,86500,53745,-32755
21626,1.0,1.0,1.0,3584,86504,53760,-32744
21627,0.0,0.0,0.0,3584,86508,53760,-32748
21628,0.0,0.0,0.0,3584,86512,53760,-32752
21629,0.0,0.0,0.0,3584,86516,53760,-32756
21630,0.0,0.0,0.0,3584,86520,53760,-32760
21631,1.0,1.0,0.6666666666666666,3585,86524,53775,-32749
21632,0.0,0.0,0.0,3585,86528,53775,-32753
21633,0.0,0.0,0.0,3585,86532,53775,-32757
21634,0.0,0.0,0.0,3585,86536,53775,-32761
21635,1.0,1.0,1.0,3586,86540,53790,-32750
21636,0.0,0.0,0.0,3586,86544,53790,-32754
21637,0.0,0.0,0.0,3586,86548,53790,-32758
21638,0.0,0.0,0.0,3586,86552,53790,-32762
21639,0.0,0.0,0.0,3586,86556,53790,-32766
21640,0.0,0.0,0.0,3586,86560,53790,-32770
21641,0.0,0.0,0.0,3586,86564,53790,-32774
21642,1.0,1.0,0.6666666666666666,3587,86568,53805,-32763
21643,0.0,0.0,0.0,3587,86572,53805,-32767
21644,0.0,0.0,0.0,3587,86576,53805,-32771
21645,0.0,0.0,0.0,3587,86580,53805,-32775
21646,0.0,0.0,0.0,3587,86584,53805,-32779
21647,0.0,0.0,0.0,3587,86588,53805,-32783
21648,1.0,1.0,1.0,3588,86592,53820,-32772
21649,0.0,0.0,0.0,3588,86596,53820,-32776
21650,0.0,0.0,0.0,3588,86600,53820,-32780
21651,0.0,0.0,0.0,3588,86604,53820,-32784
21652,0.0,0.0,0.0,3588,86608,53820,-32788
21653,0.0,0.0,0.0,3588,86612,53820,-32792
21654,0.0,0.0,0.0,3588,86616,53820,-32796
21655,1.0,1.0,1.0,3589,86620,53835,-32785
21656,0.0,0.0,0.0,3589,86624,53835,-32789
21657,1.0,1.0,1.0,3590,86628,53850,-32778
21658,0.0,0.0,0.0,3590,86632,53850,-32782
21659,0.0,0.0,0.0,3590,86636,53850,-32786
21660,1.0,1.0,0.6666666666666666,3591,86640,53865,-32775
21661,0.0,0.0,0.0,3591,86644,53865,-32779
21662,0.0,0.0,0.0,3591,86648,53865,-32783
21663,1.0,1.0,1.0,3592,86652,53880,-32772
21664,0.0,0.0,0.3333333333333333,3592,86656,53880,-32776
21665,0.0,0.0,0.3333333333333333,3592,86660,53880,-32780
21666,0.0,0.0,0.0,3592,86664,53880,-32784
21667,0.0,0.0,0.0,3592,86668,53880,-32788
21668,0.0,0.0,0.0,3592,86672,53880,-32792
21669,0.0,0.0,0.0,3592,86676,53880,-32796
21670,0.0,0.0,0.0,3592,86680,53880,-32800
21671,0.0,0.0,0.0,3592,86684,53880,-32804
21672,0.0,0.0,0.3333333333333333,3592,86688,53880,-32808
21673,0.0,0.0,0.0,3592,86692,53880,-32812
21674,0.0,0.0,0.0,3592,86696,53880,-32816
21675,0.0,1.0,0.6,3592,86700,53880,-32820
21676,1.0,1.0,1.0,3593,86704,53895,-32809
21677,0.0,0.0,0.0,3593,86708,53895,-32813
21678,1.0,1.0,1.0,3594,86712,53910,-32802
21679,0.0,0.0,0.0,3594,86716,53910,-32806
21680,0.0,0.0,0.0,3594,86720,53910,-32810
21681,0.0,0.0,0.25,3594,86724,53910,-32814
21682,0.0,0.0,0.0,3594,86728,53910,-32818
21683,0.0,0.0,0.0,3594,86732,53910,-32822
21684,0.0,0.0,0.0,3594,86736,53910,-32826
21685,1.0,1.0,1.0,3595,86740,53925,-32815
21686,0.0,0.0,0.0,3595,86744,53925,-32819
21687,0.0,0.0,0.0,3595,86748,53925,-32823
21688,0.0,0.0,0.0,3595,86752,53925,-32827
21689,1.0,1.0,1.0,3596,86756,53940,-32816
21690,0.0,0.0,0.0,3596,86760,53940,-32820
21691,1.0,1.0,0.6666666666666666,3597,86764,53955,-32809
21692,0.0,0.0,0.0,3597,86768,53955,-32813
21693,0.0,0.0,0.0,3597,86772,53955,-32817
21694,0.0,0.0,0.4,3597,86776,53955,-32821
21695,0.0,0.0,0.0,3597,86780,53955,-32825
21696,1.0,1.0,1.0,3598,86784,53970,-32814
21697,0.0,0.0,0.0,3598,86788,53970,-32818
21698,0.0,0.0,0.0,3598,86792,53970,-32822
21699,0.0,0.0,0.0,3598,86796,53970,-32826
21700,1.0,0.0,0.3333333333333333,3599,86800,53985,-32815
21701,1.0,1.0,1.0,3600,86804,54000,-32804
21702,1.0,1.0,1.0,3601,86808,54015,-32793
21703,1.0,1.0,1.0,3602,86812,54030,-32782
21704,1.0,1.0,1.0,3603,86816,54045,-32771
21705,1.0,0.0,0.2,3604,86820,54060,-32760
21706,0.0,0.0,0.0,3604,86824,54060,-32764
21707,1.0,1.0,1.0,3605,86828,54075,-32753
21708,0.0,0.0,0.0,3605,86832,54075,-32757
21709,0.0,0.0,0.0,3605,86836,54075,-32761
21710,0.0,0.0,0.0,3605,86840,54075,-32765
21711,0.0,0.0,0.0,3605,86844,54075,-32769
21712,0.0,0.0,0.0,3605,86848,54075,-32773
21713,0.0,0.0,0.0,3605,86852,54075,-32777
21714,0.0,1.0,0.6,3605,86856,54075,-32781
21715,0.0,0.0,0.0,3605,86860,54075,-32785
21716,0.0,1.0,0.6666666666666666,3605,86864,54075,-32789
21717,0.0,0.0,0.0,3605,86868,54075,-32793
21718,0.0,0.0,0.0,3605,86872,54075,-32797
21719,0.0,0.0,0.0,3605,86876,54075,-32801
21720,0.0,0.0,0.0,3605,86880,54075,-32805
21721,1.0,1.0,1.0,3606,86884,54090,-32794
21722,0.0,0.0,0.0,3606,86888,54090,-32798
21723,0.0,0.0,0.0,3606,86892,54090,-32802
21724,0.0,0.0,0.4,3606,86896,54090,-32806
21725,0.0,0.0,0.0,3606,86900,54090,-32810
21726,0.0,0.0,0.0,3606,86904,54090,-32814
21727,1.0,1.0,1.0,3607,86908,54105,-32803
21728,0.0,0.0,0.0,3607,86912,54105,-32807
21729,0.0,0.0,0.0,3607,86916,54105,-32811
21730,0.0,0.0,0.0,3607,86920,54105,-32815
21731,1.0,1.0,1.0,3608,86924,54120,-32804
21732,1.0,1.0,1.0,3609,86928,54135,-32793
21733,0.0,0.0,0.0,3609,86932,54135,-32797
21734,0.0,0.0,0.0,3609,86936,54135,-32801
21735,0.0,0.0,0.0,3609,86940,54135,-32805
21736,0.0,0.0,0.0,3609,86944,54135,-32809
21737,0.0,0.0,0.0,3609,86948,54135,-32813
21738,1.0,1.0,1.0,3610,86952,54150,-32802
21739,0.0,0.0,0.2,3610,86956,54150,-32806
21740,1.0,1.0,1.0,3611,86960,54165,-32795
